"","Destination","Years","export_val","import_val","Origin","Total","log","log2"
"1","Afghanistan",1962,8190000,6000,"Japan",8196000,8.69951474821019,15.9184244558293
"2","Afghanistan",1963,8644000,72000,"Japan",8716000,11.1844213979982,15.9723759966089
"3","Afghanistan",1964,9240000,6000,"Japan",9246000,8.69951474821019,16.0390524436179
"4","Afghanistan",1965,9742000,14000,"Japan",9756000,9.5468126085974,16.0919569933486
"5","Afghanistan",1966,12167000,57000,"Japan",12224000,10.9508065468167,16.3142379267696
"6","Afghanistan",1967,13667000,339000,"Japan",14006000,12.7337553863626,16.4304947259469
"7","Afghanistan",1968,11981000,44000,"Japan",12025000,10.6919449129004,16.298832619622
"8","Afghanistan",1969,14777000,214000,"Japan",14991000,12.273731294004,16.5085824758858
"9","Afghanistan",1970,19027000,188000,"Japan",19215000,12.1441972418121,16.7613695810225
"10","Afghanistan",1971,19611000,601000,"Japan",20212000,13.3063502135173,16.791601191263
"11","Afghanistan",1972,23927000,307000,"Japan",24234000,12.6346030265693,16.9905180863758
"12","Afghanistan",1973,32514000,1045000,"Japan",33559000,13.859527443381,17.2971813237763
"13","Afghanistan",1974,59648000,2232000,"Japan",61880000,14.6184086024833,17.9039711770274
"14","Afghanistan",1975,67601000,793000,"Japan",68394000,13.583578500617,18.0291333338032
"15","Afghanistan",1976,73754000,1335000,"Japan",75089000,14.1044418498165,18.1162457890015
"16","Afghanistan",1977,114382000,7285000,"Japan",121667000,15.8013279976114,18.555054281873
"17","Afghanistan",1978,93919000,2445000,"Japan",96364000,14.7095556808911,18.3579432666279
"18","Afghanistan",1979,99561000,6874000,"Japan",106435000,15.7432567363919,18.4162810796077
"19","Afghanistan",1980,103813000,1412000,"Japan",105225000,14.1605176970353,18.4581017617019
"20","Afghanistan",1981,79792000,847000,"Japan",80639000,13.6494559736342,18.194933806768
"21","Afghanistan",1982,96629000,621000,"Japan",97250000,13.3390863609156,18.386389461169
"22","Afghanistan",1983,120469000,237000,"Japan",120706000,12.3758154201173,18.6069030163868
"23","Afghanistan",1984,111851077,942613,"Japan",112793690,13.7564110850168,18.5326788748214
"24","Afghanistan",1985,97594817,1884228,"Japan",99479045,14.4490287459045,18.396334945465
"25","Afghanistan",1986,117129098,931500,"Japan",118060598,13.7445514690238,18.5787872861712
"26","Afghanistan",1987,140588108,2440107,"Japan",143028215,14.7075524487669,18.7613449533939
"27","Afghanistan",1988,112790272,2010825,"Japan",114801097,14.5140556435858,18.5410406521745
"28","Afghanistan",1989,94093545,1840640,"Japan",95934185,14.4256238951947,18.3598000049657
"29","Afghanistan",1990,120889169,1981213,"Japan",122870382,14.4992198413545,18.6103847251368
"30","Afghanistan",1991,116073620,2663330,"Japan",118736950,14.7950877775091,18.5697352029346
"31","Afghanistan",1992,87027590,1285833,"Japan",88313423,14.0669173153161,18.2817357527817
"32","Afghanistan",1993,92021964,1366781,"Japan",93388745,14.1279688980438,18.3375378456501
"33","Afghanistan",1994,81038199,1097206,"Japan",82135405,13.9082775064958,18.2104311940645
"34","Afghanistan",1995,84442749,911532,"Japan",85354281,13.7228819794512,18.2515843360753
"35","Afghanistan",1996,104792585,1776562,"Japan",106569147,14.3901905939187,18.4674935735313
"36","Afghanistan",1997,60670506,1069246,"Japan",61739752,13.8824642851422,17.9209682400848
"37","Afghanistan",1998,59310000,1177000,"Japan",60487000,13.9784793862424,17.8982884838149
"38","Afghanistan",1999,66387024,727230,"Japan",67114254,13.4969980751199,18.0110121736626
"39","Afghanistan",2000,51507256,432423,"Japan",51939679,12.9771595548219,17.7572332489133
"40","Afghanistan",2001,44734459,153395,"Japan",44887854,11.94077157286,17.6162546574516
"41","Afghanistan",2002,83561306,1444568,"Japan",85005874,14.1833208728929,18.2410911240183
"42","Afghanistan",2003,104534555,1828330,"Japan",106362885,14.4189135398676,18.4650282445664
"43","Afghanistan",2004,65994023,965918,"Japan",66959941,13.7808342234633,18.0050747352838
"44","Afghanistan",2005,76454887,2387662,"Japan",78842549,14.6858252024382,18.1522114124297
"45","Afghanistan",2006,68185524,545399,"Japan",68730923,13.2092729158753,18.0377428422192
"46","Afghanistan",2007,89678015,234471,"Japan",89912486,12.3650871918436,18.3117362022281
"47","Afghanistan",2008,114806195,647855,"Japan",115454050,13.3814221848631,18.5587560038084
"48","Afghanistan",2009,113265316,412050,"Japan",113677366,12.9288999801915,18.5452435538013
"49","Afghanistan",2010,96876560,391401,"Japan",97267961,12.8774878888719,18.3889481487339
"50","Afghanistan",2011,105034202,423878,"Japan",105458080,12.9572009569611,18.4697965884155
"51","Afghanistan",2012,99703049,350181,"Japan",100053230,12.7662054426505,18.4177068162097
"52","Afghanistan",2013,62456169,538885,"Japan",62995054,13.1972574690566,17.9499755726836
"53","Afghanistan",2014,26814232,445842,"Japan",27260074,13.0077199081476,17.1044433493028
"54","Afghanistan",2015,25105864,550219,"Japan",25656083,13.2180716597735,17.0386120023138
"55","Afghanistan",2016,79754612,416507,"Japan",80171119,12.9396585471705,18.1944651286781
"56","Afghanistan",2017,0,0,"0",0,0,0
"57","Angola",1962,1031000,1914000,"Japan",2945000,14.464705850995,13.8460397629991
"58","Angola",1963,1511000,1373000,"Japan",2884000,14.1325086847501,14.2282822412549
"59","Angola",1964,1992000,1542000,"Japan",3534000,14.2485908331054,14.5046497171267
"60","Angola",1965,3255000,2728000,"Japan",5983000,14.8190792979455,14.9957028336248
"61","Angola",1966,4565000,4821000,"Japan",9386000,15.3884919333878,15.3339290720112
"62","Angola",1967,9038000,10855000,"Japan",19893000,16.2001363612945,16.0169484689534
"63","Angola",1968,9936000,18222000,"Japan",28158000,16.7181402132559,16.1116750831554
"64","Angola",1969,12333000,23430000,"Japan",35763000,16.969527810484,16.3277891545481
"65","Angola",1970,16324000,40191000,"Japan",56515000,17.5091536479272,16.6081469755078
"66","Angola",1971,21940000,69374000,"Japan",91314000,18.0550227155126,16.9038220128114
"67","Angola",1972,20952000,71178000,"Japan",92130000,18.0806943398713,16.8577446651697
"68","Angola",1973,29938000,81048000,"Japan",110986000,18.2105521297157,17.2146391344573
"69","Angola",1974,29923000,101260000,"Japan",131183000,18.433202024506,17.2141379734238
"70","Angola",1975,18381000,111512000,"Japan",129893000,18.5296427663919,16.7268280803759
"71","Angola",1976,4190000,40364000,"Japan",44554000,17.5134488565666,15.2482112918983
"72","Angola",1977,37850000,10306000,"Japan",48156000,16.1482368078703,17.4491415378477
"73","Angola",1978,36046000,6232000,"Japan",42278000,15.6452078665327,17.4003064585349
"74","Angola",1979,29818000,60210000,"Japan",90028000,17.9133490094406,17.2106227959705
"75","Angola",1980,83124000,102781000,"Japan",185905000,18.4481110690004,18.2358440267927
"76","Angola",1981,83058000,28076000,"Japan",111134000,17.1504256768324,18.2350497168979
"77","Angola",1982,52042000,1511000,"Japan",53553000,14.2282822412549,17.7675616428455
"78","Angola",1983,25197000,3616000,"Japan",28813000,15.1008790004942,17.0422354977759
"79","Angola",1984,21197594,740792,"Japan",21938386,13.5154751631197,16.8693982426357
"80","Angola",1985,45837512,1131821,"Japan",46969333,13.9393383980334,17.6406133531561
"81","Angola",1986,18365331,535861,"Japan",18901192,13.1916300780633,16.7259752604876
"82","Angola",1987,22391058,12048405,"Japan",34439463,16.3044428439947,16.9241722406966
"83","Angola",1988,47310459,65178372,"Japan",112488831,17.992638254075,17.672241949526
"84","Angola",1989,25345692,65224328,"Japan",90570020,17.993343086136,17.0481193327315
"85","Angola",1990,29734039,52360674,"Japan",82094713,17.7736663713448,17.2078030417844
"86","Angola",1991,134663787,2890583,"Japan",137554370,14.8769687698476,18.7182917633653
"87","Angola",1992,49545354,4425409,"Japan",53970763,15.3028732615314,17.7183990504693
"88","Angola",1993,33550025,42807494,"Japan",76357519,17.5722237386829,17.3285481665382
"89","Angola",1994,16365403,9224205,"Japan",25589608,16.0373415653155,16.6106800913398
"90","Angola",1995,26555775,13239275,"Japan",39795050,16.3986983486657,17.0947577961237
"91","Angola",1996,36021924,20555263,"Japan",56577187,16.8386275731727,17.3996383110551
"92","Angola",1997,43866919,16793783,"Japan",60660702,16.6365193163608,17.5966710404505
"93","Angola",1998,42892000,18294000,"Japan",61186000,16.7220836951984,17.5741958863222
"94","Angola",1999,12898193,8258808,"Japan",21157001,15.9267908251561,16.3725977820007
"95","Angola",2000,25423546,2553502,"Japan",27977048,14.7529763083082,17.0511863104563
"96","Angola",2001,30602085,20825280,"Japan",51427365,16.8516781913049,17.2365787018563
"97","Angola",2002,34769614,356533596,"Japan",391303210,19.6919390318076,17.3642544023981
"98","Angola",2003,52627678,76105769,"Japan",128733447,18.1476346281058,17.7787527370331
"99","Angola",2004,303583929,7810540,"Japan",311394469,15.8709846615511,19.531168667302
"100","Angola",2005,118081230,16432830,"Japan",134514060,16.6147917210725,18.5868833354289
"101","Angola",2006,186874927,638494249,"Japan",825369176,20.2746232263485,19.0459501114737
"102","Angola",2007,207654362,171508636,"Japan",379162998,18.9601441789876,19.1513855343217
"103","Angola",2008,317334852,23276313,"Japan",340611165,16.962946791996,19.5754680897904
"104","Angola",2009,178299362,21766717,"Japan",200066079,16.8958926179802,18.998974504588
"105","Angola",2010,131027264,80573634,"Japan",211600898,18.2046820323728,18.6909159816484
"106","Angola",2011,142218825,26855955,"Japan",169074780,17.1059981420374,18.7728774505377
"107","Angola",2012,257271092,383473990,"Japan",640745082,19.7647823537857,19.3656409195992
"108","Angola",2013,287108719,385639333,"Japan",672748052,19.7704131201666,19.4753715138395
"109","Angola",2014,304591125,554270303,"Japan",858861428,20.1331630372738,19.5344808614283
"110","Angola",2015,82562238,239938521,"Japan",322500759,19.295893285991,18.2290629668883
"111","Angola",2016,31496889,20917557,"Japan",52414446,16.8560994121392,17.2653993370138
"112","Angola",2017,0,0,"0",0,0,0
"113","Albania",1962,11000,86000,"Japan",97000,11.3621025752356,9.30565055178051
"114","Albania",1963,1000,9000,"Japan",10000,9.10497985631836,6.90775527898214
"115","Albania",1964,50000,5000,"Japan",55000,8.51719319141624,10.8197782844103
"116","Albania",1965,92000,2000,"Japan",94000,7.60090245954208,11.4295438560312
"117","Albania",1966,53000,17000,"Japan",70000,9.74096862303835,10.8780471925343
"118","Albania",1967,123000,10000,"Japan",133000,9.21034037197618,11.7199396343546
"119","Albania",1968,176000,2000,"Japan",178000,7.60090245954208,12.0782392740203
"120","Albania",1969,159000,0,"Japan",159000,0,11.9766594812024
"121","Albania",1970,787000,0,"Japan",787000,0,13.5759835273995
"122","Albania",1971,87000,392000,"Japan",479000,12.8790171187726,11.3736633976367
"123","Albania",1972,112000,77000,"Japan",189000,11.2515607008358,11.6262541502772
"124","Albania",1973,92000,348000,"Japan",440000,12.7599577587566,11.4295438560312
"125","Albania",1974,830000,14000,"Japan",844000,9.5468126085974,13.6291809797728
"126","Albania",1975,753000,7577000,"Japan",8330000,15.8406279009135,13.531820506782
"127","Albania",1976,2348000,550000,"Japan",2898000,13.2176735572087,14.6690744599301
"128","Albania",1977,889000,3796000,"Japan",4685000,15.149458438712,13.697852514496
"129","Albania",1978,2198000,179000,"Japan",2377000,12.0951410848229,14.6030584139457
"130","Albania",1979,4111000,2469000,"Japan",6580000,14.7193237683273,15.22917686588
"131","Albania",1980,1619000,25000,"Japan",1644000,10.1266311038503,14.2973192326598
"132","Albania",1981,5373000,3214000,"Japan",8587000,14.9830268252796,15.496896969711
"133","Albania",1982,10297000,3817000,"Japan",14114000,15.1549753317274,16.1473631486389
"134","Albania",1983,4534000,5713000,"Japan",10247000,15.5582548377066,15.3271151100496
"135","Albania",1984,2563305,4443232,"Japan",7006537,15.3068925975253,14.7568079994366
"136","Albania",1985,243793,10895313,"Japan",11139106,16.2038432547229,12.404074783558
"137","Albania",1986,626738,4612252,"Japan",5238990,15.3442267989478,13.3482838694471
"138","Albania",1987,196133,4242956,"Japan",4439089,15.2607707541095,12.1865482795157
"139","Albania",1988,286844,9521413,"Japan",9808257,16.0690538201235,12.5666937929558
"140","Albania",1989,111825,10406338,"Japan",10518163,16.1579256015657,11.624690428301
"141","Albania",1990,1133807,8680480,"Japan",9814287,15.9765873846467,13.9410915547817
"142","Albania",1991,113191,7482503,"Japan",7595694,15.8280779196444,11.6368319362902
"143","Albania",1992,134117,4440572,"Japan",4574689,15.3062937549395,11.8064678323014
"144","Albania",1993,1561786,3131087,"Japan",4692873,14.9568907865721,14.2613405961547
"145","Albania",1994,387244,1264359,"Japan",1651603,14.0500758323505,12.8668102642921
"146","Albania",1995,1554176,2813744,"Japan",4367920,14.8500265388152,14.25645605961
"147","Albania",1996,662684,4345645,"Japan",5008329,15.2846847521548,13.4040535341301
"148","Albania",1997,902538,719589,"Japan",1622127,13.4864354946715,13.7129660735659
"149","Albania",1998,557000,735000,"Japan",1292000,13.507625778195,13.2303205189094
"150","Albania",1999,2579078,719159,"Japan",3298237,13.4858377527281,14.7629425286869
"151","Albania",2000,3762341,619336,"Japan",4381677,13.3364032153836,15.1405519280101
"152","Albania",2001,9248351,578087,"Japan",9826438,13.2674796553588,16.0399558233263
"153","Albania",2002,7709305,448935,"Japan",8158240,13.0146333900978,15.8579385988046
"154","Albania",2003,7514294,585590,"Japan",8099884,13.2803751649807,15.8323176313136
"155","Albania",2004,10134667,531827,"Japan",10666494,13.1840735274688,16.1314724808904
"156","Albania",2005,10188072,843163,"Japan",11031235,13.6449155753511,16.1367281821943
"157","Albania",2006,11845937,479649,"Japan",12325586,13.0808098653904,16.287495497554
"158","Albania",2007,18370699,817933,"Japan",19188632,13.6145357051399,16.7262675076378
"159","Albania",2008,26839723,1279421,"Japan",28119144,14.0619181898075,17.1053935495972
"160","Albania",2009,19508798,1468839,"Japan",20977637,14.1999828507834,16.7863761012703
"161","Albania",2010,18020691,1854555,"Japan",19875246,14.4331553330617,16.7070311556912
"162","Albania",2011,2216513,2765062,"Japan",4981575,14.8325736158337,14.6114457982527
"163","Albania",2012,1534767,2164386,"Japan",3699153,14.5876472764245,14.243889135951
"164","Albania",2013,1754259,3917849,"Japan",5672108,15.1810533366725,14.377557103499
"165","Albania",2014,4753098,5114239,"Japan",9867337,15.4475391681957,15.3743071739403
"166","Albania",2015,1263266,6732507,"Japan",7995773,15.7224581434,14.0492109888171
"167","Albania",2016,5321934,8179985,"Japan",13501919,15.9172008748364,15.48734732909
"168","Albania",2017,9289679.5,4066233.5,"Japan",13355913,15.2182276989687,16.0444146107331
"169","United Arab Emirates",1962,0,0,"0",0,0,0
"170","United Arab Emirates",1963,0,0,"0",0,0,0
"171","United Arab Emirates",1964,0,0,"0",0,0,0
"172","United Arab Emirates",1965,0,0,"0",0,0,0
"173","United Arab Emirates",1966,0,0,"0",0,0,0
"174","United Arab Emirates",1967,0,0,"0",0,0,0
"175","United Arab Emirates",1968,0,0,"0",0,0,0
"176","United Arab Emirates",1969,0,0,"0",0,0,0
"177","United Arab Emirates",1970,0,0,"0",0,0,0
"178","United Arab Emirates",1971,0,0,"0",0,0,0
"179","United Arab Emirates",1972,96281000,225854000,"Japan",322135000,19.2353993307781,18.3827815571983
"180","United Arab Emirates",1973,161641000,551754000,"Japan",713395000,20.128612852735,18.9008883847429
"181","United Arab Emirates",1974,308634000,2114895000,"Japan",2423529000,21.4722710028222,19.5476666668083
"182","United Arab Emirates",1975,420145000,1780563000,"Japan",2200708000,21.3001954433754,19.856110447756
"183","United Arab Emirates",1976,636248000,2468098000,"Japan",3104346000,21.626713650467,20.2710989824056
"184","United Arab Emirates",1977,845895000,2748151000,"Japan",3594046000,21.7341941588507,20.5559057963926
"185","United Arab Emirates",1978,1015308000,2621907000,"Japan",3637215000,21.6871677525513,20.7384578516849
"186","United Arab Emirates",1979,1125287000,3633356000,"Japan",4758643000,22.013422576026,20.8413039511786
"187","United Arab Emirates",1980,1355879000,8190408000,"Japan",9546287000,22.8262295504204,21.0277157894448
"188","United Arab Emirates",1981,1664305000,8835997000,"Japan",10500302000,22.9020997829841,21.2326734558185
"189","United Arab Emirates",1982,1651548000,7982865000,"Japan",9634413000,22.8005632065313,21.2249788668596
"190","United Arab Emirates",1983,1356679000,7792794000,"Japan",9149473000,22.7764652974792,21.0283056386006
"191","United Arab Emirates",1984,1126288461,7028920576,"Japan",8155209037,22.6732989856027,20.8421935159153
"192","United Arab Emirates",1985,1164846388,8139280051,"Japan",9304126439,22.8199675672262,20.8758550594763
"193","United Arab Emirates",1986,1032522575,5445324404,"Japan",6477846979,22.4180231698854,20.7552707469672
"194","United Arab Emirates",1987,1117740154,4981145313,"Japan",6098885467,22.3289256840712,20.834574764272
"195","United Arab Emirates",1988,1283166860,4757926177,"Japan",6041093037,22.2830777331541,20.9725969686832
"196","United Arab Emirates",1989,1293149572,5576275049,"Japan",6869424621,22.4417868364836,20.9803466083135
"197","United Arab Emirates",1990,1559346359,8208742628,"Japan",9768088987,22.828465597403,21.1675325697615
"198","United Arab Emirates",1991,1417737462,9550783315,"Japan",10968520777,22.9798890105885,21.0723281012291
"199","United Arab Emirates",1992,1829727366,8877949536,"Japan",10707676902,22.906836459179,21.3274328123732
"200","United Arab Emirates",1993,1742340233,8228443633,"Japan",9970783866,22.8308627247605,21.2784950080166
"201","United Arab Emirates",1994,2261963693,8272518770,"Japan",10534482463,22.8362048667209,21.5394991636716
"202","United Arab Emirates",1995,2110627891,9215728766,"Japan",11326356657,22.9441775096943,21.4702513188396
"203","United Arab Emirates",1996,2309836889,10404619004,"Japan",12714455893,23.065515679495,21.5604427481645
"204","United Arab Emirates",1997,2864819695,7482924795,"Japan",10347744490,22.7358895678805,21.7757712514503
"205","United Arab Emirates",1998,2569179000,8330896000,"Japan",10900075000,22.8432368503659,21.6668522295639
"206","United Arab Emirates",1999,3125797948,7962118184,"Japan",11087916132,22.797960904921,21.8629554309002
"207","United Arab Emirates",2000,3135278617,13401999449,"Japan",16537278066,23.3186697453841,21.8659838801286
"208","United Arab Emirates",2001,3137423865,11511455932,"Japan",14648879797,23.1666085444695,21.8666678749744
"209","United Arab Emirates",2002,2824029175,10440346814,"Japan",13264375989,23.0689436385809,21.7614304876147
"210","United Arab Emirates",2003,3443833455,13029567522,"Japan",16473400977,23.2904870365884,21.9598510643287
"211","United Arab Emirates",2004,4557085954,16650673166,"Japan",21207759120,23.535716482946,22.2399492110209
"212","United Arab Emirates",2005,4204275391,22951390009,"Japan",27155665400,23.8566443384598,22.1593677947138
"213","United Arab Emirates",2006,5900448683,28827712190,"Japan",34728160873,24.0846029902624,22.4982942329327
"214","United Arab Emirates",2007,7248129925,29063011272,"Japan",36311141197,24.0927321122941,22.7040093311611
"215","United Arab Emirates",2008,10362188950,43886910067,"Japan",54249099017,24.5048819364138,23.0614293400695
"216","United Arab Emirates",2009,7454751764,20383049178,"Japan",27837800942,23.7379694697419,22.7321174866879
"217","United Arab Emirates",2010,7749580969,26463915901,"Japan",34213496870,23.9990479779184,22.7709046103338
"218","United Arab Emirates",2011,7320857350,40790832776,"Japan",48111690126,24.4317232062479,22.7139932823781
"219","United Arab Emirates",2012,8866911571,42241678681,"Japan",51108590252,24.4666732170557,22.905592384474
"220","United Arab Emirates",2013,8370435738,41331648760,"Japan",49702084498,24.4448943572463,22.847971779591
"221","United Arab Emirates",2014,9389187175,39926034196,"Japan",49315221371,24.410294434181,22.962824563587
"222","United Arab Emirates",2015,8518913067,22197878740,"Japan",30716791807,23.823262569007,22.8655545953536
"223","United Arab Emirates",2016,7833474462,15937683142,"Japan",23771157604,23.4919521510618,22.7816719856917
"224","United Arab Emirates",2017,0,0,"0",0,0,0
"225","Argentina",1962,63941000,34462000,"Japan",98403000,17.3553678256852,17.9734713411359
"226","Argentina",1963,47074000,42016000,"Japan",89090000,17.5535610560847,17.667231389584
"227","Argentina",1964,23505000,55895000,"Japan",79400000,17.8389854886866,16.9727237224404
"228","Argentina",1965,44069000,47944000,"Japan",92013000,17.6855442211202,17.6012671453876
"229","Argentina",1966,32167000,53337000,"Japan",85504000,17.7921408321668,17.2864516402817
"230","Argentina",1967,41448000,52260000,"Japan",93708000,17.7717418180567,17.5399501874768
"231","Argentina",1968,41591000,41102000,"Japan",82693000,17.531567340083,17.5433943556714
"232","Argentina",1969,65127000,96421000,"Japan",161548000,18.3842345781802,17.991849767739
"233","Argentina",1970,85767000,153817000,"Japan",239584000,18.8512741420874,18.2671448750901
"234","Argentina",1971,156764000,119511000,"Japan",276275000,18.5989189753087,18.8702520476836
"235","Argentina",1972,142791000,78208000,"Japan",220999000,18.1748825020733,18.7768925806735
"236","Argentina",1973,256429000,168456000,"Japan",424885000,18.9421851460605,19.3623623811391
"237","Argentina",1974,391593000,230510000,"Japan",622103000,19.2558048034079,19.7857335930778
"238","Argentina",1975,493613000,213653000,"Japan",707266000,19.1798637616126,20.0172623673237
"239","Argentina",1976,249971000,253157000,"Japan",503128000,19.3495204075879,19.336855469098
"240","Argentina",1977,363990000,418804000,"Japan",782794000,19.8529135880134,19.7126369526962
"241","Argentina",1978,267261000,461396000,"Japan",728657000,19.9497672343989,19.403736266985
"242","Argentina",1979,356327000,529174000,"Japan",885501000,20.0868278582347,19.6913594065431
"243","Argentina",1980,977201000,287198000,"Japan",1264399000,19.4756824313258,20.7002029206793
"244","Argentina",1981,965382000,281091000,"Japan",1246473000,19.4541890182884,20.6880344358957
"245","Argentina",1982,429588000,413123000,"Japan",842711000,19.8392559274087,19.8783371678079
"246","Argentina",1983,311658000,543718000,"Japan",855376000,20.1139412880607,19.5574169907116
"247","Argentina",1984,339944382,439262966,"Japan",779207348,19.9006088030933,19.6442925798405
"248","Argentina",1985,225467896,394442299,"Japan",619910195,19.7929834239278,19.2336883387008
"249","Argentina",1986,306607772,453961400,"Japan",760569172,19.9335227303646,19.5410798730696
"250","Argentina",1987,398272326,269742450,"Japan",668014776,19.4129781728322,19.8026465654468
"251","Argentina",1988,349569529,445720761,"Japan",795290290,19.9152032174916,19.6722130383361
"252","Argentina",1989,164957129,376119004,"Japan",541076133,19.7454161512786,18.9211961738623
"253","Argentina",1990,164736232,499937687,"Japan",664673919,20.02999402262,18.9198561588108
"254","Argentina",1991,544080555,543963306,"Japan",1088043861,20.1143923503393,20.1146078729017
"255","Argentina",1992,633520196,461942329,"Japan",1095462525,19.9509506122499,20.2668024372489
"256","Argentina",1993,602120655,442680421,"Japan",1044801076,19.908358670386,20.215968406779
"257","Argentina",1994,563283162,391998728,"Japan",955281890,19.7867691528515,20.1492930117086
"258","Argentina",1995,642997498,383592409,"Japan",1026589907,19.7650911119352,20.281651391059
"259","Argentina",1996,656048581,473164376,"Japan",1129212957,19.9749534040562,20.3017454005688
"260","Argentina",1997,1344832421,634587571,"Japan",1979419992,20.2684858513559,21.0195352481857
"261","Argentina",1998,1450018000,703440000,"Japan",2153458000,20.371493143035,21.0948418070949
"262","Argentina",1999,969426679,487154129,"Japan",1456580808,20.0040911176285,20.692215402144
"263","Argentina",2000,902962239,410465384,"Japan",1313427623,19.8328021568699,20.6211912932311
"264","Argentina",2001,691356846,368440528,"Japan",1059797374,19.7247898671524,20.3541666681148
"265","Argentina",2002,283418415,406182263,"Japan",689600678,19.8223125404753,19.4624348619383
"266","Argentina",2003,358489348,397385417,"Japan",755874765,19.8004171913845,19.6974095048707
"267","Argentina",2004,553096137,414037086,"Japan",967133223,19.8414661074877,20.13104239067
"268","Argentina",2005,506721246,297238805,"Japan",803960051,19.5100464309252,20.0434715997033
"269","Argentina",2006,845265554,441569906,"Japan",1286835460,19.9058469029601,20.5551614010393
"270","Argentina",2007,1029710078,734267686,"Japan",1763977764,20.4143842149167,20.7525431218958
"271","Argentina",2008,1185460079,632788250,"Japan",1818248329,20.2656464059773,20.8933967885038
"272","Argentina",2009,782533890,571346091,"Japan",1353879981,20.1635056978429,20.4780477893449
"273","Argentina",2010,1016613140,899367170,"Japan",1915980310,20.6172019295221,20.7397424883313
"274","Argentina",2011,968289179,1081203409,"Japan",2049492588,20.8013405253398,20.6910413392637
"275","Argentina",2012,1129116231,1241866651,"Japan",2370982882,20.9398814483489,20.8447010672135
"276","Argentina",2013,1105547479,1847808354,"Japan",2953355833,21.3372661002428,20.8236065053269
"277","Argentina",2014,1053498131,911985405,"Japan",1965483536,20.6311345446211,20.7753820171206
"278","Argentina",2015,794357629,787850567,"Japan",1582208196,20.4848189940522,20.493044332163
"279","Argentina",2016,629363249,752975623,"Japan",1382338872,20.4395434120662,20.2602191503591
"280","Argentina",2017,878003357.5,684037771,"Japan",1562041128.5,20.3435236948224,20.593160975624
"281","Armenia",1962,0,0,"0",0,0,0
"282","Armenia",1963,0,0,"0",0,0,0
"283","Armenia",1964,0,0,"0",0,0,0
"284","Armenia",1965,0,0,"0",0,0,0
"285","Armenia",1966,0,0,"0",0,0,0
"286","Armenia",1967,0,0,"0",0,0,0
"287","Armenia",1968,0,0,"0",0,0,0
"288","Armenia",1969,0,0,"0",0,0,0
"289","Armenia",1970,0,0,"0",0,0,0
"290","Armenia",1971,0,0,"0",0,0,0
"291","Armenia",1972,0,0,"0",0,0,0
"292","Armenia",1973,0,0,"0",0,0,0
"293","Armenia",1974,0,0,"0",0,0,0
"294","Armenia",1975,0,0,"0",0,0,0
"295","Armenia",1976,0,0,"0",0,0,0
"296","Armenia",1977,0,0,"0",0,0,0
"297","Armenia",1978,0,0,"0",0,0,0
"298","Armenia",1979,0,0,"0",0,0,0
"299","Armenia",1980,0,0,"0",0,0,0
"300","Armenia",1981,0,0,"0",0,0,0
"301","Armenia",1982,0,0,"0",0,0,0
"302","Armenia",1983,0,0,"0",0,0,0
"303","Armenia",1984,0,0,"0",0,0,0
"304","Armenia",1985,0,0,"0",0,0,0
"305","Armenia",1986,0,0,"0",0,0,0
"306","Armenia",1987,0,0,"0",0,0,0
"307","Armenia",1988,0,0,"0",0,0,0
"308","Armenia",1989,0,0,"0",0,0,0
"309","Armenia",1990,0,0,"0",0,0,0
"310","Armenia",1991,0,0,"0",0,0,0
"311","Armenia",1992,200219,261144,"Japan",461363,12.472827258299,12.207167046455
"312","Armenia",1993,64520,0,"Japan",64520,0,11.0747305322391
"313","Armenia",1994,47083,126054,"Japan",173137,11.7444656655517,10.7596672806695
"314","Armenia",1995,94545,179780,"Japan",274325,12.0994891601274,11.4568311906153
"315","Armenia",1996,165702,108561,"Japan",274263,11.5950675059623,12.0179462733478
"316","Armenia",1997,1884778,5332470,"Japan",7217248,15.4893251034328,14.4493206000453
"317","Armenia",1998,1564000,5802000,"Japan",7366000,15.5737132436635,14.2627572000874
"318","Armenia",1999,1162224,631537,"Japan",1793761,13.3559118097135,13.9658459689004
"319","Armenia",2000,1572991,110698,"Japan",1683689,11.6145610516862,14.2684894604729
"320","Armenia",2001,347665,915646,"Japan",1263311,13.7273851060781,12.7589946514395
"321","Armenia",2002,535249,2476108,"Japan",3011357,14.7221985305753,13.1904873381643
"322","Armenia",2003,3640782,1863137,"Japan",5503919,14.4377721841854,15.107709051704
"323","Armenia",2004,1334636,528419,"Japan",1863055,13.1776448085917,14.1041691534622
"324","Armenia",2005,1021148,1101015,"Japan",2122163,13.9117430395902,13.8364380425673
"325","Armenia",2006,1821184,338893,"Japan",2160077,12.7334397023213,14.414997396988
"326","Armenia",2007,3619080,4533963,"Japan",8153043,15.3271069494517,15.1017304078556
"327","Armenia",2008,74817706,531012,"Japan",75348718,13.1825398988388,18.130565126163
"328","Armenia",2009,38868012,1853180,"Japan",40721192,14.4324136403231,17.4756821566787
"329","Armenia",2010,49838266,3096121,"Japan",52934387,14.9456605956154,17.724293640506
"330","Armenia",2011,13356842,2231246,"Japan",15588088,14.6180707317914,16.4075393208858
"331","Armenia",2012,20388546,1729387,"Japan",22117933,14.3632775684223,16.8304838305426
"332","Armenia",2013,10677292,3379997,"Japan",14057289,15.0333853798848,16.1836298012926
"333","Armenia",2014,10965930,9181335,"Japan",20147265,16.0326831768601,16.210303751559
"334","Armenia",2015,8933347,10631679,"Japan",19565026,16.1793486870458,16.0053016866626
"335","Armenia",2016,19229363,12220401,"Japan",31449764,16.3186173262266,16.7719489916913
"336","Armenia",2017,27544044.5,9531151.5,"Japan",37075196,16.0700760972923,17.1312968995961
"337","Antarctica",1962,0,0,"0",0,0,0
"338","Antarctica",1963,0,0,"0",0,0,0
"339","Antarctica",1964,0,0,"0",0,0,0
"340","Antarctica",1965,0,0,"0",0,0,0
"341","Antarctica",1966,0,0,"0",0,0,0
"342","Antarctica",1967,0,0,"0",0,0,0
"343","Antarctica",1968,0,0,"0",0,0,0
"344","Antarctica",1969,0,0,"0",0,0,0
"345","Antarctica",1970,0,0,"0",0,0,0
"346","Antarctica",1971,0,0,"0",0,0,0
"347","Antarctica",1972,0,0,"0",0,0,0
"348","Antarctica",1973,0,0,"0",0,0,0
"349","Antarctica",1974,0,0,"0",0,0,0
"350","Antarctica",1975,0,0,"0",0,0,0
"351","Antarctica",1976,0,0,"0",0,0,0
"352","Antarctica",1977,0,0,"0",0,0,0
"353","Antarctica",1978,0,0,"0",0,0,0
"354","Antarctica",1979,0,0,"0",0,0,0
"355","Antarctica",1980,0,0,"0",0,0,0
"356","Antarctica",1981,0,0,"0",0,0,0
"357","Antarctica",1982,0,0,"0",0,0,0
"358","Antarctica",1983,0,0,"0",0,0,0
"359","Antarctica",1984,0,0,"0",0,0,0
"360","Antarctica",1985,0,0,"0",0,0,0
"361","Antarctica",1986,0,0,"0",0,0,0
"362","Antarctica",1987,0,0,"0",0,0,0
"363","Antarctica",1988,0,0,"0",0,0,0
"364","Antarctica",1989,0,0,"0",0,0,0
"365","Antarctica",1990,0,0,"0",0,0,0
"366","Antarctica",1991,0,0,"0",0,0,0
"367","Antarctica",1992,0,0,"0",0,0,0
"368","Antarctica",1993,0,0,"0",0,0,0
"369","Antarctica",1994,0,0,"0",0,0,0
"370","Antarctica",1995,0,0,"0",0,0,0
"371","Antarctica",1996,0,0,"0",0,0,0
"372","Antarctica",1997,0,0,"0",0,0,0
"373","Antarctica",1998,0,0,"0",0,0,0
"374","Antarctica",1999,0,0,"0",0,0,0
"375","Antarctica",2000,26732,1150112,"Japan",1176844,13.9553698869016,10.193616628631
"376","Antarctica",2001,0,0,"0",0,0,0
"377","Antarctica",2002,0,0,"0",0,0,0
"378","Antarctica",2003,0,0,"0",0,0,0
"379","Antarctica",2004,0,0,"0",0,0,0
"380","Antarctica",2005,0,0,"0",0,0,0
"381","Antarctica",2006,0,0,"0",0,0,0
"382","Antarctica",2007,30511,0,"Japan",30511,0,10.3258425533126
"383","Antarctica",2008,0,0,"0",0,0,0
"384","Antarctica",2009,0,4557,"Japan",4557,8.42441979126388,0
"385","Antarctica",2010,0,0,"0",0,0,0
"386","Antarctica",2011,0,7787,"Japan",7787,8.96021095557699,0
"387","Antarctica",2012,0,0,"0",0,0,0
"388","Antarctica",2013,0,0,"0",0,0,0
"389","Antarctica",2014,7073,0,"Japan",7073,0,8.86403999703599
"390","Antarctica",2015,5785,0,"Japan",5785,0,8.66302363962778
"391","Antarctica",2016,0,0,"0",0,0,0
"392","Antarctica",2017,0,0,"0",0,0,0
"393","French Southern and Antarctic Lands",1962,0,0,"0",0,0,0
"394","French Southern and Antarctic Lands",1963,0,0,"0",0,0,0
"395","French Southern and Antarctic Lands",1964,0,0,"0",0,0,0
"396","French Southern and Antarctic Lands",1965,0,0,"0",0,0,0
"397","French Southern and Antarctic Lands",1966,0,0,"0",0,0,0
"398","French Southern and Antarctic Lands",1967,0,0,"0",0,0,0
"399","French Southern and Antarctic Lands",1968,0,0,"0",0,0,0
"400","French Southern and Antarctic Lands",1969,0,0,"0",0,0,0
"401","French Southern and Antarctic Lands",1970,0,0,"0",0,0,0
"402","French Southern and Antarctic Lands",1971,0,0,"0",0,0,0
"403","French Southern and Antarctic Lands",1972,0,0,"0",0,0,0
"404","French Southern and Antarctic Lands",1973,0,0,"0",0,0,0
"405","French Southern and Antarctic Lands",1974,0,0,"0",0,0,0
"406","French Southern and Antarctic Lands",1975,0,0,"0",0,0,0
"407","French Southern and Antarctic Lands",1976,0,0,"0",0,0,0
"408","French Southern and Antarctic Lands",1977,0,0,"0",0,0,0
"409","French Southern and Antarctic Lands",1978,0,0,"0",0,0,0
"410","French Southern and Antarctic Lands",1979,0,0,"0",0,0,0
"411","French Southern and Antarctic Lands",1980,0,0,"0",0,0,0
"412","French Southern and Antarctic Lands",1981,0,0,"0",0,0,0
"413","French Southern and Antarctic Lands",1982,0,0,"0",0,0,0
"414","French Southern and Antarctic Lands",1983,0,0,"0",0,0,0
"415","French Southern and Antarctic Lands",1984,0,0,"0",0,0,0
"416","French Southern and Antarctic Lands",1985,0,0,"0",0,0,0
"417","French Southern and Antarctic Lands",1986,0,0,"0",0,0,0
"418","French Southern and Antarctic Lands",1987,0,0,"0",0,0,0
"419","French Southern and Antarctic Lands",1988,0,0,"0",0,0,0
"420","French Southern and Antarctic Lands",1989,0,0,"0",0,0,0
"421","French Southern and Antarctic Lands",1990,0,0,"0",0,0,0
"422","French Southern and Antarctic Lands",1991,0,0,"0",0,0,0
"423","French Southern and Antarctic Lands",1992,0,0,"0",0,0,0
"424","French Southern and Antarctic Lands",1993,0,0,"0",0,0,0
"425","French Southern and Antarctic Lands",1994,0,0,"0",0,0,0
"426","French Southern and Antarctic Lands",1995,0,0,"0",0,0,0
"427","French Southern and Antarctic Lands",1996,0,0,"0",0,0,0
"428","French Southern and Antarctic Lands",1997,0,0,"0",0,0,0
"429","French Southern and Antarctic Lands",1998,0,0,"0",0,0,0
"430","French Southern and Antarctic Lands",1999,0,0,"0",0,0,0
"431","French Southern and Antarctic Lands",2000,0,0,"0",0,0,0
"432","French Southern and Antarctic Lands",2001,0,0,"0",0,0,0
"433","French Southern and Antarctic Lands",2002,0,0,"0",0,0,0
"434","French Southern and Antarctic Lands",2003,0,0,"0",0,0,0
"435","French Southern and Antarctic Lands",2004,0,0,"0",0,0,0
"436","French Southern and Antarctic Lands",2005,0,0,"0",0,0,0
"437","French Southern and Antarctic Lands",2006,0,0,"0",0,0,0
"438","French Southern and Antarctic Lands",2007,0,0,"0",0,0,0
"439","French Southern and Antarctic Lands",2008,0,0,"0",0,0,0
"440","French Southern and Antarctic Lands",2009,0,0,"0",0,0,0
"441","French Southern and Antarctic Lands",2010,0,0,"0",0,0,0
"442","French Southern and Antarctic Lands",2011,0,0,"0",0,0,0
"443","French Southern and Antarctic Lands",2012,0,0,"0",0,0,0
"444","French Southern and Antarctic Lands",2013,0,0,"0",0,0,0
"445","French Southern and Antarctic Lands",2014,0,0,"0",0,0,0
"446","French Southern and Antarctic Lands",2015,0,0,"0",0,0,0
"447","French Southern and Antarctic Lands",2016,0,0,"0",0,0,0
"448","French Southern and Antarctic Lands",2017,0,0,"0",0,0,0
"449","Australia",1962,138503000,435557000,"Japan",574060000,19.8921362297336,18.7464025440069
"450","Australia",1963,155085000,514374000,"Japan",669459000,20.0584611852868,18.859483911671
"451","Australia",1964,223672000,581837000,"Japan",805509000,20.1817008977406,19.225691250991
"452","Australia",1965,317506000,552096000,"Japan",869602000,20.1292325021637,19.5760072737563
"453","Australia",1966,295934000,679694000,"Japan",975628000,20.337153254854,19.5056470144532
"454","Australia",1967,349975000,792464000,"Japan",1142439000,20.4906576368164,19.6733722813252
"455","Australia",1968,409237000,921368000,"Japan",1330605000,20.6413700801039,19.8298050082864
"456","Australia",1969,488970000,1243484000,"Japan",1732454000,20.941182954217,20.0078116958639
"457","Australia",1970,573900000,1507820000,"Japan",2081720000,21.1339307360126,20.1679657230786
"458","Australia",1971,726472000,1749069000,"Japan",2475541000,21.2823494833196,20.4037104992821
"459","Australia",1972,745611000,2205163000,"Japan",2950774000,21.5140672660156,20.4297145744457
"460","Australia",1973,1207317000,3496970000,"Japan",4704287000,21.975162716209,20.9116663792107
"461","Australia",1974,2039440000,4029939000,"Japan",6069379000,22.117017076314,21.4359410973139
"462","Australia",1975,1736551000,4160340000,"Japan",5896891000,22.148862638649,21.2751667991384
"463","Australia",1976,2325106000,5358045000,"Japan",7683151000,22.4018650066898,21.5670314663443
"464","Australia",1977,2368001000,5285082000,"Japan",7653083000,22.3881539717585,21.5853119762654
"465","Australia",1978,2693394000,5298831000,"Japan",7992225000,22.3907520671385,21.7140679453101
"466","Australia",1979,2561908000,6297625000,"Japan",8859533000,22.5634384151405,21.6640181303304
"467","Australia",1980,3373371000,6976487000,"Japan",10349858000,22.6658113318962,21.9391783780832
"468","Australia",1981,4630590000,7419261000,"Japan",12049851000,22.7273452934784,22.2559501267317
"469","Australia",1982,4725434000,6961159000,"Japan",11686593000,22.6636118204178,22.2762252455258
"470","Australia",1983,4281092000,6641500000,"Japan",10922592000,22.6166036785368,22.1774739541843
"471","Australia",1984,4544606164,6607587623,"Japan",11152193787,22.6114844654974,22.237206908236
"472","Australia",1985,4868081062,6668376766,"Japan",11536457828,22.620642303838,22.3059656639462
"473","Australia",1986,4873701144,6308244753,"Japan",11181945897,22.5651233057067,22.3071194738969
"474","Australia",1987,4734527549,7101390157,"Japan",11835917706,22.6835563985886,22.278147780148
"475","Australia",1988,5908903819,9237937935,"Japan",15146841754,22.9465845304867,22.4997261721424
"476","Australia",1989,7219411499,10476764342,"Japan",17696175841,23.0724257221751,22.7000392766952
"477","Australia",1990,6497301156,11170026691,"Japan",17667327847,23.1364998395502,22.5946527208566
"478","Australia",1991,6003737571,11765419611,"Japan",17769157182,23.1884305245331,22.515648040735
"479","Australia",1992,6520479792,11152523341,"Japan",17673003133,23.1349316178585,22.5982137979076
"480","Australia",1993,7188724060,10901063130,"Japan",18089787190,23.1121261562877,22.6957795325698
"481","Australia",1994,7918284718,12148918735,"Japan",20067203453,23.2205060097687,22.7924404433067
"482","Australia",1995,7855894043,12978887489,"Japan",20834781532,23.2865898349189,22.7845299205095
"483","Australia",1996,7056083074,12703583951,"Japan",19759667025,23.2651499914659,22.6771559291077
"484","Australia",1997,7440884446,11641047647,"Japan",19081932093,23.1778032792374,22.7302555558766
"485","Australia",1998,8350152000,12673214000,"Japan",21023366000,23.2627564691975,22.8455455792363
"486","Australia",1999,7787490851,11479139691,"Japan",19266630542,23.1637972852213,22.7757845462278
"487","Australia",2000,7819332295,13224282161,"Japan",21043614456,23.3053205342762,22.7798650035871
"488","Australia",2001,6918910735,12885995264,"Japan",19804905999,23.2794069201321,22.657524185949
"489","Australia",2002,7509235410,12493135836,"Japan",20002371246,23.2484451973059,22.7393994879523
"490","Australia",2003,9344231541,13495441869,"Japan",22839673410,23.3256178260445,22.95802504237
"491","Australia",2004,10844668534,17406532685,"Japan",28251201219,23.580111414373,23.1069394168116
"492","Australia",2005,11499052828,21913410205,"Japan",33412463033,23.8103646244942,23.165530506141
"493","Australia",2006,11508275346,24850542946,"Japan",36358818292,23.936145438184,23.1663322088354
"494","Australia",2007,12702836858,27701812617,"Japan",40404649475,24.0447636854356,23.2650911801122
"495","Australia",2008,14509565913,42573672057,"Japan",57083237970,24.4745018723334,23.3980739869925
"496","Australia",2009,11132733739,30949693571,"Japan",42082427310,24.1556289352526,23.1331555910322
"497","Australia",2010,14175270229,40112211530,"Japan",54287481759,24.4149466518327,23.3747647501528
"498","Australia",2011,15298558933,56462572500,"Japan",71761131433,24.7568438219644,23.4510244735233
"499","Australia",2012,16410131392,56166272506,"Japan",72576403898,24.7515822803488,23.5211647488415
"500","Australia",2013,13441218093,50926742752,"Japan",64367960845,24.6536540204079,23.3215917998542
"501","Australia",2014,11559891096,48081744189,"Japan",59641635285,24.5961684033249,23.170807279385
"502","Australia",2015,10437715511,34764749155,"Japan",45202464666,24.2718697550248,23.0686915746707
"503","Australia",2016,12078554021,30341382314,"Japan",42419936335,24.1357783706068,23.2146973220401
"504","Australia",2017,16339825050.5,31617325933,"Japan",47957150983.5,24.1769710963028,23.5168712194972
"505","Austria",1962,4382000,5245000,"Japan",9627000,15.4727857998125,15.2930157991375
"506","Austria",1963,7360000,6600000,"Japan",13960000,15.7025802069967,15.8115704907051
"507","Austria",1964,8860000,5413000,"Japan",14273000,15.5043140257791,15.9970573225813
"508","Austria",1965,10405000,5845000,"Japan",16250000,15.5810971528883,16.1577970178099
"509","Austria",1966,12171000,6609000,"Japan",18780000,15.7039429144526,16.3145666308567
"510","Austria",1967,12706000,7050000,"Japan",19756000,15.7685381747885,16.3575848808086
"511","Austria",1968,15300000,10070000,"Japan",25370000,16.1250712646947,16.5433633863627
"512","Austria",1969,21820000,14567000,"Japan",36387000,16.4942692544311,16.8983375383692
"513","Austria",1970,33710000,15639000,"Japan",49349000,16.5652783524184,17.3333050872102
"514","Austria",1971,55947000,17580000,"Japan",73527000,16.6822724502213,17.8399153719817
"515","Austria",1972,89040000,26436000,"Japan",115476000,17.0902372755725,18.3045962649316
"516","Austria",1973,123606000,54987000,"Japan",178593000,17.8226073516221,18.632609645499
"517","Austria",1974,127981000,69020000,"Japan",197001000,18.0499068756341,18.667392373366
"518","Austria",1975,140275000,51606000,"Japan",191881000,17.7591485027617,18.7591153396013
"519","Austria",1976,185744000,58416000,"Japan",244160000,17.8831003828776,19.03987993956
"520","Austria",1977,279930000,51464000,"Japan",331394000,17.756393092073,19.4500501298783
"521","Austria",1978,295700000,79196000,"Japan",374896000,18.1874363504587,19.5048559848227
"522","Austria",1979,379979000,130685000,"Japan",510664000,18.6883004053671,19.7556265459997
"523","Austria",1980,589885000,170234000,"Japan",760119000,18.9526845191356,20.1954381606114
"524","Austria",1981,576410000,149859000,"Japan",726269000,18.8252054099835,20.1723297710023
"525","Austria",1982,550461000,149995000,"Japan",700456000,18.8261125181716,20.1262666669308
"526","Austria",1983,678422000,165315000,"Japan",843737000,18.9233633027759,20.3352800711614
"527","Austria",1984,610531010,179661221,"Japan",790192231,19.0065835299128,20.2298396446558
"528","Austria",1985,652212391,169285308,"Japan",821497699,18.9470960624753,20.2958808199124
"529","Austria",1986,1124301618,233060312,"Japan",1357361930,19.2668078278196,20.8404278958366
"530","Austria",1987,1359152957,325412286,"Japan",1684565243,19.6006035086437,21.0301275169226
"531","Austria",1988,1700417287,406883612,"Japan",2107300899,19.8240377369089,21.2541395208287
"532","Austria",1989,1749044879,479278025,"Japan",2228322904,19.987791414967,21.2823356924593
"533","Austria",1990,2063274132,652324267,"Japan",2715598399,20.2960523382819,21.4475599424792
"534","Austria",1991,2225319720,709421679,"Japan",2934741399,20.3799606594647,21.5231664366236
"535","Austria",1992,2317004307,691310535,"Japan",3008314842,20.3540996802034,21.5635409412642
"536","Austria",1993,1928006834,641618660,"Japan",2569625494,20.2795046976348,21.3797525777343
"537","Austria",1994,2138969362,723242879,"Japan",2862212241,20.3992556559373,21.4835899434284
"538","Austria",1995,1476785894,830387808,"Japan",2307173702,20.5374033881872,21.1131338699338
"539","Austria",1996,1455781382,881767157,"Japan",2337548539,20.5974385847874,21.098808625722
"540","Austria",1997,1432505365,554349662,"Japan",1986855027,20.1333062044593,21.0826907517469
"541","Austria",1998,1589570000,603220000,"Japan",2192790000,20.217792530607,21.1867293763514
"542","Austria",1999,1542402995,757635840,"Japan",2300038835,20.4457134060034,21.1566074235977
"543","Austria",2000,1641948671,834047310,"Japan",2475995981,20.5418006853328,21.2191495874393
"544","Austria",2001,1415583460,811933080,"Japan",2227516540,20.5149284809366,21.0708076222758
"545","Austria",2002,1390459448,827762815,"Japan",2218222263,20.5342372159994,21.0529000676028
"546","Austria",2003,1834380570,938964275,"Japan",2773344845,20.6602879906554,21.3299726974327
"547","Austria",2004,2191008272,1171760538,"Japan",3362768810,20.8817731881126,21.5076276729976
"548","Austria",2005,2096757722,1189166228,"Japan",3285923950,20.8965182497613,21.4636580466645
"549","Austria",2006,2182725207,1386660795,"Japan",3569386002,21.0501643881675,21.5038400279834
"550","Austria",2007,2207869903,1442205824,"Japan",3650075727,21.0894396007136,21.5152940428826
"551","Austria",2008,2320439066,1397414751,"Japan",3717853817,21.0578897600595,21.5650222573048
"552","Austria",2009,1748163251,1218724517,"Japan",2966887768,20.9210706709295,21.2818315028395
"553","Austria",2010,1965421749,1351042369,"Japan",3316464118,21.0241422566466,21.3989726897721
"554","Austria",2011,1166798857,1817604997,"Japan",2984403854,21.3207855357171,20.877529816355
"555","Austria",2012,952367021,1823269955,"Japan",2775636976,21.3238974045103,20.67446104472
"556","Austria",2013,924838957,1710162599,"Japan",2635001556,21.259854290075,20.6451301797789
"557","Austria",2014,924941008,1781104017,"Japan",2706045025,21.3004992432543,20.6452405183078
"558","Austria",2015,1033218887,1538699844,"Japan",2571918731,21.1542036396433,20.7559448991195
"559","Austria",2016,1017247133,1671181638,"Japan",2688428771,21.2367967808318,20.7403659264592
"560","Austria",2017,1793999675,1649544748.5,"Japan",3443544423.5,21.2237651767887,21.3077134194236
"561","Azerbaijan",1962,0,0,"0",0,0,0
"562","Azerbaijan",1963,0,0,"0",0,0,0
"563","Azerbaijan",1964,0,0,"0",0,0,0
"564","Azerbaijan",1965,0,0,"0",0,0,0
"565","Azerbaijan",1966,0,0,"0",0,0,0
"566","Azerbaijan",1967,0,0,"0",0,0,0
"567","Azerbaijan",1968,0,0,"0",0,0,0
"568","Azerbaijan",1969,0,0,"0",0,0,0
"569","Azerbaijan",1970,0,0,"0",0,0,0
"570","Azerbaijan",1971,0,0,"0",0,0,0
"571","Azerbaijan",1972,0,0,"0",0,0,0
"572","Azerbaijan",1973,0,0,"0",0,0,0
"573","Azerbaijan",1974,0,0,"0",0,0,0
"574","Azerbaijan",1975,0,0,"0",0,0,0
"575","Azerbaijan",1976,0,0,"0",0,0,0
"576","Azerbaijan",1977,0,0,"0",0,0,0
"577","Azerbaijan",1978,0,0,"0",0,0,0
"578","Azerbaijan",1979,0,0,"0",0,0,0
"579","Azerbaijan",1980,0,0,"0",0,0,0
"580","Azerbaijan",1981,0,0,"0",0,0,0
"581","Azerbaijan",1982,0,0,"0",0,0,0
"582","Azerbaijan",1983,0,0,"0",0,0,0
"583","Azerbaijan",1984,0,0,"0",0,0,0
"584","Azerbaijan",1985,0,0,"0",0,0,0
"585","Azerbaijan",1986,0,0,"0",0,0,0
"586","Azerbaijan",1987,0,0,"0",0,0,0
"587","Azerbaijan",1988,0,0,"0",0,0,0
"588","Azerbaijan",1989,0,0,"0",0,0,0
"589","Azerbaijan",1990,0,0,"0",0,0,0
"590","Azerbaijan",1991,0,0,"0",0,0,0
"591","Azerbaijan",1992,15082170,732627,"Japan",15814797,13.5043919836846,16.5290238093958
"592","Azerbaijan",1993,6159642,1692601,"Japan",7852243,14.341776957025,15.6335292169377
"593","Azerbaijan",1994,3018483,544976,"Japan",3563459,13.2084970359785,14.9202649452664
"594","Azerbaijan",1995,11417075,433296,"Japan",11850371,12.979176376206,16.2506205997882
"595","Azerbaijan",1996,33285257,237665,"Japan",33522922,12.378617398081,17.3206251241829
"596","Azerbaijan",1997,18918929,194527,"Japan",19113456,12.1783262498871,16.7556735132205
"597","Azerbaijan",1998,18401000,210000,"Japan",18611000,12.2548628096996,16.7279155689285
"598","Azerbaijan",1999,35575883,134294,"Japan",35710177,11.807786705415,17.3871785224333
"599","Azerbaijan",2000,8018700,760039,"Japan",8778739,13.5411250267354,15.8972868719408
"600","Azerbaijan",2001,64642792,3325677,"Japan",67968469,15.0171838203691,17.9843871643136
"601","Azerbaijan",2002,29796551,645752,"Japan",30442303,13.3781708081271,17.2099032065224
"602","Azerbaijan",2003,92008691,2459284,"Japan",94467975,14.7153808086327,18.3373935979429
"603","Azerbaijan",2004,114394513,963907,"Japan",115358420,13.7787500959098,18.555163672473
"604","Azerbaijan",2005,68201510,616580,"Japan",68818090,13.3319433579691,18.0379772633311
"605","Azerbaijan",2006,168642796,1258922,"Japan",169901718,14.0457663571756,18.9432934028762
"606","Azerbaijan",2007,264001412,168329573,"Japan",432330985,18.9414343597082,19.3914650095811
"607","Azerbaijan",2008,217290609,48215546,"Japan",265506155,17.6911920581392,19.1967462275418
"608","Azerbaijan",2009,130456697,121957145,"Japan",252413842,18.6191802704958,18.6865519059065
"609","Azerbaijan",2010,134514340,32824836,"Japan",167339176,17.3066959819487,18.7171813684233
"610","Azerbaijan",2011,85918183,786357,"Japan",86704540,13.5751661667677,18.2689060409221
"611","Azerbaijan",2012,190052990,24933628,"Japan",214986618,17.0317279723886,19.0628134859777
"612","Azerbaijan",2013,94882802,1035400,"Japan",95918202,13.8502983834499,18.3681530248181
"613","Azerbaijan",2014,116364090,1249733,"Japan",117613823,14.0384404864628,18.5722345405095
"614","Azerbaijan",2015,73116535,1165952,"Japan",74282487,13.9690484786644,18.1075650961317
"615","Azerbaijan",2016,100287853,3247810,"Japan",103535663,14.9934914810157,18.4235551389182
"616","Azerbaijan",2017,64474954,4256278,"Japan",68731232,15.2639056274193,17.9817873962766
"617","Burundi",1962,1023000,87000,"Japan",1110000,11.3736633976367,13.8382500449338
"618","Burundi",1963,1903000,44000,"Japan",1947000,10.6919449129004,14.4589421462783
"619","Burundi",1964,1908000,3000,"Japan",1911000,8.00636756765025,14.4615661309904
"620","Burundi",1965,4852000,129000,"Japan",4981000,11.7675676833438,15.3949015490461
"621","Burundi",1966,1986000,167000,"Japan",2153000,12.0257490913989,14.5016331235873
"622","Burundi",1967,1949000,0,"Japan",1949000,0,14.4828269784897
"623","Burundi",1968,2128000,1000,"Japan",2129000,6.90775527898214,14.5706931294437
"624","Burundi",1969,1577000,48000,"Japan",1625000,10.77895628989,14.2710348659452
"625","Burundi",1970,2806000,1016000,"Japan",3822000,13.8313839071206,14.8472705396445
"626","Burundi",1971,2204000,864000,"Japan",3068000,13.6693280477862,14.6057844492549
"627","Burundi",1972,1444000,389000,"Japan",1833000,12.8713346226006,14.1829275984349
"628","Burundi",1973,1541000,1452000,"Japan",2993000,14.1884524743669,14.2479421143023
"629","Burundi",1974,1684000,370000,"Japan",2054000,12.8212582846204,14.3366824737844
"630","Burundi",1975,2605000,50000,"Japan",2655000,10.8197782844103,14.7729432331696
"631","Burundi",1976,2145000,334000,"Japan",2479000,12.7188962719588,14.5786501103443
"632","Burundi",1977,3683000,221000,"Japan",3904000,12.3059179804999,15.1192381954272
"633","Burundi",1978,8299000,33000,"Japan",8332000,10.4042628404486,15.9316455835806
"634","Burundi",1979,9641000,2992000,"Japan",12633000,14.9114526180765,16.0815353956465
"635","Burundi",1980,9638000,4505000,"Japan",14143000,15.3206984490246,16.0812241761824
"636","Burundi",1981,12957000,2551000,"Japan",15508000,14.7519959971239,16.3771467406109
"637","Burundi",1982,12725000,2381000,"Japan",15106000,14.683031125469,16.3590791204009
"638","Burundi",1983,8003000,6424000,"Japan",14427000,15.6755515346087,15.8953270293492
"639","Burundi",1984,9500597,7830896,"Japan",17331493,15.8735874930932,16.0668651967015
"640","Burundi",1985,7054764,1163894,"Japan",8218658,13.9672818378347,15.7692136912567
"641","Burundi",1986,9684582,1611047,"Japan",11295629,14.2923948361594,16.0860456943668
"642","Burundi",1987,11860844,5116725,"Japan",16977569,15.4480251439158,16.2887531125769
"643","Burundi",1988,14614707,5569798,"Japan",20184505,15.5328693455367,16.4975389084305
"644","Burundi",1989,17044075,6319477,"Japan",23363552,15.6591470095343,16.6513131939678
"645","Burundi",1990,10864724,2738062,"Japan",13602786,14.82276092884,16.2010317686809
"646","Burundi",1991,18051130,1620859,"Japan",19671989,14.2984668135909,16.7087188446617
"647","Burundi",1992,12873321,1792608,"Japan",14665929,14.3991821006869,16.3706675882433
"648","Burundi",1993,14540793,500081,"Japan",15040874,13.1225253642837,16.4924685677846
"649","Burundi",1994,7450804,337864,"Japan",7788668,12.73039872663,15.8238325039959
"650","Burundi",1995,14361254,18679,"Japan",14379933,9.8351551771593,16.480044443677
"651","Burundi",1996,4500957,211208,"Japan",4712165,12.2605987088847,15.3198005987969
"652","Burundi",1997,1792706,157145,"Japan",1949851,11.9649242249839,14.3992367681442
"653","Burundi",1998,1441000,171000,"Japan",1612000,12.0494188354848,14.1808478749817
"654","Burundi",1999,1733341,1969143,"Japan",3702484,14.4931089806825,14.3655613179507
"655","Burundi",2000,1606671,1088553,"Japan",2695224,13.9003598493304,14.2896748944505
"656","Burundi",2001,1145209,3310320,"Japan",4455529,15.0125554194175,13.9510977110645
"657","Burundi",2002,1264935,242592,"Japan",1507527,12.399136298856,14.0505312954244
"658","Burundi",2003,3066415,188571,"Japan",3254986,12.1472298727774,14.9360196847662
"659","Burundi",2004,9070788,259252,"Japan",9330040,12.4655558406233,16.0205696981411
"660","Burundi",2005,7941574,379124,"Japan",8320698,12.8456186073349,15.8876220503528
"661","Burundi",2006,1744838,140713,"Japan",1885551,11.8544776340013,14.3721722726329
"662","Burundi",2007,2146002,127557,"Japan",2273559,11.7563186025031,14.5791171341388
"663","Burundi",2008,5392661,222796,"Japan",5615457,12.3140118335527,15.5005495130816
"664","Burundi",2009,7627922,74780,"Japan",7702702,11.2223057485311,15.8473260201651
"665","Burundi",2010,12579978,91872,"Japan",12671850,11.4281515829208,16.3476170604274
"666","Burundi",2011,9053613,321124,"Japan",9374737,12.6795826203552,16.0186744625257
"667","Burundi",2012,8739413,322655,"Japan",9062068,12.6843389199121,15.9833535829048
"668","Burundi",2013,4611264,928491,"Japan",5539755,13.7413159666746,15.3440125639415
"669","Burundi",2014,6532704,658329,"Japan",7191033,13.3974600853491,15.6923315043623
"670","Burundi",2015,5050807,1288994,"Japan",6339801,14.0693726271393,15.4350585904648
"671","Burundi",2016,5180385,1106588,"Japan",6286973,13.9167919653606,15.4603899357981
"672","Burundi",2017,14824759.5,492750.5,"Japan",15317510,13.1077582397278,16.5118092801195
"673","Belgium",1962,34311000,14969000,"Japan",49280000,16.5214919538974,17.3509765604315
"674","Belgium",1963,35506000,27454000,"Japan",62960000,17.1280224347937,17.3852122542489
"675","Belgium",1964,36636000,23279000,"Japan",59915000,16.9630622245784,17.416541921505
"676","Belgium",1965,44941000,24657000,"Japan",69598000,17.0205713937987,17.6208610763653
"677","Belgium",1966,51202000,38634000,"Japan",89836000,17.4696432757484,17.7512891517468
"678","Belgium",1967,61444000,48559000,"Japan",110003000,17.6982901114228,17.9336367488512
"679","Belgium",1968,69168000,48266000,"Japan",117434000,17.6922379369977,18.0520488858896
"680","Belgium",1969,97338000,61243000,"Japan",158581000,17.9303601151437,18.3937000156206
"681","Belgium",1970,115954000,75445000,"Japan",191399000,18.1389144719299,18.5687041186991
"682","Belgium",1971,140352000,82984000,"Japan",223336000,18.2341583760938,18.7596641107597
"683","Belgium",1972,194433000,122347000,"Japan",316780000,18.6223718277322,19.0855981886706
"684","Belgium",1973,268368000,199217000,"Japan",467585000,19.1099052408389,19.4078697309167
"685","Belgium",1974,341162000,230867000,"Japan",572029000,19.2573523450983,19.64786799575
"686","Belgium",1975,420017000,161634000,"Japan",581651000,18.9008450779607,19.855805744613
"687","Belgium",1976,558096000,177676000,"Japan",735772000,18.9954722249152,20.1400415485586
"688","Belgium",1977,644872000,189287000,"Japan",834159000,19.058774939759,20.2845624054539
"689","Belgium",1978,796609000,316642000,"Japan",1113251000,19.57328235612,20.4958745266646
"690","Belgium",1979,1016092000,384815000,"Japan",1400907000,19.7682732572851,20.7392297331843
"691","Belgium",1980,1432609000,374695000,"Japan",1807304000,19.7416229196663,21.0827630944089
"692","Belgium",1981,1463109000,338825000,"Japan",1801934000,19.6409943078664,21.103829460652
"693","Belgium",1982,1093925000,338635000,"Japan",1432560000,19.6404333891258,20.8130379828375
"694","Belgium",1983,1166470000,373400000,"Japan",1539870000,19.7381607890719,20.8772479311353
"695","Belgium",1984,1055905490,431952440,"Japan",1487857930,19.8838260475552,20.7776645201192
"696","Belgium",1985,1096041838,446250142,"Japan",1542291980,19.9163902092654,20.8149711981013
"697","Belgium",1986,1730280707,617623157,"Japan",2347903864,20.2413890511144,21.2715494906751
"698","Belgium",1987,2027933058,788744573,"Japan",2816677631,20.4859530912889,21.4302829132548
"699","Belgium",1988,1910067288,1048595160,"Japan",2958662448,20.770717162414,21.3704043077038
"700","Belgium",1989,2060151783,1337474897,"Japan",3397626680,21.0140492679602,21.4460454981015
"701","Belgium",1990,2286201782,1478187443,"Japan",3764389225,21.114082473488,21.550157667015
"702","Belgium",1991,2382668010,1278774751,"Japan",3661442761,20.9691682306635,21.5914867093694
"703","Belgium",1992,2536678900,1178631810,"Japan",3715310710,20.8876201196526,21.6541215427421
"704","Belgium",1993,2769829114,1266131957,"Japan",4035961071,20.9592323866743,21.7420514635459
"705","Belgium",1994,3054388161,1667439649,"Japan",4721827810,21.2345551425953,21.8398451348806
"706","Belgium",1995,3694606508,2177500814,"Japan",5872107322,21.5014436405141,22.030139892577
"707","Belgium",1996,3530164129,2121855738,"Japan",5652019867,21.4755568908498,21.9846102022782
"708","Belgium",1997,3908646640,1377578226,"Japan",5286224866,21.0435928857637,22.0864570231504
"709","Belgium",1998,0,0,"0",0,0,0
"710","Belgium",1999,4570653995,1581204639,"Japan",6151858634,21.1814528232302,22.2429221377407
"711","Belgium",2000,4474632777,1657139955,"Japan",6131772732,21.2283590347088,22.2216901243005
"712","Belgium",2001,4599750394,1328188739,"Japan",5927939133,21.0070820006431,22.2492678767953
"713","Belgium",2002,5641142374,1343484735,"Japan",6984627109,21.0185326238414,22.4533524305277
"714","Belgium",2003,6832372336,1665192216,"Japan",8497564552,21.2332063987606,22.6449377907767
"715","Belgium",2004,7739810396,1886469499,"Japan",9626279895,21.3579729292019,22.7696430276072
"716","Belgium",2005,7891202423,2054263576,"Japan",9945465999,21.4431832634917,22.7890143585451
"717","Belgium",2006,7747647905,1694111907,"Japan",9441759812,21.2504244917972,22.7706551381184
"718","Belgium",2007,8963480255,1785773918,"Japan",10749254173,21.3031177257218,22.9164244098342
"719","Belgium",2008,10953633573,1890817617,"Japan",12844451190,21.3602751740602,23.1169370713152
"720","Belgium",2009,8110053250,1677152897,"Japan",9787206147,21.2403634885593,22.8163702710201
"721","Belgium",2010,7733942102,2244889407,"Japan",9978831509,21.5319220950119,22.7688845439385
"722","Belgium",2011,6746931189,3340719836,"Japan",10087651025,21.9294521404745,22.6323535997847
"723","Belgium",2012,6236770716,2599145305,"Japan",8835916021,21.6784484990845,22.5537283719099
"724","Belgium",2013,5189368488,2471241644,"Japan",7660610132,21.6279865511586,22.3698778481081
"725","Belgium",2014,5514254576,2498934203,"Japan",8013188779,21.6391301591209,22.4306023175066
"726","Belgium",2015,5099278321,2160057103,"Japan",7259335424,21.4934004948671,22.3523648609775
"727","Belgium",2016,5682271936,2473588746,"Japan",8155860682,21.6289358667028,22.4606169784377
"728","Belgium",2017,7998224213,3303082901.5,"Japan",11301307114.5,21.9181220818896,22.8024853806115
"729","Benin",1962,8000,0,"Japan",8000,0,8.98719682066197
"730","Benin",1963,35000,19000,"Japan",54000,9.85219425814858,10.4631033404715
"731","Benin",1964,113000,146000,"Japan",259000,11.8913619006905,11.6351430976945
"732","Benin",1965,303000,176000,"Japan",479000,12.0782392740203,12.6214880844915
"733","Benin",1966,274000,162000,"Japan",436000,11.9953516142145,12.5208833853702
"734","Benin",1967,292000,405000,"Japan",697000,12.9116423460887,12.5845090812504
"735","Benin",1968,887000,776000,"Japan",1663000,13.5619077991654,13.6956002612917
"736","Benin",1969,1214000,1488000,"Japan",2702000,14.2129434943752,14.0094312506016
"737","Benin",1970,1729000,3971000,"Japan",5700000,15.1945285101134,14.3630537646654
"738","Benin",1971,3856000,4893000,"Japan",8749000,15.4033161702713,15.1651409347126
"739","Benin",1972,2904000,1870000,"Japan",4774000,14.4414489888308,14.8815996549268
"740","Benin",1973,3541000,3917000,"Japan",7458000,15.180836612648,15.079919731094
"741","Benin",1974,5931000,3958000,"Japan",9889000,15.1912494051446,15.5957033908209
"742","Benin",1975,11799000,3183000,"Japan",14982000,14.9733347062642,16.2835253400821
"743","Benin",1976,23707000,4923000,"Japan",28630000,15.4094286587403,16.9812809211454
"744","Benin",1977,19506000,5959000,"Japan",25465000,15.6004132397291,16.7862326685141
"745","Benin",1978,9335000,6102000,"Japan",15437000,15.6241271442588,16.049281334958
"746","Benin",1979,22857000,5547000,"Japan",28404000,15.5287677990374,16.9447679741233
"747","Benin",1980,22028000,4354000,"Japan",26382000,15.2866055207766,16.9078249293645
"748","Benin",1981,29287000,3627000,"Japan",32914000,15.103916418265,17.1926542895227
"749","Benin",1982,27213000,3125000,"Japan",30338000,14.9549448411526,17.1192053582652
"750","Benin",1983,9817000,576000,"Japan",10393000,13.263862939678,16.0996261346747
"751","Benin",1984,13551322,2561571,"Japan",16112893,14.7561313001112,16.4219946651065
"752","Benin",1985,25619475,877544,"Japan",26497019,13.6848823755152,17.0588633624196
"753","Benin",1986,24080617,1112063,"Japan",25192680,13.9217274068641,16.9969178010002
"754","Benin",1987,30879429,1602855,"Japan",32482284,14.2872969721042,17.2456007920172
"755","Benin",1988,18893167,1135249,"Japan",20028416,13.9423625680966,16.754310880269
"756","Benin",1989,10955668,560794,"Japan",11516462,13.2371089156439,16.2093675058757
"757","Benin",1990,10325960,55617,"Japan",10381577,10.9262441889007,16.1501716706974
"758","Benin",1991,13799897,432829,"Japan",14232726,12.9780980098149,16.4401716863315
"759","Benin",1992,21906701,2036502,"Japan",23943203,14.5267441881472,16.902303129719
"760","Benin",1993,20202748,855333,"Japan",21058081,13.6592461457779,16.8213291927228
"761","Benin",1994,15006658,302615,"Japan",15309273,12.6202166494978,16.5240045272535
"762","Benin",1995,16098841,370938,"Japan",16469779,12.8237902117212,16.5942578397858
"763","Benin",1996,14220573,397146,"Japan",14617719,12.8920592502493,16.4702002768862
"764","Benin",1997,15215675,730712,"Japan",15946387,13.5017746802529,16.5378367044435
"765","Benin",1998,14327000,704000,"Japan",15031000,13.4645336351402,16.4776564268755
"766","Benin",1999,11704175,131180,"Japan",11835355,11.7843257048477,16.2754561737234
"767","Benin",2000,11767434,52953,"Japan",11820387,10.8771600066484,16.2808464435738
"768","Benin",2001,9321240,273995,"Japan",9595235,12.5208651370285,16.0478062250221
"769","Benin",2002,8534420,153288,"Japan",8687708,11.9400737839095,15.9596179564242
"770","Benin",2003,13891125,408998,"Japan",14300123,12.9214655450374,16.4467607049712
"771","Benin",2004,13325003,6044,"Japan",13331047,8.70682132339263,16.4051527531569
"772","Benin",2005,19104016,52518,"Japan",19156534,10.8689112469605,16.7654091326951
"773","Benin",2006,16418929,68474,"Japan",16487403,11.1342093901546,16.6139454345263
"774","Benin",2007,20087935,32077,"Japan",20120012,10.3758945413981,16.8156299440517
"775","Benin",2008,22834449,0,"Japan",22834449,0,16.9437808746845
"776","Benin",2009,30024196,4942,"Japan",30029138,8.50552538654856,17.2175141478865
"777","Benin",2010,24109575,1817073,"Japan",25926648,14.4127375226857,16.9981196224615
"778","Benin",2011,25661717,1656352,"Japan",27318069,14.3201281517261,17.0605108283972
"779","Benin",2012,15227502,1769987,"Japan",16997489,14.3864827598903,16.5386136930341
"780","Benin",2013,10906210,5475402,"Japan",16381612,15.5157762556289,16.2048429097385
"781","Benin",2014,15818072,3101913,"Japan",18919985,14.9475295759036,16.5766636418276
"782","Benin",2015,9193032,1024512,"Japan",10217544,13.8397269596232,16.0339563637492
"783","Benin",2016,10538568,1186151,"Japan",11724719,13.9862241691538,16.1705522284696
"784","Benin",2017,7423077,42343,"Japan",7465420,10.6535583971622,15.8201042192104
"785","Burkina Faso",1962,803000,50000,"Japan",853000,10.8197782844103,13.5961099929289
"786","Burkina Faso",1963,404000,1000,"Japan",405000,6.90775527898214,12.9091701569433
"787","Burkina Faso",1964,256000,279000,"Japan",535000,12.5389670608035,12.4529327234617
"788","Burkina Faso",1965,45000,119000,"Japan",164000,11.6868787720937,10.7144177687525
"789","Burkina Faso",1966,38000,790000,"Japan",828000,13.5797882244432,10.5453414387085
"790","Burkina Faso",1967,184000,332000,"Japan",516000,12.7128902478986,12.1226910365911
"791","Burkina Faso",1968,124000,1337000,"Japan",1461000,14.1059388560841,11.7280368445872
"792","Burkina Faso",1969,418000,1689000,"Japan",2107000,14.3396471957899,12.9432367115069
"793","Burkina Faso",1970,645000,4533000,"Japan",5178000,15.326894529923,13.3770055957779
"794","Burkina Faso",1971,931000,1659000,"Japan",2590000,14.3217255691726,13.7440145562592
"795","Burkina Faso",1972,1062000,808000,"Japan",1870000,13.6023173375032,13.875664480784
"796","Burkina Faso",1973,688000,1337000,"Japan",2025000,14.1059388560841,13.4415441169155
"797","Burkina Faso",1974,1198000,1630000,"Japan",2828000,14.3040905727829,13.9961640576575
"798","Burkina Faso",1975,3054000,940000,"Japan",3994000,13.7536351542462,14.9319627647607
"799","Burkina Faso",1976,3060000,4226000,"Japan",7286000,15.2567664771581,14.9339254739286
"800","Burkina Faso",1977,3940000,4002000,"Japan",7942000,15.2023047941258,15.1866912812741
"801","Burkina Faso",1978,5118000,3770000,"Japan",8888000,15.1425855594242,15.4482742957019
"802","Burkina Faso",1979,9704000,4320000,"Japan",14024000,15.2787659602203,16.088048729606
"803","Burkina Faso",1980,13242000,16837000,"Japan",30079000,16.6390894036399,16.3989041544669
"804","Burkina Faso",1981,12695000,12058000,"Japan",24753000,16.3052388980315,16.3567187731209
"805","Burkina Faso",1982,8777000,11276000,"Japan",20053000,16.2381871312161,15.9876452215743
"806","Burkina Faso",1983,8624000,7023000,"Japan",15647000,15.7647010351412,15.9700595721309
"807","Burkina Faso",1984,6004586,11327821,"Japan",17332407,16.2427722932371,15.6080340685717
"808","Burkina Faso",1985,7550173,2236157,"Japan",9786330,14.6202693254612,15.83708103487
"809","Burkina Faso",1986,14642816,2245555,"Japan",16888371,14.6244632646413,16.4994603977274
"810","Burkina Faso",1987,15667947,2061446,"Japan",17729393,14.5389182362675,16.5671275910713
"811","Burkina Faso",1988,23051221,4100036,"Japan",27151257,15.2265063121238,16.9532292978044
"812","Burkina Faso",1989,19696609,2122618,"Japan",21819227,14.5681607904397,16.7959570469121
"813","Burkina Faso",1990,19633652,8701658,"Japan",28335310,15.9790241401804,16.7927555907218
"814","Burkina Faso",1991,19460246,2092592,"Japan",21552838,14.5539140469265,16.7838842759578
"815","Burkina Faso",1992,25141715,4827521,"Japan",29969236,15.389843643353,17.040038976779
"816","Burkina Faso",1993,26188259,4787752,"Japan",30976011,15.3815715481615,17.0808217385202
"817","Burkina Faso",1994,12527642,1155137,"Japan",13682779,13.9597295096225,16.3434481208146
"818","Burkina Faso",1995,17306610,2170580,"Japan",19477190,14.5905049709094,16.6665990674185
"819","Burkina Faso",1996,14965377,3193430,"Japan",18158807,14.9766061322195,16.5212498910666
"820","Burkina Faso",1997,7520457,4256966,"Japan",11777423,15.2640672579332,15.8331374653561
"821","Burkina Faso",1998,7004000,4624000,"Japan",11628000,15.3467706893344,15.7619919723879
"822","Burkina Faso",1999,11527134,7186746,"Japan",18713880,15.7877490542371,16.2602142923963
"823","Burkina Faso",2000,7935814,4501551,"Japan",12437365,15.3199325620233,15.8868964901722
"824","Burkina Faso",2001,7169142,4562057,"Japan",11731199,15.3332841762684,15.7852965401434
"825","Burkina Faso",2002,8613076,7505422,"Japan",16118498,15.8311362506494,15.9687920716033
"826","Burkina Faso",2003,7243752,8350997,"Japan",15594749,15.9378914908969,15.7956498621702
"827","Burkina Faso",2004,4177824,9963619,"Japan",14141443,16.1144509169776,15.2453010947925
"828","Burkina Faso",2005,4450569,8002651,"Japan",12453220,15.8952834197515,15.3085425111369
"829","Burkina Faso",2006,7290135,8778341,"Japan",16068476,15.9877979955936,15.8020326223319
"830","Burkina Faso",2007,6190820,14865171,"Japan",21055991,16.51453151788,15.6385781076158
"831","Burkina Faso",2008,20865094,29775319,"Japan",50640413,17.2091903868342,16.8535881771498
"832","Burkina Faso",2009,4037179,17357346,"Japan",21394525,16.6695263753248,15.2110567387084
"833","Burkina Faso",2010,13189954,27202899,"Japan",40392853,17.1188341064692,16.3949660371969
"834","Burkina Faso",2011,14462001,25377970,"Japan",39839971,17.049392032812,16.4870351468638
"835","Burkina Faso",2012,18102773,19274516,"Japan",37377289,16.774294366852,16.7115756889213
"836","Burkina Faso",2013,5253836,41435056,"Japan",46688892,17.5396378437788,15.4744690344275
"837","Burkina Faso",2014,3512985,39631501,"Japan",43144486,17.4951348397963,15.071976661384
"838","Burkina Faso",2015,13639481,41187362,"Japan",54826843,17.5336420196903,16.4284791598023
"839","Burkina Faso",2016,29314012,13338030,"Japan",42652042,16.4061299113846,17.19357618493
"840","Burkina Faso",2017,56499653,34321854.5,"Japan",90821507.5,17.351292866672,17.8497450545049
"841","Bangladesh",1962,0,0,"0",0,0,0
"842","Bangladesh",1963,0,0,"0",0,0,0
"843","Bangladesh",1964,0,0,"0",0,0,0
"844","Bangladesh",1965,0,0,"0",0,0,0
"845","Bangladesh",1966,0,0,"0",0,0,0
"846","Bangladesh",1967,0,0,"0",0,0,0
"847","Bangladesh",1968,0,0,"0",0,0,0
"848","Bangladesh",1969,0,0,"0",0,0,0
"849","Bangladesh",1970,0,0,"0",0,0,0
"850","Bangladesh",1971,0,0,"0",0,0,0
"851","Bangladesh",1972,44118000,6354000,"Japan",50472000,15.6645950938116,17.6023784204064
"852","Bangladesh",1973,70154000,12138000,"Japan",82292000,16.3118515853779,18.0662033835571
"853","Bangladesh",1974,75225000,15082000,"Japan",90307000,16.5290125377447,18.1359941804804
"854","Bangladesh",1975,125765000,7108000,"Japan",132873000,15.7767314682567,18.6499256441246
"855","Bangladesh",1976,74055000,13094000,"Japan",87149000,16.3876646679832,18.1203186183432
"856","Bangladesh",1977,126433000,19177000,"Japan",145610000,16.7692222022557,18.655223081552
"857","Bangladesh",1978,156476000,36196000,"Japan",192672000,17.4044591734532,18.8684132015519
"858","Bangladesh",1979,204908000,46947000,"Japan",251855000,17.6645298638134,19.1380716558828
"859","Bangladesh",1980,326637000,27973000,"Japan",354610000,17.1467503172026,19.6043600205102
"860","Bangladesh",1981,289052000,34386000,"Japan",323438000,17.3531600627619,19.482117160687
"861","Bangladesh",1982,219113000,56219000,"Japan",275332000,17.8447653360201,19.2050981364431
"862","Bangladesh",1983,193518000,64742000,"Japan",258260000,17.9859206987872,19.0808810893635
"863","Bangladesh",1984,243476442,71193810,"Japan",314670252,18.0809164344006,19.3105307483733
"864","Bangladesh",1985,311083935,75865743,"Japan",386949678,18.144475796606,19.5555733211902
"865","Bangladesh",1986,445221995,74911947,"Japan",520133942,18.1318239417757,19.9140835809072
"866","Bangladesh",1987,357136685,66484333,"Japan",423621018,18.0124768838845,19.6936291376159
"867","Bangladesh",1988,283081393,77001666,"Japan",360083059,18.1593376159475,19.4612450220302
"868","Bangladesh",1989,334533531,62234373,"Japan",396767904,17.9464180256497,19.6282476746611
"869","Bangladesh",1990,380953050,64572609,"Japan",445525659,17.9833008695475,19.7581866971513
"870","Bangladesh",1991,242417310,59601693,"Japan",302019003,17.9031945376724,19.3061712205009
"871","Bangladesh",1992,239791382,55970749,"Japan",295762131,17.840339772947,19.29527986163
"872","Bangladesh",1993,323766444,66258179,"Japan",390024623,18.0090694718142,19.5955329619661
"873","Bangladesh",1994,334377302,81779505,"Japan",416156807,18.2195372200578,19.6277805600768
"874","Bangladesh",1995,330833472,129944948,"Japan",460778420,18.6826214418051,19.617125701001
"875","Bangladesh",1996,402874910,129242376,"Japan",532117286,18.6772000831527,19.8141366747055
"876","Bangladesh",1997,322768498,102423801,"Japan",425192299,18.4446296752023,19.592445899759
"877","Bangladesh",1998,317811000,111957000,"Japan",429768000,18.5336254269685,19.576967424432
"878","Bangladesh",1999,322300915,102811156,"Japan",425112071,18.4484044264981,19.5909961857515
"879","Bangladesh",2000,508327256,105631581,"Japan",613958837,18.4754679470262,20.0466360028564
"880","Bangladesh",2001,537225409,103593825,"Japan",640819234,18.4559882817661,20.1019283204524
"881","Bangladesh",2002,518899369,100897335,"Japan",619796704,18.4296140726856,20.0672205283033
"882","Bangladesh",2003,526142862,118549029,"Japan",644691891,18.5908371798053,20.0810833345856
"883","Bangladesh",2004,999773935,127380583,"Japan",1127154518,18.6626898797537,20.7230397463899
"884","Bangladesh",2005,678724126,136281932,"Japan",815006058,18.7302363273516,20.3357253084122
"885","Bangladesh",2006,795297065,143616085,"Japan",938913150,18.7826542208403,20.4942262694893
"886","Bangladesh",2007,807765369,156918571,"Japan",964683940,18.8712375727131,20.5097821894145
"887","Bangladesh",2008,735830046,179890334,"Japan",915720380,19.0078579676273,20.4165097342671
"888","Bangladesh",2009,759556759,237601697,"Japan",997158456,19.2861062876832,20.4482456092684
"889","Bangladesh",2010,972005127,335830215,"Japan",1307835342,19.6321162777141,20.6948716371022
"890","Bangladesh",2011,1069272223,562547281,"Japan",1631819504,20.1479857436215,20.7902440885822
"891","Bangladesh",2012,967878319,718345155,"Japan",1686223474,20.3924607287752,20.6906169338271
"892","Bangladesh",2013,805240566,873515055,"Japan",1678755621,20.5880359226503,20.5066516304907
"893","Bangladesh",2014,1050665666,937235108,"Japan",1987900774,20.658444724417,20.7726897678623
"894","Bangladesh",2015,1336870632,1080825100,"Japan",2417695732,20.8009905678787,21.0135973704744
"895","Bangladesh",2016,1551033294,1216379725,"Japan",2767413019,20.9191448455917,21.1621871870613
"896","Bangladesh",2017,0,0,"0",0,0,0
"897","Bulgaria",1962,1657000,1541000,"Japan",3198000,14.2479421143023,14.3205192964087
"898","Bulgaria",1963,2206000,1424000,"Japan",3630000,14.1689803709541,14.6066914787956
"899","Bulgaria",1964,7503000,5781000,"Japan",13284000,15.5700872360646,15.8308134985279
"900","Bulgaria",1965,10883000,6097000,"Japan",16980000,15.62330740489,16.2027124966782
"901","Bulgaria",1966,24549000,13558000,"Japan",38107000,16.422487336973,17.0161816781776
"902","Bulgaria",1967,24512000,15072000,"Japan",39584000,16.5283492757983,17.0146733515225
"903","Bulgaria",1968,14976000,6574000,"Japan",21550000,15.6986330332063,16.5219594776995
"904","Bulgaria",1969,11803000,8697000,"Japan",20500000,15.9784886965719,16.2838642944112
"905","Bulgaria",1970,20757000,9340000,"Japan",30097000,16.049816810205,16.8483940971491
"906","Bulgaria",1971,20069000,10542000,"Japan",30611000,16.1708778363973,16.8146868939208
"907","Bulgaria",1972,20986000,13358000,"Japan",34344000,16.4076260142677,16.8593661067
"908","Bulgaria",1973,36432000,18178000,"Japan",54610000,16.7157226296609,17.4109580672857
"909","Bulgaria",1974,73720000,22136000,"Japan",95856000,16.9127158004489,18.1157846907659
"910","Bulgaria",1975,54201000,13883000,"Japan",68084000,16.4461756280169,17.8082099164242
"911","Bulgaria",1976,47039000,15227000,"Japan",62266000,16.5385807258229,17.6664876028253
"912","Bulgaria",1977,50758000,16921000,"Japan",67679000,16.6440660120508,17.742579798931
"913","Bulgaria",1978,55403000,18212000,"Japan",73615000,16.7175912754368,17.8301443018759
"914","Bulgaria",1979,45003000,24498000,"Japan",69501000,17.0141020395298,17.6222397121791
"915","Bulgaria",1980,65311000,22070000,"Japan",87381000,16.9097297782329,17.9946710333525
"916","Bulgaria",1981,111108000,17714000,"Japan",128822000,16.6898658453517,18.5260132592182
"917","Bulgaria",1982,86548000,19640000,"Japan",106188000,16.7930788608906,18.2762097312895
"918","Bulgaria",1983,141184000,19547000,"Japan",160731000,16.7883323799352,18.7655745621553
"919","Bulgaria",1984,83865029,59179342,"Japan",143044371,17.8960830862534,18.2447192669048
"920","Bulgaria",1985,123422134,19765893,"Japan",143188027,16.7994684345676,18.6311210212603
"921","Bulgaria",1986,160512867,16174245,"Japan",176687112,16.5989307202912,18.8938846655453
"922","Bulgaria",1987,117222105,22321715,"Japan",139543820,16.9210705294431,18.5795810265377
"923","Bulgaria",1988,160491652,44695365,"Japan",205187017,17.6153803629323,18.8937524867206
"924","Bulgaria",1989,166606981,40854069,"Japan",207461050,17.5255169826328,18.9311481895802
"925","Bulgaria",1990,54269278,31764973,"Japan",86034251,17.2738747626903,17.8094688421
"926","Bulgaria",1991,35661741,39623011,"Japan",75284752,17.4949205933183,17.3895889914173
"927","Bulgaria",1992,36414493,38782609,"Japan",75197102,17.4734824824627,17.4104774127032
"928","Bulgaria",1993,30869041,21958626,"Japan",52827667,16.9046706043421,17.2452643302362
"929","Bulgaria",1994,19864498,20926539,"Japan",40791037,16.8565287200224,16.8044446763351
"930","Bulgaria",1995,16107959,28678944,"Japan",44786903,17.1716737529341,16.5948240556311
"931","Bulgaria",1996,32084202,31149851,"Japan",63234053,17.2543200198797,17.2838743174222
"932","Bulgaria",1997,37725652,41778792,"Japan",79504444,17.547899400319,17.4458508454377
"933","Bulgaria",1998,38252000,40387000,"Japan",78639000,17.5140185089702,17.4597064044516
"934","Bulgaria",1999,57771083,34878987,"Japan",92650070,17.3673951141521,17.8719989143361
"935","Bulgaria",2000,56394261,27785631,"Japan",84179892,17.1400295745337,17.8478779559717
"936","Bulgaria",2001,69478695,18284218,"Japan",87762913,16.7215488413555,18.0565307167774
"937","Bulgaria",2002,79941554,20446717,"Japan",100388271,16.8333328896682,18.1968063506382
"938","Bulgaria",2003,123800234,23405643,"Japan",147205877,16.9684877051012,18.6341798083584
"939","Bulgaria",2004,169221115,29367581,"Japan",198588696,17.1954019368274,18.9467167904946
"940","Bulgaria",2005,200221092,35304067,"Japan",235525159,17.3795087277317,19.1149327739413
"941","Bulgaria",2006,281476881,55903631,"Japan",337380512,17.8391398912931,19.455560874285
"942","Bulgaria",2007,356952184,58560497,"Japan",415512681,17.8855709146032,19.693112392398
"943","Bulgaria",2008,460033173,53789192,"Japan",513822365,17.8005831127572,19.9468091600646
"944","Bulgaria",2009,202732307,58234880,"Japan",260967187,17.8799950459003,19.1273969820472
"945","Bulgaria",2010,84381682,55720386,"Japan",140102068,17.8358566343465,18.2508608980954
"946","Bulgaria",2011,65187968,91836118,"Japan",157024086,18.3355162204784,17.99278546999
"947","Bulgaria",2012,54260976,101937703,"Japan",156198679,18.4398724297598,17.809315852501
"948","Bulgaria",2013,69579130,115715193,"Japan",185294323,18.5666424972854,18.0579752240169
"949","Bulgaria",2014,77559866,106494962,"Japan",184054828,18.4836082368305,18.1665606606425
"950","Bulgaria",2015,64383078,103484276,"Japan",167867354,18.454930236423,17.9803613925709
"951","Bulgaria",2016,82337259,105503027,"Japan",187840286,18.4742502024119,18.2263342849494
"952","Bulgaria",2017,105380261.5,92914797.5,"Japan",198295059,18.3471934752762,18.4730859042379
"953","The Bahamas",1962,0,0,"0",0,0,0
"954","The Bahamas",1963,0,0,"0",0,0,0
"955","The Bahamas",1964,0,0,"0",0,0,0
"956","The Bahamas",1965,0,0,"0",0,0,0
"957","The Bahamas",1966,0,0,"0",0,0,0
"958","The Bahamas",1967,0,0,"0",0,0,0
"959","The Bahamas",1968,0,0,"0",0,0,0
"960","The Bahamas",1969,0,0,"0",0,0,0
"961","The Bahamas",1970,0,0,"0",0,0,0
"962","The Bahamas",1971,0,0,"0",0,0,0
"963","The Bahamas",1972,0,0,"0",0,0,0
"964","The Bahamas",1973,0,0,"0",0,0,0
"965","The Bahamas",1974,0,0,"0",0,0,0
"966","The Bahamas",1975,0,0,"0",0,0,0
"967","The Bahamas",1976,0,0,"0",0,0,0
"968","The Bahamas",1977,0,0,"0",0,0,0
"969","The Bahamas",1978,0,0,"0",0,0,0
"970","The Bahamas",1979,0,0,"0",0,0,0
"971","The Bahamas",1980,0,0,"0",0,0,0
"972","The Bahamas",1981,0,0,"0",0,0,0
"973","The Bahamas",1982,0,0,"0",0,0,0
"974","The Bahamas",1983,0,0,"0",0,0,0
"975","The Bahamas",1984,0,0,"0",0,0,0
"976","The Bahamas",1985,0,0,"0",0,0,0
"977","The Bahamas",1986,0,0,"0",0,0,0
"978","The Bahamas",1987,0,0,"0",0,0,0
"979","The Bahamas",1988,0,0,"0",0,0,0
"980","The Bahamas",1989,0,0,"0",0,0,0
"981","The Bahamas",1990,0,0,"0",0,0,0
"982","The Bahamas",1991,0,0,"0",0,0,0
"983","The Bahamas",1992,0,0,"0",0,0,0
"984","The Bahamas",1993,0,0,"0",0,0,0
"985","The Bahamas",1994,0,0,"0",0,0,0
"986","The Bahamas",1995,0,0,"0",0,0,0
"987","The Bahamas",1996,0,0,"0",0,0,0
"988","The Bahamas",1997,0,0,"0",0,0,0
"989","The Bahamas",1998,0,0,"0",0,0,0
"990","The Bahamas",1999,0,0,"0",0,0,0
"991","The Bahamas",2000,0,0,"0",0,0,0
"992","The Bahamas",2001,0,0,"0",0,0,0
"993","The Bahamas",2002,0,0,"0",0,0,0
"994","The Bahamas",2003,0,0,"0",0,0,0
"995","The Bahamas",2004,0,0,"0",0,0,0
"996","The Bahamas",2005,0,0,"0",0,0,0
"997","The Bahamas",2006,0,0,"0",0,0,0
"998","The Bahamas",2007,0,0,"0",0,0,0
"999","The Bahamas",2008,0,0,"0",0,0,0
"1000","The Bahamas",2009,0,0,"0",0,0,0
"1001","The Bahamas",2010,0,0,"0",0,0,0
"1002","The Bahamas",2011,0,0,"0",0,0,0
"1003","The Bahamas",2012,0,0,"0",0,0,0
"1004","The Bahamas",2013,0,0,"0",0,0,0
"1005","The Bahamas",2014,0,0,"0",0,0,0
"1006","The Bahamas",2015,0,0,"0",0,0,0
"1007","The Bahamas",2016,0,0,"0",0,0,0
"1008","The Bahamas",2017,0,0,"0",0,0,0
"1009","Bosnia and Herzegovina",1962,0,0,"0",0,0,0
"1010","Bosnia and Herzegovina",1963,0,0,"0",0,0,0
"1011","Bosnia and Herzegovina",1964,0,0,"0",0,0,0
"1012","Bosnia and Herzegovina",1965,0,0,"0",0,0,0
"1013","Bosnia and Herzegovina",1966,0,0,"0",0,0,0
"1014","Bosnia and Herzegovina",1967,0,0,"0",0,0,0
"1015","Bosnia and Herzegovina",1968,0,0,"0",0,0,0
"1016","Bosnia and Herzegovina",1969,0,0,"0",0,0,0
"1017","Bosnia and Herzegovina",1970,0,0,"0",0,0,0
"1018","Bosnia and Herzegovina",1971,0,0,"0",0,0,0
"1019","Bosnia and Herzegovina",1972,0,0,"0",0,0,0
"1020","Bosnia and Herzegovina",1973,0,0,"0",0,0,0
"1021","Bosnia and Herzegovina",1974,0,0,"0",0,0,0
"1022","Bosnia and Herzegovina",1975,0,0,"0",0,0,0
"1023","Bosnia and Herzegovina",1976,0,0,"0",0,0,0
"1024","Bosnia and Herzegovina",1977,0,0,"0",0,0,0
"1025","Bosnia and Herzegovina",1978,0,0,"0",0,0,0
"1026","Bosnia and Herzegovina",1979,0,0,"0",0,0,0
"1027","Bosnia and Herzegovina",1980,0,0,"0",0,0,0
"1028","Bosnia and Herzegovina",1981,0,0,"0",0,0,0
"1029","Bosnia and Herzegovina",1982,0,0,"0",0,0,0
"1030","Bosnia and Herzegovina",1983,0,0,"0",0,0,0
"1031","Bosnia and Herzegovina",1984,0,0,"0",0,0,0
"1032","Bosnia and Herzegovina",1985,0,0,"0",0,0,0
"1033","Bosnia and Herzegovina",1986,0,0,"0",0,0,0
"1034","Bosnia and Herzegovina",1987,0,0,"0",0,0,0
"1035","Bosnia and Herzegovina",1988,0,0,"0",0,0,0
"1036","Bosnia and Herzegovina",1989,0,0,"0",0,0,0
"1037","Bosnia and Herzegovina",1990,0,0,"0",0,0,0
"1038","Bosnia and Herzegovina",1991,0,0,"0",0,0,0
"1039","Bosnia and Herzegovina",1992,0,143584,"Japan",143584,11.8746755087757,0
"1040","Bosnia and Herzegovina",1993,0,95216,"Japan",95216,11.4639032738846,0
"1041","Bosnia and Herzegovina",1994,121813,0,"Japan",121813,0,11.7102423609106
"1042","Bosnia and Herzegovina",1995,0,2548,"Japan",2548,7.84306401669205,0
"1043","Bosnia and Herzegovina",1996,554458,67904,"Japan",622362,11.1258502219737,13.2257463389904
"1044","Bosnia and Herzegovina",1997,10877489,1215861,"Japan",12093350,14.0109630257639,16.2022059823147
"1045","Bosnia and Herzegovina",1998,10022000,1330000,"Japan",11352000,14.1006895001979,16.1202932345018
"1046","Bosnia and Herzegovina",1999,19222334,175863,"Japan",19398197,12.0774605618117,16.7715833901378
"1047","Bosnia and Herzegovina",2000,3702636,432322,"Japan",4134958,12.9769259599461,15.1245555563874
"1048","Bosnia and Herzegovina",2001,1319187,206316,"Japan",1525503,12.2371642530078,14.0925261957217
"1049","Bosnia and Herzegovina",2002,1636070,332834,"Japan",1968904,12.7153991461724,14.3078075825155
"1050","Bosnia and Herzegovina",2003,28190783,518448,"Japan",28709231,13.1585950123264,17.1545056385116
"1051","Bosnia and Herzegovina",2004,30426455,1243484,"Japan",31669939,14.0334276752349,17.2308230182088
"1052","Bosnia and Herzegovina",2005,45002995,1401104,"Japan",46404099,14.152771055255,17.6222396010754
"1053","Bosnia and Herzegovina",2006,48986986,2757521,"Japan",51744507,14.8298426456746,17.7070652289624
"1054","Bosnia and Herzegovina",2007,65976752,3407275,"Japan",69384027,15.0414234095583,18.0048129955145
"1055","Bosnia and Herzegovina",2008,77343918,5146864,"Japan",82490782,15.4538981551267,18.1637725022862
"1056","Bosnia and Herzegovina",2009,49288819,3781085,"Japan",53069904,15.1455215634456,17.7132078181592
"1057","Bosnia and Herzegovina",2010,46267236,4127706,"Japan",50394942,15.233232362677,17.6499446227687
"1058","Bosnia and Herzegovina",2011,465767,6516905,"Japan",6982672,15.6899101279488,13.0514407880661
"1059","Bosnia and Herzegovina",2012,1735541,4532715,"Japan",6268256,15.3268316556764,14.3668297383207
"1060","Bosnia and Herzegovina",2013,6363402,5330899,"Japan",11694301,15.4890304498366,15.6660736979656
"1061","Bosnia and Herzegovina",2014,2358948,6062169,"Japan",8421117,15.6175782147992,14.6737263149082
"1062","Bosnia and Herzegovina",2015,7601048,6766945,"Japan",14367993,15.7275602875029,15.8437966904868
"1063","Bosnia and Herzegovina",2016,4061878,6784134,"Japan",10846012,15.7300972086173,15.2171559862056
"1064","Bosnia and Herzegovina",2017,20287024.5,4486990.5,"Japan",24774015,15.3166927677283,16.8254920524527
"1065","Belarus",1962,0,0,"0",0,0,0
"1066","Belarus",1963,0,0,"0",0,0,0
"1067","Belarus",1964,0,0,"0",0,0,0
"1068","Belarus",1965,0,0,"0",0,0,0
"1069","Belarus",1966,0,0,"0",0,0,0
"1070","Belarus",1967,0,0,"0",0,0,0
"1071","Belarus",1968,0,0,"0",0,0,0
"1072","Belarus",1969,0,0,"0",0,0,0
"1073","Belarus",1970,0,0,"0",0,0,0
"1074","Belarus",1971,0,0,"0",0,0,0
"1075","Belarus",1972,0,0,"0",0,0,0
"1076","Belarus",1973,0,0,"0",0,0,0
"1077","Belarus",1974,0,0,"0",0,0,0
"1078","Belarus",1975,0,0,"0",0,0,0
"1079","Belarus",1976,0,0,"0",0,0,0
"1080","Belarus",1977,0,0,"0",0,0,0
"1081","Belarus",1978,0,0,"0",0,0,0
"1082","Belarus",1979,0,0,"0",0,0,0
"1083","Belarus",1980,0,0,"0",0,0,0
"1084","Belarus",1981,0,0,"0",0,0,0
"1085","Belarus",1982,0,0,"0",0,0,0
"1086","Belarus",1983,0,0,"0",0,0,0
"1087","Belarus",1984,0,0,"0",0,0,0
"1088","Belarus",1985,0,0,"0",0,0,0
"1089","Belarus",1986,0,0,"0",0,0,0
"1090","Belarus",1987,0,0,"0",0,0,0
"1091","Belarus",1988,0,0,"0",0,0,0
"1092","Belarus",1989,0,0,"0",0,0,0
"1093","Belarus",1990,0,0,"0",0,0,0
"1094","Belarus",1991,0,0,"0",0,0,0
"1095","Belarus",1992,5250956,434040,"Japan",5684996,12.9808919747341,15.4739207132286
"1096","Belarus",1993,4748720,4939056,"Japan",9687776,15.4126847777861,15.3733856660121
"1097","Belarus",1994,48037228,4116506,"Japan",52153734,15.2305153032684,17.6874868515962
"1098","Belarus",1995,6019414,11504585,"Japan",17523999,16.2582562095277,15.6105004703543
"1099","Belarus",1996,3308646,12764691,"Japan",16073337,16.3621934015492,15.0120496002199
"1100","Belarus",1997,40880382,8752426,"Japan",49632808,15.984841477048,17.5261608482388
"1101","Belarus",1998,9929000,9505000,"Japan",19434000,16.0673285339047,16.1109703260157
"1102","Belarus",1999,30085711,4998894,"Japan",35084605,15.42472724593,17.2195608993971
"1103","Belarus",2000,36474783,7028004,"Japan",43502787,15.7654132974409,17.4121317030751
"1104","Belarus",2001,20496238,12321494,"Japan",32817732,16.3268557749513,16.8357519150731
"1105","Belarus",2002,24411349,4785228,"Japan",29196577,15.3810442306368,17.0105587050781
"1106","Belarus",2003,35358193,6837015,"Japan",42195208,15.7378617908382,17.3810406914867
"1107","Belarus",2004,39945846,5587512,"Japan",45533358,15.5360446655527,17.5030352447953
"1108","Belarus",2005,52241555,5746660,"Japan",57988215,15.5641293744382,17.7713888089519
"1109","Belarus",2006,125978043,6133593,"Japan",132111636,15.6292912699714,18.6516181878256
"1110","Belarus",2007,187937842,39688537,"Japan",227626379,17.4965729634097,19.0516218384653
"1111","Belarus",2008,275290758,18644225,"Japan",293934983,16.7410470046276,19.4333383988991
"1112","Belarus",2009,178922137,5660431,"Japan",184582568,15.5490105956901,19.0024612803431
"1113","Belarus",2010,156566980,5997392,"Japan",162564372,15.6068352660307,18.8689944636045
"1114","Belarus",2011,48142017,14924513,"Japan",63066530,16.5185155868948,17.6896658880705
"1115","Belarus",2012,38571576,20903671,"Japan",59475247,16.8554353474441,17.4680261901223
"1116","Belarus",2013,42279943,26230101,"Japan",68510044,17.0824182023884,17.5598233708102
"1117","Belarus",2014,81409876,18316710,"Japan",99726586,16.7233243159301,18.2150071503946
"1118","Belarus",2015,15394883,23660773,"Japan",39055656,16.9793290871558,16.5495457394418
"1119","Belarus",2016,23580355,18041854,"Japan",41622209,16.7082048389367,16.9759245080916
"1120","Belarus",2017,64955697,18935864.5,"Japan",83891561.5,16.7565682744681,17.9892160108601
"1121","Belize",1962,0,0,"0",0,0,0
"1122","Belize",1963,0,0,"0",0,0,0
"1123","Belize",1964,0,0,"0",0,0,0
"1124","Belize",1965,0,0,"0",0,0,0
"1125","Belize",1966,0,0,"0",0,0,0
"1126","Belize",1967,0,0,"0",0,0,0
"1127","Belize",1968,0,0,"0",0,0,0
"1128","Belize",1969,0,0,"0",0,0,0
"1129","Belize",1970,650000,1e+05,"Japan",750000,11.5129254649702,13.3847276418718
"1130","Belize",1971,679000,68000,"Japan",747000,11.1272629841582,13.4283764065408
"1131","Belize",1972,1414000,142000,"Japan",1556000,11.8635823365834,14.1619331254387
"1132","Belize",1973,945000,45000,"Japan",990000,10.7144177687525,13.7589402064759
"1133","Belize",1974,1590000,18000,"Japan",1608000,9.7981270368783,14.2792445741964
"1134","Belize",1975,1330000,0,"Japan",1330000,0,14.1006895001979
"1135","Belize",1976,1604000,12000,"Japan",1616000,9.39266192877014,14.2880110674086
"1136","Belize",1977,1847000,11000,"Japan",1858000,9.30565055178051,14.4290732591814
"1137","Belize",1978,2155000,201000,"Japan",2356000,12.2110601870412,14.58330128152
"1138","Belize",1979,3161000,366000,"Japan",3527000,12.8103886123835,14.9663989911978
"1139","Belize",1980,5740000,354000,"Japan",6094000,12.7770521921159,15.5629697682957
"1140","Belize",1981,5248000,310000,"Japan",5558000,12.6443275764613,15.4733576096061
"1141","Belize",1982,2426000,102000,"Japan",2528000,11.5327280922664,14.7017543684861
"1142","Belize",1983,1409000,380000,"Japan",1789000,12.8479265317026,14.1583907908808
"1143","Belize",1984,2327131,385169,"Japan",2712300,12.8614374779937,14.6601467363595
"1144","Belize",1985,3316746,824598,"Japan",4141344,13.6226512738336,15.0144947397786
"1145","Belize",1986,1949351,353366,"Japan",2302717,12.7752596259768,14.4830070546301
"1146","Belize",1987,5439078,339458,"Japan",5778536,12.7351055069878,15.5091201191738
"1147","Belize",1988,19733045,759493,"Japan",20492538,13.5404063843856,16.7978051995929
"1148","Belize",1989,10510780,7811624,"Japan",18322404,15.87112343874,16.1679119551326
"1149","Belize",1990,8235706,1627112,"Japan",9862818,14.3023172221847,15.9239896495524
"1150","Belize",1991,8618822,800858,"Japan",9419680,13.5934389319328,15.9694589743685
"1151","Belize",1992,6013655,1382950,"Japan",7396605,14.1397294567034,15.6095432747395
"1152","Belize",1993,12347827,4123664,"Japan",16471491,15.232252646503,16.32899065414
"1153","Belize",1994,20184575,9053991,"Japan",29238566,16.0187162129418,16.8204292568085
"1154","Belize",1995,23558662,20862652,"Japan",44421314,16.8534711327256,16.9750041239635
"1155","Belize",1996,24699865,35821368,"Japan",60521233,17.3940551448224,17.0223083359962
"1156","Belize",1997,28262125,47524870,"Japan",75786995,17.6767637109326,17.1570331270151
"1157","Belize",1998,27236000,53041000,"Japan",80277000,17.7865757573595,17.120050185585
"1158","Belize",1999,31785822,67198377,"Japan",98984199,18.023159653416,17.2745308992736
"1159","Belize",2000,18732063,40401957,"Japan",59134020,17.5143887823522,16.7457472125086
"1160","Belize",2001,25212202,31278881,"Japan",56491083,17.2584536993442,17.0428386416408
"1161","Belize",2002,22712269,6861904,"Japan",29574173,15.7414955122123,16.9384158210239
"1162","Belize",2003,15479642,8587120,"Japan",24066762,15.9657739641698,16.5550362992434
"1163","Belize",2004,20622719,8528746,"Japan",29151465,15.9589528981098,16.8419038901297
"1164","Belize",2005,10403547,7186888,"Japan",17590435,15.7877688126364,16.157657363657
"1165","Belize",2006,7045002,4826945,"Japan",11871947,15.389724320337,15.7678289872042
"1166","Belize",2007,4256675,6288867,"Japan",10545542,15.6542914852658,15.2639988970521
"1167","Belize",2008,5624742,5035755,"Japan",10660497,15.4320740232409,15.5426856383362
"1168","Belize",2009,5072941,5748339,"Japan",10821280,15.5644215014775,15.4394312862821
"1169","Belize",2010,8542688,9060543,"Japan",17603231,16.019439609998,15.9605862703384
"1170","Belize",2011,2755735,19086833,"Japan",21842568,16.7645092835632,14.8291947526465
"1171","Belize",2012,7383426,21706345,"Japan",29089771,16.8931151720846,15.8147483164986
"1172","Belize",2013,5122183,14012986,"Japan",19135169,16.4554950290796,15.4490912733345
"1173","Belize",2014,3256020,8057644,"Japan",11313664,15.9021317640603,14.9960161485918
"1174","Belize",2015,5014520,4877604,"Japan",9892124,15.4001646736509,15.427848261936
"1175","Belize",2016,10848759,7104473,"Japan",17953232,15.7762351436449,16.1995612535289
"1176","Belize",2017,4493193,3466772.5,"Japan",7959965.5,15.0587346038237,15.3180741428386
"1177","Bermuda",1962,826000,13000,"Japan",839000,9.47270463644367,13.6243500525031
"1178","Bermuda",1963,1526000,25000,"Japan",1551000,10.1266311038503,14.2381604908265
"1179","Bermuda",1964,3644000,13461000,"Japan",17105000,16.4153071736262,15.108592537362
"1180","Bermuda",1965,273000,23000,"Japan",296000,10.0432494949113,12.5172270741671
"1181","Bermuda",1966,6626000,51000,"Japan",6677000,10.8395809117065,15.706511861842
"1182","Bermuda",1967,16368000,5000,"Japan",16373000,8.51719319141624,16.6108387671735
"1183","Bermuda",1968,22696000,0,"Japan",22696000,0,16.9376992554708
"1184","Bermuda",1969,6335000,4000,"Japan",6339000,8.29404964010203,15.6616003717374
"1185","Bermuda",1970,23540000,101000,"Japan",23641000,11.5228757958234,16.9742116597964
"1186","Bermuda",1971,1521000,76000,"Japan",1597000,11.2384886192685,14.2348785712414
"1187","Bermuda",1972,2392000,53000,"Japan",2445000,10.8780471925343,14.6876403940527
"1188","Bermuda",1973,1950000,13000,"Japan",1963000,9.47270463644367,14.4833399305399
"1189","Bermuda",1974,2722000,317000,"Japan",3039000,12.6666570528594,14.8168774621935
"1190","Bermuda",1975,2266000,3000,"Japan",2269000,8.00636756765025,14.6335267205701
"1191","Bermuda",1976,4163000,8000,"Japan",4171000,8.98719682066197,15.2417465261771
"1192","Bermuda",1977,4836000,14000,"Japan",4850000,9.5468126085974,15.3915984907168
"1193","Bermuda",1978,80193000,132000,"Japan",80325000,11.7905572015685,18.199946787232
"1194","Bermuda",1979,7538000,211000,"Japan",7749000,12.2596134124582,15.8354674528092
"1195","Bermuda",1980,95558000,115000,"Japan",95673000,11.6526874073454,18.3752439509438
"1196","Bermuda",1981,12079000,140000,"Japan",12219000,11.8493977015914,16.3069789655874
"1197","Bermuda",1982,12043000,235000,"Japan",12278000,12.3673407931263,16.3039941362426
"1198","Bermuda",1983,18107000,89000,"Japan",18196000,11.3963916487143,16.7118091618028
"1199","Bermuda",1984,102224337,41291,"Japan",102265628,10.6283998375261,18.4426803385006
"1200","Bermuda",1985,73865691,86277,"Japan",73951968,11.365318329384,18.1177590155983
"1201","Bermuda",1986,42145530,66633,"Japan",42212163,11.1069552293066,17.5566391869664
"1202","Bermuda",1987,46618630,330078,"Japan",46948708,12.7070842691495,17.6575108046107
"1203","Bermuda",1988,54498335,290222,"Japan",54788557,12.5784014263452,17.8136807087081
"1204","Bermuda",1989,88348597,279133,"Japan",88627730,12.5394436497259,18.2968008765813
"1205","Bermuda",1990,114997723,1987903,"Japan",116985626,14.5025908722517,18.5604228861315
"1206","Bermuda",1991,213671294,8242224,"Japan",221913518,15.924780768381,19.1799493827686
"1207","Bermuda",1992,264923876,96904,"Japan",265020780,11.4814760766966,19.394953082306
"1208","Bermuda",1993,28022358,769754,"Japan",28792112,13.5538262622656,17.148513249508
"1209","Bermuda",1994,28039465,298710,"Japan",28338175,12.6072284820502,17.1491235400628
"1210","Bermuda",1995,41982724,2274986,"Japan",44257710,14.6374844565021,17.5527687582935
"1211","Bermuda",1996,25178427,248215,"Japan",25426642,12.4220505850595,17.0414981144147
"1212","Bermuda",1997,21522262,142059,"Japan",21664321,11.8639977432478,16.8845983992582
"1213","Bermuda",1998,20526000,105000,"Japan",20631000,11.5617156291397,16.8372029331878
"1214","Bermuda",1999,29345393,193529,"Japan",29538922,12.1731826510235,17.1946461242856
"1215","Bermuda",2000,198748777,1039307,"Japan",199788084,13.8540647028564,19.1075521580207
"1216","Bermuda",2001,219951577,2102327,"Japan",222053904,14.5585553844474,19.2089179755446
"1217","Bermuda",2002,21592161,3427990,"Japan",25020151,15.0474846415427,16.8878408901175
"1218","Bermuda",2003,18646768,4029154,"Japan",22675922,15.2090669863271,16.7411833914492
"1219","Bermuda",2004,973404630,3410428,"Japan",976815058,15.0423483545801,20.6963104118758
"1220","Bermuda",2005,25958766,4208198,"Japan",30166964,15.2525450855247,17.0720199140016
"1221","Bermuda",2006,29168664,19722,"Japan",29188386,9.88949004289227,17.1886055403151
"1222","Bermuda",2007,16333987,18522,"Japan",16352509,9.82671449373021,16.6087585870142
"1223","Bermuda",2008,14618066,3776,"Japan",14621842,8.23642052726539,16.4977687189938
"1224","Bermuda",2009,8597893,34761,"Japan",8632654,10.4562513476652,15.9670277312063
"1225","Bermuda",2010,7029803,284496,"Japan",7314299,12.5584744726957,15.7656692406346
"1226","Bermuda",2011,4462273,36608,"Japan",4498881,10.5080220747395,15.3111688354289
"1227","Bermuda",2012,3814740,35459,"Japan",3850199,10.4761323784409,15.1543830683468
"1228","Bermuda",2013,3398082,7720,"Japan",3405802,8.95156964301882,15.0387217127651
"1229","Bermuda",2014,3200818,40445,"Japan",3241263,10.6076983054521,14.9789169601035
"1230","Bermuda",2015,56728708,6363,"Japan",56735071,8.75825524323279,17.8537909544973
"1231","Bermuda",2016,276065663,27554,"Japan",276093217,10.2239029946045,19.4361493048058
"1232","Bermuda",2017,10115288.5,112431,"Japan",10227719.5,11.6300949791274,16.1295585501743
"1233","Bolivia",1962,8502000,1708000,"Japan",10210000,14.3508336533307,15.9558119879009
"1234","Bolivia",1963,7720000,1775000,"Japan",9495000,14.3893109808917,15.859324922001
"1235","Bolivia",1964,9713000,5719000,"Japan",15432000,15.5593045228975,16.0889757523845
"1236","Bolivia",1965,17585000,6241000,"Japan",23826000,15.6466509839162,16.6825568238902
"1237","Bolivia",1966,15512000,5511000,"Japan",21023000,15.5222566528654,16.5571244759046
"1238","Bolivia",1967,18272000,10708000,"Japan",28980000,16.1865016836224,16.7208803914379
"1239","Bolivia",1968,17040000,8929000,"Japan",25969000,16.0048149644994,16.6510740793654
"1240","Bolivia",1969,27108000,12080000,"Japan",39188000,16.3070617504709,17.1153394452381
"1241","Bolivia",1970,19594000,37673000,"Japan",57267000,17.4444542154672,16.7907339548867
"1242","Bolivia",1971,18233000,16558000,"Japan",34791000,16.6223799266809,16.7187436970213
"1243","Bolivia",1972,19629000,18718000,"Japan",38347000,16.7449961856993,16.79251862252
"1244","Bolivia",1973,18119000,20681000,"Japan",38800000,16.8447259623348,16.7124716694182
"1245","Bolivia",1974,55481000,34601000,"Japan",90082000,17.3593931413444,17.8315511777618
"1246","Bolivia",1975,88971000,21001000,"Japan",109972000,16.8600806136016,18.3038210319015
"1247","Bolivia",1976,64426000,27049000,"Japan",91475000,17.1131605939967,17.981027836307
"1248","Bolivia",1977,93784000,18812000,"Japan",112596000,16.7500055220471,18.3565048237338
"1249","Bolivia",1978,112357000,13437000,"Japan",125794000,16.4135226538575,18.5371918599507
"1250","Bolivia",1979,69779000,27026000,"Japan",96805000,17.1123099235802,18.0608436628664
"1251","Bolivia",1980,65091000,29393000,"Japan",94484000,17.1962671087216,17.9912968487736
"1252","Bolivia",1981,96137000,27187000,"Japan",123324000,17.1182494758395,18.3812848154498
"1253","Bolivia",1982,42081000,12820000,"Japan",54901000,16.3665170094568,17.5551068903699
"1254","Bolivia",1983,13881000,8696000,"Japan",22577000,15.9783737077832,16.4460315565572
"1255","Bolivia",1984,20912555,8519183,"Japan",29431738,15.9578310021888,16.8558602542797
"1256","Bolivia",1985,63179697,8291784,"Japan",71471481,15.9307757029945,17.9614935575052
"1257","Bolivia",1986,60193052,7918423,"Japan",68111475,15.8847026278027,17.9130674883358
"1258","Bolivia",1987,69935071,8398135,"Japan",78333206,15.9435202153531,18.0630778124235
"1259","Bolivia",1988,64056097,16256682,"Japan",80312779,16.6040145822205,17.9752697730334
"1260","Bolivia",1989,56968691,14965668,"Japan",71934359,16.5212693357602,17.8580123941872
"1261","Bolivia",1990,67070935,17873721,"Japan",84944656,16.6988420915368,18.0212613486378
"1262","Bolivia",1991,110729561,9932891,"Japan",120662452,16.1113621316147,18.5226013990679
"1263","Bolivia",1992,128476377,3111860,"Japan",131588237,14.9507311761219,18.6712556088237
"1264","Bolivia",1993,118918163,5458166,"Japan",124376329,15.512623393859,18.5939461086153
"1265","Bolivia",1994,164297294,4834189,"Japan",169131483,15.3912239375367,18.9171881129997
"1266","Bolivia",1995,156120631,5330238,"Japan",161450869,15.4889064480532,18.8661395420313
"1267","Bolivia",1996,180345185,14082624,"Japan",194427809,16.460452254967,19.0103832668704
"1268","Bolivia",1997,432438845,5406944,"Japan",437845789,15.5031946113658,19.8849514754945
"1269","Bolivia",1998,96186000,5502000,"Japan",101688000,15.5206222204667,18.3817943748999
"1270","Bolivia",1999,142707621,14186586,"Japan",156894207,16.4678074282232,18.7763084867673
"1271","Bolivia",2000,91232477,30641911,"Japan",121874388,17.2378792703435,18.3289214991095
"1272","Bolivia",2001,52641696,25829959,"Japan",78471655,17.0670455777692,17.7790190633073
"1273","Bolivia",2002,88361705,35211510,"Japan",123573215,17.3768835757556,18.2969492323916
"1274","Bolivia",2003,75962789,24083910,"Japan",100046699,16.9970545406387,18.1457541599273
"1275","Bolivia",2004,95325684,79118526,"Japan",174444210,18.186457615176,18.3728098391346
"1276","Bolivia",2005,128301649,71590524,"Japan",199892173,18.0864732768036,18.6698946821923
"1277","Bolivia",2006,200310033,164362101,"Japan",364672134,18.9175824848133,19.1153768892468
"1278","Bolivia",2007,296165090,248816929,"Japan",544982019,19.332227959119,19.5064275932976
"1279","Bolivia",2008,444117896,221969816,"Japan",666087712,19.2180519666287,19.9116006166808
"1280","Bolivia",2009,272426018,187618152,"Japan",460044170,19.0499193489174,19.4228776416285
"1281","Bolivia",2010,279858666,257475275,"Japan",537333941,19.3664342540404,19.4497952694114
"1282","Bolivia",2011,154798618,351527406,"Japan",506326024,19.6777982348811,18.8576355914315
"1283","Bolivia",2012,231696967,273969449,"Japan",505666416,19.4285271581358,19.2609408991141
"1284","Bolivia",2013,226670670,341737404,"Japan",568408074,19.6495531755372,19.2390087290751
"1285","Bolivia",2014,273964501,341421291,"Japan",615385792,19.6486277301762,19.4285090975648
"1286","Bolivia",2015,220437418,246480758,"Japan",466918176,19.3227944875482,19.211124393973
"1287","Bolivia",2016,172060133,266562112,"Japan",438622245,19.4011178400806,18.9633545841433
"1288","Bolivia",2017,235172832,449955953.5,"Japan",685128785.5,19.9246602548269,19.2758312571128
"1289","Brazil",1962,60190000,40079000,"Japan",100269000,17.5063630643298,17.913016783524
"1290","Brazil",1963,61703000,38391000,"Japan",100094000,17.4633336150878,17.9378431100599
"1291","Brazil",1964,33816000,37192000,"Japan",71008000,17.4316042423526,17.3364446212288
"1292","Brazil",1965,36727000,49573000,"Japan",86300000,17.7189568886416,17.4190227373569
"1293","Brazil",1966,44447000,60606000,"Japan",105053000,17.9199044560394,17.609808026083
"1294","Brazil",1967,50460000,85638000,"Japan",136098000,18.26563966784,17.7366915011772
"1295","Brazil",1968,73102000,87118000,"Japan",160220000,18.2827740794843,18.1073662841269
"1296","Brazil",1969,105664000,148299000,"Japan",253963000,18.8147410639971,18.4757748062619
"1297","Brazil",1970,177839000,217873000,"Japan",395712000,19.1994228821869,18.9963892045725
"1298","Brazil",1971,260428000,222432000,"Japan",482860000,19.2201319948824,19.3778369893998
"1299","Brazil",1972,365559000,249403000,"Japan",614962000,19.3345806200071,19.7169382468355
"1300","Brazil",1973,549399000,450847000,"Japan",1000246000,19.9266385937902,20.1243355114563
"1301","Brazil",1974,1250200000,661776000,"Japan",1911976000,20.3104376880617,20.946569375462
"1302","Brazil",1975,1256343000,883667000,"Japan",2140010000,20.5995908528013,20.9514709568823
"1303","Brazil",1976,969891000,818552000,"Japan",1788443000,20.5230474836066,20.6926942520136
"1304","Brazil",1977,935565000,946799000,"Japan",1882364000,20.6685973794143,20.6566611828253
"1305","Brazil",1978,1335948000,787005000,"Japan",2122953000,20.4837451596016,21.0129069891477
"1306","Brazil",1979,1179467000,1240433000,"Japan",2419900000,20.9387263491579,20.8883284784639
"1307","Brazil",1980,1191462000,1560862000,"Japan",2752324000,21.1685040697031,20.8984469614221
"1308","Brazil",1981,1379317000,1578459000,"Japan",2957776000,21.179714891599,21.0448542860622
"1309","Brazil",1982,973294000,1602743000,"Japan",2576037000,21.1949823733287,20.696196752783
"1310","Brazil",1983,737904000,1668972000,"Japan",2406876000,21.2354737049725,20.4193242928026
"1311","Brazil",1984,639521816,1798590694,"Japan",2438112510,21.3102692474071,20.276231292553
"1312","Brazil",1985,615013319,1640355387,"Japan",2255368706,21.2181787546968,20.2371544824469
"1313","Brazil",1986,969618628,1694683456,"Japan",2664302084,21.2507618087161,20.692413385141
"1314","Brazil",1987,878842304,2155759184,"Japan",3034601488,21.4914087880219,20.5941160356866
"1315","Brazil",1988,1046805307,3036120629,"Japan",4082925936,21.8338464285627,20.7690087983438
"1316","Brazil",1989,1315592846,2716804803,"Japan",4032397649,21.7227223219684,20.9975532344413
"1317","Brazil",1990,1216048707,2845243155,"Japan",4061291862,21.7689143683594,20.9188726747869
"1318","Brazil",1991,1225202207,3031169306,"Japan",4256371513,21.8322142915947,20.9263717342598
"1319","Brazil",1992,1139086400,2693635770,"Japan",3832722170,21.7141577053487,20.8534923745486
"1320","Brazil",1993,1529647837,2701040063,"Japan",4230687900,21.7169027443015,21.1483033739617
"1321","Brazil",1994,1783439241,2919327300,"Japan",4702766541,21.7946190499735,21.3018094948995
"1322","Brazil",1995,2447519331,3532072575,"Japan",5979591906,21.9851506673253,21.6183408306013
"1323","Brazil",1996,2615604745,3417130073,"Japan",6032734818,21.9520668757876,21.6847611677651
"1324","Brazil",1997,3151001410,2622878044,"Japan",5773879454,21.687538041897,21.8709861471984
"1325","Brazil",1998,3426170000,2904850000,"Japan",6331020000,21.7896475908053,21.954708856166
"1326","Brazil",1999,2474996173,2414217319,"Japan",4889213492,21.6046409800106,21.6295046867032
"1327","Brazil",2000,2729051861,2819644728,"Japan",5548696589,21.7598767309812,21.7272200821564
"1328","Brazil",2001,2809366344,2255375406,"Japan",5064741750,21.5365822732071,21.7562247945072
"1329","Brazil",2002,2117681858,2380403327,"Japan",4498085185,21.5905357753983,21.4735878641557
"1330","Brazil",2003,2283840847,2588837802,"Japan",4872678649,21.6744748868541,21.5491244446135
"1331","Brazil",2004,2613810827,3266452210,"Japan",5880263037,21.9069702817998,21.6840750803636
"1332","Brazil",2005,3088577858,3947533799,"Japan",7036111657,22.0963568661853,21.8509765817836
"1333","Brazil",2006,3531916759,4504321408,"Japan",8036238167,22.2283030858061,21.9851065517434
"1334","Brazil",2007,4129441725,5322701128,"Japan",9452142853,22.3952467422753,22.1414080592375
"1335","Brazil",2008,5856001173,8114107598,"Japan",13970108771,22.8168700624266,22.4907328139128
"1336","Brazil",2009,4707977093,5670391345,"Japan",10378368438,22.4585239725865,22.2725241607846
"1337","Brazil",2010,6196458747,8808552668,"Japan",15005011415,22.8989889805382,22.5472437959791
"1338","Brazil",2011,6152332019,12665767046,"Japan",18818099065,23.2621686827982,22.5400970369717
"1339","Brazil",2012,5698348821,12004520093,"Japan",17702868914,23.2085490902271,22.4634422892951
"1340","Brazil",2013,5581006654,11130672065,"Japan",16711678719,23.1329703836094,22.4426350010114
"1341","Brazil",2014,4669641475,9684421890,"Japan",14354063365,22.9937844407486,22.2643481337315
"1342","Brazil",2015,3867940691,7516104064,"Japan",11384044755,22.7403137640644,22.0759880811727
"1343","Brazil",2016,2760362941,6737602764,"Japan",9497965705,22.630970025607,21.7386280083924
"1344","Brazil",2017,3619893455.5,6276544432.5,"Japan",9896437888,22.5600854163817,22.0097104301686
"1345","Brunei",1962,0,0,"0",0,0,0
"1346","Brunei",1963,0,0,"0",0,0,0
"1347","Brunei",1964,0,0,"0",0,0,0
"1348","Brunei",1965,0,0,"0",0,0,0
"1349","Brunei",1966,0,0,"0",0,0,0
"1350","Brunei",1967,0,0,"0",0,0,0
"1351","Brunei",1968,0,0,"0",0,0,0
"1352","Brunei",1969,0,0,"0",0,0,0
"1353","Brunei",1970,0,0,"0",0,0,0
"1354","Brunei",1971,0,0,"0",0,0,0
"1355","Brunei",1972,0,0,"0",0,0,0
"1356","Brunei",1973,0,0,"0",0,0,0
"1357","Brunei",1974,0,0,"0",0,0,0
"1358","Brunei",1975,0,0,"0",0,0,0
"1359","Brunei",1976,0,0,"0",0,0,0
"1360","Brunei",1977,0,0,"0",0,0,0
"1361","Brunei",1978,0,0,"0",0,0,0
"1362","Brunei",1979,0,0,"0",0,0,0
"1363","Brunei",1980,0,0,"0",0,0,0
"1364","Brunei",1981,0,0,"0",0,0,0
"1365","Brunei",1982,0,0,"0",0,0,0
"1366","Brunei",1983,0,0,"0",0,0,0
"1367","Brunei",1984,71751274,1981804069,"Japan",2053555343,21.4072734127709,18.0887161685439
"1368","Brunei",1985,89920030,1688013859,"Japan",1777933889,21.2468184433945,18.3144312777395
"1369","Brunei",1986,104814161,1185649536,"Japan",1290463697,20.8935565930098,18.4676994447686
"1370","Brunei",1987,83400068,1072383312,"Japan",1155783380,20.7931494028473,18.2391596826764
"1371","Brunei",1988,107255764,985931617,"Japan",1093187381,20.7090975562064,18.490726857918
"1372","Brunei",1989,114328350,974868318,"Japan",1089196668,20.6978129613794,18.5545851295064
"1373","Brunei",1990,132833169,1145420508,"Japan",1278253677,20.8590376624259,18.7046045303864
"1374","Brunei",1991,172869940,1352464439,"Japan",1525334379,21.0251942755481,18.9680500778173
"1375","Brunei",1992,207378884,1214197937,"Japan",1421576821,20.9173495615981,19.1500580356545
"1376","Brunei",1993,154924784,1254913547,"Japan",1409838331,20.9503325203048,18.8584502925885
"1377","Brunei",1994,170705547,1074199884,"Japan",1244905431,20.7948419274483,18.955450682843
"1378","Brunei",1995,130302697,1210516154,"Japan",1340818851,20.9143126791521,18.6853707402692
"1379","Brunei",1996,132051512,1249346903,"Japan",1381398415,20.9458867741216,18.6987026468501
"1380","Brunei",1997,90682015,922234873,"Japan",1012916888,20.6423104920295,18.3228696043536
"1381","Brunei",1998,0,0,"0",0,0,0
"1382","Brunei",1999,52559705,933764412,"Japan",986324117,20.6547347288303,17.7774603194917
"1383","Brunei",2000,56280687,1478982649,"Japan",1535263336,21.1146202890309,17.845861996959
"1384","Brunei",2001,64966812,1509585129,"Japan",1574551941,21.1351007010162,17.9893871128518
"1385","Brunei",2002,185505480,1346327911,"Japan",1531833391,21.0206466573694,19.0385949813544
"1386","Brunei",2003,113154508,1637680705,"Japan",1750835213,21.2165468735836,18.5442647701693
"1387","Brunei",2004,126227224,1703909053,"Japan",1830136277,21.2561908912766,18.6535942058846
"1388","Brunei",2005,104492390,2045798963,"Japan",2150291353,21.4390542410949,18.4646248037509
"1389","Brunei",2006,194097540,2107767725,"Japan",2301865265,21.468895274173,19.0838713741795
"1390","Brunei",2007,123007847,2230578192,"Japan",2353586039,21.5255266677352,18.6277587080497
"1391","Brunei",2008,179792929,4025018877,"Japan",4204811806,22.1157954377438,19.0073163521984
"1392","Brunei",2009,162571367,2961073670,"Japan",3123645037,21.8088177658644,18.9066276448605
"1393","Brunei",2010,149493123,3582843067,"Japan",3732336190,21.9994224749798,18.822760949737
"1394","Brunei",2011,142804003,5705325819,"Japan",5848129822,22.4646659297603,18.7769836396897
"1395","Brunei",2012,187030006,5953134026,"Japan",6140164032,22.5071836448908,19.0467796218396
"1396","Brunei",2013,152038996,4741249976,"Japan",4893288972,22.2795666459054,18.8396475985381
"1397","Brunei",2014,106615093,4012451695,"Japan",4119066788,22.1126682867008,18.4847356450396
"1398","Brunei",2015,120102277,2342434560,"Japan",2462536837,21.5744566357208,18.6038542460712
"1399","Brunei",2016,83332713,1749247996,"Japan",1832580709,21.2824518159558,18.2383517431307
"1400","Brunei",2017,99350101.5,1659765607.5,"Japan",1759115709,21.229942229044,18.4141605486022
"1401","Bhutan",1962,0,0,"0",0,0,0
"1402","Bhutan",1963,0,0,"0",0,0,0
"1403","Bhutan",1964,0,0,"0",0,0,0
"1404","Bhutan",1965,0,0,"0",0,0,0
"1405","Bhutan",1966,0,0,"0",0,0,0
"1406","Bhutan",1967,0,0,"0",0,0,0
"1407","Bhutan",1968,0,0,"0",0,0,0
"1408","Bhutan",1969,0,0,"0",0,0,0
"1409","Bhutan",1970,0,0,"0",0,0,0
"1410","Bhutan",1971,0,0,"0",0,0,0
"1411","Bhutan",1972,0,0,"0",0,0,0
"1412","Bhutan",1973,0,0,"0",0,0,0
"1413","Bhutan",1974,0,0,"0",0,0,0
"1414","Bhutan",1975,0,0,"0",0,0,0
"1415","Bhutan",1976,0,0,"0",0,0,0
"1416","Bhutan",1977,0,0,"0",0,0,0
"1417","Bhutan",1978,0,0,"0",0,0,0
"1418","Bhutan",1979,0,0,"0",0,0,0
"1419","Bhutan",1980,0,0,"0",0,0,0
"1420","Bhutan",1981,0,0,"0",0,0,0
"1421","Bhutan",1982,0,0,"0",0,0,0
"1422","Bhutan",1983,0,0,"0",0,0,0
"1423","Bhutan",1984,2414792,44056,"Japan",2458848,10.6932168309423,14.6971237129952
"1424","Bhutan",1985,2065264,44063,"Japan",2109327,10.693375707008,14.5407686212421
"1425","Bhutan",1986,5403294,21722,"Japan",5425016,9.98608085083998,15.5025193255601
"1426","Bhutan",1987,3568698,2707,"Japan",3571405,7.9035962896143,15.0877113813521
"1427","Bhutan",1988,4823341,0,"Japan",4823341,0,15.3889773994338
"1428","Bhutan",1989,10896304,3800,"Japan",10900104,8.24275634571448,16.2039342071291
"1429","Bhutan",1990,6274319,514779,"Japan",6789098,13.1514929613313,15.6519755111963
"1430","Bhutan",1991,9077788,116062,"Japan",9193850,11.6618798100621,16.0213411085644
"1431","Bhutan",1992,10765882,206660,"Japan",10972542,12.2388302097683,16.191892617612
"1432","Bhutan",1993,12522236,401581,"Japan",12923817,12.9031645354835,16.3430165019394
"1433","Bhutan",1994,11339556,73602,"Japan",11413158,11.2064274782608,16.2438077020582
"1434","Bhutan",1995,7632942,927025,"Japan",8559967,13.7397358129006,15.8479839121666
"1435","Bhutan",1996,5853135,146832,"Japan",5999967,11.8970443550588,15.5824879731022
"1436","Bhutan",1997,6173038,130945,"Japan",6303983,11.7825326666945,15.635701657197
"1437","Bhutan",1998,0,0,"0",0,0,0
"1438","Bhutan",1999,6179741,219003,"Japan",6398744,12.2968407073349,15.6367869191705
"1439","Bhutan",2000,8274188,39740,"Japan",8313928,10.5901135161058,15.9286513475244
"1440","Bhutan",2001,7262458,75279,"Japan",7337737,11.2289564904303,15.7982288969931
"1441","Bhutan",2002,10078603,35995,"Japan",10114598,10.4911353189034,16.125925219733
"1442","Bhutan",2003,9669435,52522,"Japan",9721957,10.8689874084228,16.0844804375943
"1443","Bhutan",2004,21721904,3206872,"Japan",24928776,14.9808065651878,16.8938317103298
"1444","Bhutan",2005,13133876,178171,"Japan",13312047,12.0904990422794,16.3907054045434
"1445","Bhutan",2006,9018454,169791,"Japan",9188245,12.0423235479211,16.0147834804529
"1446","Bhutan",2007,14389211,706543,"Japan",15095754,13.4681393426658,16.4819892476175
"1447","Bhutan",2008,20056657,1265599,"Japan",21322256,14.0510560858561,16.8140716765606
"1448","Bhutan",2009,8885195,323951,"Japan",9209146,12.6883475487695,15.9998969664319
"1449","Bhutan",2010,20205488,2853377,"Japan",23058865,14.864013763071,16.8214648086406
"1450","Bhutan",2011,18449025,3307267,"Japan",21756292,15.0116327265337,16.730522081526
"1451","Bhutan",2012,7477098,2243940,"Japan",9721038,14.6237438072993,15.8273553067572
"1452","Bhutan",2013,5178000,2156048,"Japan",7334048,14.583787474214,15.4599294392936
"1453","Bhutan",2014,9582012,637333,"Japan",10219345,13.3650475609127,16.0753981487726
"1454","Bhutan",2015,14387096,165685,"Japan",14552781,12.0178436742718,16.4818422516875
"1455","Bhutan",2016,7982403,1035536,"Japan",9017939,13.8504297250271,15.8927500519157
"1456","Bhutan",2017,0,0,"0",0,0,0
"1457","Botswana",1962,0,0,"0",0,0,0
"1458","Botswana",1963,0,0,"0",0,0,0
"1459","Botswana",1964,0,0,"0",0,0,0
"1460","Botswana",1965,0,0,"0",0,0,0
"1461","Botswana",1966,0,0,"0",0,0,0
"1462","Botswana",1967,0,0,"0",0,0,0
"1463","Botswana",1968,0,0,"0",0,0,0
"1464","Botswana",1969,0,0,"0",0,0,0
"1465","Botswana",1970,0,0,"0",0,0,0
"1466","Botswana",1971,0,0,"0",0,0,0
"1467","Botswana",1972,0,0,"0",0,0,0
"1468","Botswana",1973,0,0,"0",0,0,0
"1469","Botswana",1974,0,0,"0",0,0,0
"1470","Botswana",1975,0,0,"0",0,0,0
"1471","Botswana",1976,0,0,"0",0,0,0
"1472","Botswana",1977,0,0,"0",0,0,0
"1473","Botswana",1978,0,0,"0",0,0,0
"1474","Botswana",1979,0,0,"0",0,0,0
"1475","Botswana",1980,0,0,"0",0,0,0
"1476","Botswana",1981,0,0,"0",0,0,0
"1477","Botswana",1982,0,0,"0",0,0,0
"1478","Botswana",1983,0,0,"0",0,0,0
"1479","Botswana",1984,0,0,"0",0,0,0
"1480","Botswana",1985,0,0,"0",0,0,0
"1481","Botswana",1986,0,0,"0",0,0,0
"1482","Botswana",1987,0,0,"0",0,0,0
"1483","Botswana",1988,0,0,"0",0,0,0
"1484","Botswana",1989,0,0,"0",0,0,0
"1485","Botswana",1990,0,0,"0",0,0,0
"1486","Botswana",1991,0,0,"0",0,0,0
"1487","Botswana",1992,0,0,"0",0,0,0
"1488","Botswana",1993,0,0,"0",0,0,0
"1489","Botswana",1994,0,0,"0",0,0,0
"1490","Botswana",1995,0,0,"0",0,0,0
"1491","Botswana",1996,0,0,"0",0,0,0
"1492","Botswana",1997,0,0,"0",0,0,0
"1493","Botswana",1998,0,0,"0",0,0,0
"1494","Botswana",1999,0,0,"0",0,0,0
"1495","Botswana",2000,2168848,2443,"Japan",2171291,7.80098207125774,14.5897067089763
"1496","Botswana",2001,1507963,0,"Japan",1507963,0,14.22627029144
"1497","Botswana",2002,1348638,362884,"Japan",1711522,12.8018385029484,14.1146057522548
"1498","Botswana",2003,11393898,18243118,"Japan",29637016,16.7192984709838,16.2485885069024
"1499","Botswana",2004,18969261,22213419,"Japan",41182680,16.9162071236899,16.7583303849057
"1500","Botswana",2005,18975476,24650352,"Japan",43625828,17.0203017382699,16.7586579665703
"1501","Botswana",2006,15940959,22982342,"Japan",38923301,16.9502367399004,16.5844023926283
"1502","Botswana",2007,24131365,26363478,"Japan",50494843,17.0874902012318,16.9990230045881
"1503","Botswana",2008,32095089,24636124,"Japan",56731213,17.019724379061,17.2842135857418
"1504","Botswana",2009,27409963,17127815,"Japan",44537778,16.6562143081658,17.1264171184057
"1505","Botswana",2010,14945403,21020545,"Japan",35965948,16.8610108507649,16.5199143188769
"1506","Botswana",2011,39999310,32137294,"Japan",72136604,17.2855277205785,17.5043727619294
"1507","Botswana",2012,38874859,27636544,"Japan",66511403,17.1346495128666,17.4758583014474
"1508","Botswana",2013,27541642,23062795,"Japan",50604437,16.9537312710111,17.1312096718549
"1509","Botswana",2014,30983540,16988573,"Japan",47972113,16.648051499538,17.2489666536942
"1510","Botswana",2015,32284101,10697153,"Japan",42981254,16.1854881892616,17.2900854379062
"1511","Botswana",2016,24691841,24802982,"Japan",49494823,17.0264744458422,17.0219834231426
"1512","Botswana",2017,28046141,20550299.5,"Japan",48596440.5,16.8383860730096,17.149361604711
"1513","Central African Republic",1962,1247000,33000,"Japan",1280000,10.4042628404486,14.0362512246622
"1514","Central African Republic",1963,170000,15000,"Japan",185000,9.61580548008435,12.0435537160324
"1515","Central African Republic",1964,225000,42000,"Japan",267000,10.6454248972655,12.3238556811866
"1516","Central African Republic",1965,447000,179000,"Japan",626000,12.0951410848229,13.0103138735957
"1517","Central African Republic",1966,694000,145000,"Japan",839000,11.8844890214027,13.4502272394889
"1518","Central African Republic",1967,1053000,442000,"Japan",1495000,12.9990651610598,13.8671537911161
"1519","Central African Republic",1968,740000,249000,"Japan",989000,12.4252081754468,13.5144054651804
"1520","Central African Republic",1969,635000,117000,"Japan",752000,11.6699292137799,13.3613802778748
"1521","Central African Republic",1970,682000,1774000,"Japan",2456000,14.3887474418517,13.4327849368256
"1522","Central African Republic",1971,545000,1149000,"Japan",1694000,13.9544025568309,13.2085410736454
"1523","Central African Republic",1972,1042000,235000,"Japan",1277000,12.3673407931263,13.8566525012955
"1524","Central African Republic",1973,1162000,891000,"Japan",2053000,13.7000997064529,13.965653216394
"1525","Central African Republic",1974,866000,1385000,"Japan",2251000,14.1412106976036,13.6716401875446
"1526","Central African Republic",1975,1107000,2605000,"Japan",3712000,14.7729432331696,13.9171642116908
"1527","Central African Republic",1976,1513000,5645000,"Japan",7158000,15.5462807555659,14.2296049927705
"1528","Central African Republic",1977,2892000,7304000,"Japan",10196000,15.8039327012569,14.8774588622608
"1529","Central African Republic",1978,3367000,2425000,"Japan",5792000,14.7013420823537,15.0295326981432
"1530","Central African Republic",1979,2890000,4816000,"Japan",7706000,15.3874542659708,14.8767670600886
"1531","Central African Republic",1980,5809000,9754000,"Japan",15563000,16.0931880152521,15.5749189969747
"1532","Central African Republic",1981,2414000,7760000,"Japan",10174000,15.8644928921594,14.6967956806396
"1533","Central African Republic",1982,5160000,6965000,"Japan",12125000,15.756408165196,15.4564471374577
"1534","Central African Republic",1983,5156000,12716000,"Japan",17872000,16.3583716010128,15.4556716430412
"1535","Central African Republic",1984,4777949,8667585,"Japan",13445534,15.9751007632426,15.3795219328888
"1536","Central African Republic",1985,4886971,6401014,"Japan",11287985,15.67196697328,15.4020832421238
"1537","Central African Republic",1986,4882583,4856590,"Japan",9739173,15.3958471035173,15.4011849410764
"1538","Central African Republic",1987,3840790,708909,"Japan",4549699,13.4714824474883,15.1611886325712
"1539","Central African Republic",1988,7626644,471859,"Japan",8098503,13.0644354911258,15.8471584637754
"1540","Central African Republic",1989,8575582,1205979,"Japan",9781561,14.0028022431823,15.9644294204332
"1541","Central African Republic",1990,7238247,1351,"Japan",7239598,7.2086003379602,15.7948896079726
"1542","Central African Republic",1991,10078050,268066,"Japan",10346116,12.4989884978306,16.1258703495122
"1543","Central African Republic",1992,7113114,105813,"Japan",7218927,11.569428664204,15.7774506805801
"1544","Central African Republic",1993,5683630,668832,"Japan",6352462,13.413288186498,15.5531006710768
"1545","Central African Republic",1994,6361187,34853,"Japan",6396040,10.4588944956975,15.6657255531222
"1546","Central African Republic",1995,33060844,182220,"Japan",33243064,12.1129700272678,17.3138601793719
"1547","Central African Republic",1996,5346981,29695,"Japan",5376676,10.29873396045,15.4920426605301
"1548","Central African Republic",1997,4951283,543413,"Japan",5494696,13.2056248991332,15.4151572928796
"1549","Central African Republic",1998,3856000,582000,"Japan",4438000,13.2742257267136,15.1651409347126
"1550","Central African Republic",1999,4262111,418079,"Japan",4680190,12.9434256888649,15.2652751354123
"1551","Central African Republic",2000,4012763,699563,"Japan",4712326,13.4582111333638,15.2049905894438
"1552","Central African Republic",2001,3199825,1684798,"Japan",4884623,14.3371562332766,14.9786066787745
"1553","Central African Republic",2002,2480202,962264,"Japan",3442466,13.7770441202737,14.7238505664371
"1554","Central African Republic",2003,2087841,1818140,"Japan",3905981,14.4133245584554,14.5516410756599
"1555","Central African Republic",2004,2044620,1998567,"Japan",4043187,14.5079409817154,14.5307225111216
"1556","Central African Republic",2005,1159200,1904193,"Japan",3063393,14.4595688547425,13.9632406699886
"1557","Central African Republic",2006,840828,1590686,"Japan",2431514,14.279675927691,13.6421423996079
"1558","Central African Republic",2007,1157551,2029142,"Japan",3186693,14.5231236015735,13.9618171244471
"1559","Central African Republic",2008,1777972,1532450,"Japan",3310422,14.2423783198328,14.3909839469005
"1560","Central African Republic",2009,1233046,1301042,"Japan",2534088,14.0786760398329,14.024998088831
"1561","Central African Republic",2010,1825938,922367,"Japan",2748305,13.7346984710611,14.4176043855628
"1562","Central African Republic",2011,3897681,1556612,"Japan",5454293,14.2580222225873,15.1758923188614
"1563","Central African Republic",2012,1402237,1089632,"Japan",2491869,13.9013505825218,14.1535793765128
"1564","Central African Republic",2013,804484,2902654,"Japan",3707138,14.8811360488555,13.5979563570875
"1565","Central African Republic",2014,827499,2107032,"Japan",2934531,14.5607908801413,13.6261631777734
"1566","Central African Republic",2015,5928429,1498900,"Japan",7427329,14.2202420637187,15.5952698117606
"1567","Central African Republic",2016,2766479,1612769,"Japan",4379248,14.2934631354443,14.8330859504728
"1568","Central African Republic",2017,4354899.5,284973.5,"Japan",4639873,12.5601514724715,15.2868120910794
"1569","Canada",1962,117098000,255012000,"Japan",372110000,19.356821160839,18.5785217490028
"1570","Canada",1963,121065000,318817000,"Japan",439882000,19.5801278284272,18.6118381494087
"1571","Canada",1964,161306000,378710000,"Japan",540016000,19.7522812986496,18.8988137401718
"1572","Canada",1965,212872000,356772000,"Japan",569644000,19.6926074802545,19.1762016040704
"1573","Canada",1966,234068000,451337000,"Japan",685405000,19.9277248468122,19.2711222293971
"1574","Canada",1967,281914000,633377000,"Japan",915291000,20.2665763794424,19.4571126178522
"1575","Canada",1968,333168000,660347000,"Japan",993515000,20.3082760123984,19.6241574252296
"1576","Canada",1969,458526000,669455000,"Japan",1127981000,20.3219745064975,19.9435275547052
"1577","Canada",1970,557055000,928661000,"Japan",1485716000,20.649254321679,20.1381745362843
"1578","Canada",1971,794172000,1003285000,"Japan",1797457000,20.7265454531213,20.4928106204368
"1579","Canada",1972,1116045000,1148852000,"Japan",2264897000,20.8620290198578,20.8330570226732
"1580","Canada",1973,1018215000,2012213000,"Japan",3030428000,21.4225009483918,20.7413169312038
"1581","Canada",1974,1459374000,2665634000,"Japan",4125008000,21.7037077649575,21.1012734135965
"1582","Canada",1975,1184349000,2499412000,"Japan",3683761000,21.6393213411567,20.8924590934875
"1583","Canada",1976,1547807000,2715430000,"Japan",4263237000,21.7222161571655,21.1601049273385
"1584","Canada",1977,1694992000,2880660000,"Japan",4575652000,21.7812852715063,21.2509438580037
"1585","Canada",1978,318844000,3182311000,"Japan",3501155000,21.8808734993582,19.5802125129227
"1586","Canada",1979,1842127000,4084028000,"Japan",5926155000,22.1303495932488,21.3341867191998
"1587","Canada",1980,2387259000,4722206000,"Japan",7109465000,22.2755419002405,21.5934116828158
"1588","Canada",1981,3369315000,4462029000,"Japan",7831344000,22.2188694322633,21.9379752965548
"1589","Canada",1982,2859268000,4434081000,"Japan",7293349000,22.2125862159033,21.773831484963
"1590","Canada",1983,3577481000,4376873000,"Japan",7954354000,22.1996003794269,21.9979247584094
"1591","Canada",1984,4051302545,5602208337,"Japan",9653510882,22.4464267028465,22.1223042824069
"1592","Canada",1985,4100652820,4431951786,"Japan",8532604606,22.2121059077221,22.1344120223721
"1593","Canada",1986,5022122603,4491314438,"Japan",9513437041,22.2254112437425,22.3371185105658
"1594","Canada",1987,5223780845,5682421205,"Japan",10906202050,22.4606432473388,22.3764872764709
"1595","Canada",1988,6857618592,7527742037,"Japan",14385360629,22.7418609715063,22.6486260743924
"1596","Canada",1989,7306462943,7786010430,"Japan",15092473373,22.7755944257176,22.7120251280807
"1597","Canada",1990,7404122787,7621175158,"Japan",15025297945,22.7541964149642,22.7253028153937
"1598","Canada",1991,8110916407,6950415589,"Japan",15061331996,22.6620672917138,22.816476695854
"1599","Canada",1992,8053548195,6894574236,"Japan",14948122431,22.6540005966114,22.8093786008317
"1600","Canada",1993,7460287293,7234198939,"Japan",14694486232,22.7020854706511,22.7328597615466
"1601","Canada",1994,7488554155,7978674273,"Japan",15467228428,22.8000381034038,22.7366415791259
"1602","Canada",1995,7926468288,9650788495,"Japan",17577256783,22.9903054582857,22.7934734124826
"1603","Canada",1996,6880278397,9032782619,"Japan",15913061016,22.9241263096192,22.6519249527532
"1604","Canada",1997,8472168085,6869220488,"Japan",15341388573,22.6503164706585,22.8600522851101
"1605","Canada",1998,9512005000,7603059000,"Japan",17115064000,22.7518165032573,22.9758205219866
"1606","Canada",1999,9095122953,7098957557,"Japan",16194080510,22.6832137872564,22.9310041675717
"1607","Canada",2000,10030551021,7809987820,"Japan",17840538841,22.7786692412577,23.0289013746994
"1608","Canada",2001,8488731774,6941710600,"Japan",15430442374,22.6608140652428,22.862005447313
"1609","Canada",2002,8808758318,6415388811,"Japan",15224147129,22.5819654428422,22.8990123268934
"1610","Canada",2003,8872869081,6781050847,"Japan",15653919928,22.6373979190716,22.9062640399291
"1611","Canada",2004,9322346965,7562532472,"Japan",16884879437,22.7464719541123,22.9556802542215
"1612","Canada",2005,10942223885,8007807483,"Japan",18950031368,22.8036828380859,23.1158948934462
"1613","Canada",2006,12131069852,8627264353,"Japan",20758334205,22.8781932990891,23.2190357548589
"1614","Canada",2007,12512281725,8898806269,"Japan",21411087994,22.90918297761,23.2499765368801
"1615","Canada",2008,12445258307,11447468510,"Japan",23892726817,23.1610344516728,23.2446055284365
"1616","Canada",2009,9346839322,8232664930,"Japan",17579504252,22.8313756060257,22.9583040826707
"1617","Canada",2010,11284558017,9774413855,"Japan",21058971872,23.0030339773371,23.1467010809195
"1618","Canada",2011,8707983293,12885832681,"Japan",21593815974,23.2793943030217,22.8875060617363
"1619","Canada",2012,10102495087,12603456477,"Japan",22705951564,23.2572369368554,23.0360482686015
"1620","Canada",2013,8511724927,11922152413,"Japan",20433877340,23.2016640538429,22.8647104531166
"1621","Canada",2014,7889912843,11209811692,"Japan",19099724535,23.1400552756735,22.7888509252286
"1622","Canada",2015,7666049206,9131777000,"Japan",16797826206,22.9350261456925,22.7600672226162
"1623","Canada",2016,8088660247,9146773846,"Japan",17235434093,22.9366670689245,22.8137289482458
"1624","Canada",2017,11622755591,10000490957.5,"Japan",21623246548.5,23.0259000244853,23.1762307023391
"1625","Switzerland",1962,37446000,53870000,"Japan",91316000,17.8020842946567,17.4384104531442
"1626","Switzerland",1963,39138000,63688000,"Japan",102826000,17.9695067197506,17.4826044200063
"1627","Switzerland",1964,44152000,73305000,"Japan",117457000,18.1101393773545,17.6031487841015
"1628","Switzerland",1965,49722000,70165000,"Japan",119887000,18.0663601691674,17.7219580490592
"1629","Switzerland",1966,55642000,69987000,"Japan",125629000,18.0638200684809,17.8344488697365
"1630","Switzerland",1967,64312000,87135000,"Japan",151447000,18.2829691980769,17.9792567969899
"1631","Switzerland",1968,70530000,117147000,"Japan",187677000,18.5789401143956,18.0715487091844
"1632","Switzerland",1969,93488000,149232000,"Japan",242720000,18.8210126999488,18.3533436437764
"1633","Switzerland",1970,142871000,176922000,"Japan",319793000,18.9912195154449,18.7774526831869
"1634","Switzerland",1971,184033000,191105000,"Japan",375138000,19.0683335731801,19.0306256473184
"1635","Switzerland",1972,251184000,229616000,"Japan",480800000,19.2519189063928,19.3416962962622
"1636","Switzerland",1973,294708000,379027000,"Japan",673735000,19.7531180006148,19.5014955935899
"1637","Switzerland",1974,345296000,453096000,"Japan",798392000,19.9316145815251,19.6599125781634
"1638","Switzerland",1975,322931000,417626000,"Japan",740557000,19.850096853131,19.5929492360754
"1639","Switzerland",1976,389228000,415899000,"Japan",805127000,19.8459530002861,19.7796758481344
"1640","Switzerland",1977,538993000,455870000,"Japan",994863000,19.9377182391141,20.105213141776
"1641","Switzerland",1978,686686000,626248000,"Japan",1312934000,20.2552570167455,20.3473876860232
"1642","Switzerland",1979,806179000,779229000,"Japan",1585408000,20.4738155272592,20.5078163601811
"1643","Switzerland",1980,1188292000,751722000,"Japan",1940014000,20.4378771327142,20.8957828189309
"1644","Switzerland",1981,1173621000,685204000,"Japan",1858825000,20.3452271621088,20.8833596782935
"1645","Switzerland",1982,1060210000,679636000,"Japan",1739846000,20.3370679186957,20.7817328386561
"1646","Switzerland",1983,1116474000,726993000,"Japan",1843467000,20.4044274068407,20.8334413419156
"1647","Switzerland",1984,1130109927,1791687236,"Japan",2921797163,21.3064236027843,20.8455807454702
"1648","Switzerland",1985,1201313383,1595465173,"Japan",2796778556,21.1904311751773,20.9066812810607
"1649","Switzerland",1986,1893043974,2351661889,"Japan",4244705863,21.5783881019722,21.3614519386978
"1650","Switzerland",1987,2302694521,2853947176,"Japan",5156641697,21.7719688470701,21.5573458050443
"1651","Switzerland",1988,2694586972,3244214533,"Japan",5938801505,21.9001391032571,21.7145107724194
"1652","Switzerland",1989,2602438836,3526847182,"Japan",6129286018,21.9836701592208,21.6797148561599
"1653","Switzerland",1990,2972648709,3742609251,"Japan",6715257960,22.0430488658159,21.8127192135369
"1654","Switzerland",1991,2894264806,3309543243,"Japan",6203808049,21.9200760237621,21.7859969626974
"1655","Switzerland",1992,2753441206,2893327910,"Japan",5646769116,21.7856732025248,21.7361173139783
"1656","Switzerland",1993,2237883550,2576730865,"Japan",4814614415,21.6697873258325,21.5287964124171
"1657","Switzerland",1994,2324234406,2783782908,"Japan",5108017314,21.7470765979298,21.5666565340167
"1658","Switzerland",1995,2453938406,3658254465,"Japan",6112192871,22.020251948465,21.6209600834906
"1659","Switzerland",1996,2158561807,3212288813,"Japan",5370850620,21.8902495458629,21.4927080067866
"1660","Switzerland",1997,2184087541,2720906543,"Japan",4904994084,21.7242309495939,21.5044639769012
"1661","Switzerland",1998,2126177000,2880360000,"Japan",5006537000,21.7811811232824,21.4775913683395
"1662","Switzerland",1999,2287432669,3047792738,"Japan",5335225407,21.8376834731149,21.5506959203638
"1663","Switzerland",2000,2357733098,2966316368,"Japan",5324049466,21.8105867398424,21.5809664426636
"1664","Switzerland",2001,2123555036,2962936056,"Japan",5086491092,21.8094465244747,21.4763574249706
"1665","Switzerland",2002,1781328300,2993495653,"Japan",4774823953,21.8197076561823,21.3006251589099
"1666","Switzerland",2003,2164024356,3496581697,"Japan",5660606053,21.9750516702006,21.4952354529505
"1667","Switzerland",2004,2528776238,4345704891,"Japan",6874481129,22.1924538128856,21.6510013222698
"1668","Switzerland",2005,2449450118,4548607441,"Japan",6998057559,22.2380869661412,21.6191293946796
"1669","Switzerland",2006,2755206566,4594071949,"Japan",7349278515,22.2480326026057,21.7367582553249
"1670","Switzerland",2007,3382749141,4701849613,"Japan",8084598754,22.2712218029288,21.9419545711726
"1671","Switzerland",2008,4728598763,5779427570,"Japan",10508026333,22.4775704783941,22.2768947509523
"1672","Switzerland",2009,6389331509,5674327465,"Japan",12063658974,22.4592178849212,22.5778954846833
"1673","Switzerland",2010,7613840618,6143971080,"Japan",13757811698,22.5387371257495,22.7532335619322
"1674","Switzerland",2011,9216587110,7838387504,"Japan",17054974614,22.7822989746444,22.944270644383
"1675","Switzerland",2012,4362832567,8202666872,"Japan",12565499439,22.827725166634,22.1963873546926
"1676","Switzerland",2013,3298505071,7286772684,"Japan",10585277755,22.7093265804176,21.9167351939915
"1677","Switzerland",2014,3013465648,7207207599,"Japan",10220673247,22.6983474176633,21.8263566314529
"1678","Switzerland",2015,2682486495,7386600453,"Japan",10069086948,22.7229334461732,21.7100099979737
"1679","Switzerland",2016,3111395014,7642622360,"Japan",10754017374,22.7570066220689,21.858337020122
"1680","Switzerland",2017,5454460823,7838765913.5,"Japan",13293226736.5,22.7823472499263,22.4196996104664
"1681","Chile",1962,14603000,60812000,"Japan",75415000,17.9232976958829,16.4967375450226
"1682","Chile",1963,12447000,62474000,"Japan",74921000,17.9502610281546,16.3369901879831
"1683","Chile",1964,11930000,95251000,"Japan",107181000,18.3720260706036,16.2945667940741
"1684","Chile",1965,9236000,131607000,"Japan",140843000,18.6953307669302,16.0386194494565
"1685","Chile",1966,16818000,149444000,"Japan",166262000,18.8224322986819,16.637960299375
"1686","Chile",1967,8884000,166923000,"Japan",175807000,18.9330431862076,15.9997624639965
"1687","Chile",1968,13280000,187062000,"Japan",200342000,19.0469506706702,16.4017697020126
"1688","Chile",1969,18211000,196772000,"Japan",214983000,19.0975562560374,16.717536365078
"1689","Chile",1970,27700000,212411000,"Japan",240111000,19.1740336350683,17.1369429711576
"1690","Chile",1971,44317000,241580000,"Japan",285897000,19.3027112391414,17.6068789085816
"1691","Chile",1972,33473000,179962000,"Japan",213435000,19.0082562754563,17.3262497016775
"1692","Chile",1973,35211000,269209000,"Japan",304420000,19.4109985875683,17.3768690917504
"1693","Chile",1974,48579000,402792000,"Japan",451371000,19.8139308576383,17.6987018967237
"1694","Chile",1975,77990000,258456000,"Japan",336446000,19.370236024659,18.1720911713067
"1695","Chile",1976,77164000,298259000,"Japan",375423000,19.5134727945138,18.1614435849899
"1696","Chile",1977,219986000,326586000,"Japan",546572000,19.6042038716909,19.2090744659281
"1697","Chile",1978,224497000,367272000,"Japan",591769000,19.7216132759211,19.2293729020283
"1698","Chile",1979,245515000,549656000,"Japan",795171000,20.124803185967,19.3188686031287
"1699","Chile",1980,462380000,643410000,"Japan",1105790000,20.2822927150793,19.9518976217919
"1700","Chile",1981,741989000,529263000,"Japan",1271252000,20.0869960307385,20.4248449762239
"1701","Chile",1982,231050000,579044000,"Japan",810094000,20.1768890257415,19.2581446952805
"1702","Chile",1983,140861000,500313000,"Japan",641174000,20.0307444605302,18.7632841465038
"1703","Chile",1984,309321848,581543781,"Japan",890865629,20.1811968168567,19.5498928720827
"1704","Chile",1985,168710631,481676226,"Japan",650386857,19.9927827160125,18.943695562721
"1705","Chile",1986,292930200,477954379,"Japan",770884579,19.9850258444783,19.4954449133452
"1706","Chile",1987,366258121,558170493,"Japan",924428614,20.1401750166876,19.7188488914286
"1707","Chile",1988,368822561,913884296,"Japan",1282706857,20.6332145305955,19.7258262218537
"1708","Chile",1989,686489078,1191672106,"Japan",1878161184,20.8986232888894,20.3471008733589
"1709","Chile",1990,511913849,1475977438,"Japan",1987891287,21.1125862771,20.053666905174
"1710","Chile",1991,591859185,1703037057,"Japan",2294896242,21.2556789982258,20.1987793013787
"1711","Chile",1992,870152578,1701364269,"Japan",2571516847,21.2546962773451,20.5841791312476
"1712","Chile",1993,795832423,1629390136,"Japan",2425222559,21.2114716320604,20.494899197776
"1713","Chile",1994,916523665,1929730336,"Japan",2846254001,21.3806461078213,20.6360984459691
"1714","Chile",1995,915801620,2844617048,"Japan",3760418668,21.7686942901922,20.6353103271309
"1715","Chile",1996,854307718,2471696214,"Japan",3326003932,21.6281704782135,20.5658020123781
"1716","Chile",1997,895239473,2159413265,"Japan",3054652738,21.4931023851685,20.6126018080471
"1717","Chile",1998,990388000,2394179000,"Japan",3384567000,21.596306211546,20.7136073435046
"1718","Chile",1999,569684324,2242380996,"Japan",2812065320,21.5308040829306,20.1605929478354
"1719","Chile",2000,629367928,2561501823,"Japan",3190869751,21.6638595730356,20.2602265848298
"1720","Chile",2001,491720501,2192139337,"Japan",2683859838,21.5081437701616,20.0134210256354
"1721","Chile",2002,477893686,1925550188,"Japan",2403443874,21.3784775757978,19.9848988514921
"1722","Chile",2003,552034464,2364878424,"Japan",2916912888,21.5839924512265,20.129121037075
"1723","Chile",2004,701822454,3751622606,"Japan",4453445060,22.0454542782766,20.3691910154719
"1724","Chile",2005,901011711,4605419326,"Japan",5506431037,22.2504995613572,20.6190288132684
"1725","Chile",2006,1009559070,6538743838,"Japan",7548302908,22.6010109102667,20.7327795081212
"1726","Chile",2007,1363771551,7316086872,"Japan",8679858423,22.7133414416528,21.0335198977365
"1727","Chile",2008,2814576474,7145616237,"Japan",9960192711,22.689764891915,21.7580776339329
"1728","Chile",2009,1415305534,4779543686,"Japan",6194849220,22.287610915713,21.0706112698215
"1729","Chile",2010,2999855245,6759491824,"Japan",9759347069,22.6342135502111,21.8218298727837
"1730","Chile",2011,1744560292,9822116186,"Japan",11566676478,23.0079024336525,21.2797683791862
"1731","Chile",2012,1633409898,9352507875,"Japan",10985917773,22.9589103662071,21.2139356286228
"1732","Chile",2013,1573568644,8020068163,"Japan",9593636807,22.8052127579159,21.1766118985569
"1733","Chile",2014,1384112414,8140978960,"Japan",9525091374,22.8201762750858,21.0483249148318
"1734","Chile",2015,1289705029,5997128721,"Japan",7286833750,22.5145466451345,20.9776793694835
"1735","Chile",2016,1301088039,5348508266,"Japan",6649596305,22.4000835301893,20.9864667044409
"1736","Chile",2017,1940510455.5,6488571459.5,"Japan",8429081915,22.5933082293351,21.386216896803
"1737","China",1962,38461000,46027000,"Japan",84488000,17.6447387387835,17.4651552988269
"1738","China",1963,62425000,74608000,"Japan",137033000,18.1277582980302,17.9494763941301
"1739","China",1964,152757000,157761000,"Japan",310518000,18.8765917875409,18.8443589814799
"1740","China",1965,245055000,224719000,"Japan",469774000,19.2303612907682,19.3169932331109
"1741","China",1966,315174000,306265000,"Japan",621439000,19.5399612982156,19.5686354252361
"1742","China",1967,288319000,269465000,"Japan",557784000,19.4119490697496,19.4795780640098
"1743","China",1968,325472000,224201000,"Japan",549673000,19.2280535288957,19.6007869944075
"1744","China",1969,390828000,234560000,"Japan",625388000,19.2732219766626,19.7837781234681
"1745","China",1970,568917000,253836000,"Japan",822753000,19.3521989471573,20.1592451115033
"1746","China",1971,577738000,321445000,"Japan",899183000,19.5883370139124,20.1746310366737
"1747","China",1972,608917000,491116000,"Japan",1100033000,20.0121909104014,20.2271925273876
"1748","China",1973,1041493000,971286000,"Japan",2012779000,20.6941315245963,20.7639210975673
"1749","China",1974,1989210000,1307303000,"Japan",3296513000,20.9912320733355,21.4110034119388
"1750","China",1975,2257102000,1533091000,"Japan",3790193000,21.1505517958049,21.5373475264944
"1751","China",1976,1662567000,1370916000,"Japan",3033483000,21.038744966503,21.2316286304341
"1752","China",1977,1938641000,1546910000,"Japan",3485551000,21.159525229728,21.3852530490821
"1753","China",1978,3048750000,2030297000,"Japan",5079047000,21.4314479247172,21.8379975074944
"1754","China",1979,3698630000,2954773000,"Japan",6653403000,21.8066876659028,22.0312283177594
"1755","China",1980,5078307000,4323366000,"Japan",9401673000,22.1873001024763,22.3482437752742
"1756","China",1981,5095434000,5291794000,"Japan",10387228000,22.3894231557597,22.3516106815439
"1757","China",1982,3510738000,5352418000,"Japan",8863156000,22.4008142583668,21.9790921087337
"1758","China",1983,4912219000,5087358000,"Japan",9999577000,22.3500244757777,22.3149916114879
"1759","China",1984,7216711560,5452798497,"Japan",12669510057,22.419394799521,22.6996652234927
"1760","China",1985,12479681660,5903628335,"Japan",18383309995,22.4988329708742,23.2473676915495
"1761","China",1986,9856177409,5137049759,"Japan",14993227168,22.3597447747775,23.011364243677
"1762","China",1987,9167198899,6776705214,"Japan",15943904113,22.6367568641464,22.9388976129744
"1763","China",1988,10109515353,8966498042,"Japan",19076013395,22.9167610289844,23.036742931441
"1764","China",1989,9582817675,10198712207,"Japan",19781529882,23.0455272950502,22.9832375062479
"1765","China",1990,6890996864,10987018530,"Japan",17878015394,23.1199802792024,22.653481594235
"1766","China",1991,9094940238,12949731975,"Japan",22044672213,23.2843409279666,22.9309840780318
"1767","China",1992,12386439138,15380504791,"Japan",27766943929,23.4563666217467,23.2398680932178
"1768","China",1993,21199449331,18474464417,"Japan",39673913748,23.6396553137529,23.7772410433342
"1769","China",1994,23842587167,24834595715,"Japan",48677182882,23.9355035065329,23.8947391953612
"1770","China",1995,26055281414,32463528855,"Japan",58518810269,24.2033831070796,23.9834863260169
"1771","China",1996,26301508978,36439621695,"Japan",62741130673,24.3189225276981,23.9928921500736
"1772","China",1997,25464050710,33432105178,"Japan",58896155888,24.2327825081148,23.9605335183631
"1773","China",1998,28271346000,36891230000,"Japan",65162576000,24.3312396903684,24.0651146198283
"1774","China",1999,30447451297,38633500197,"Japan",69080951494,24.3773856177778,24.1392681263512
"1775","China",2000,37448888578,49688975636,"Japan",87137864214,24.6290489272546,24.3462428689793
"1776","China",2001,38551820266,52035962896,"Japan",90587783162,24.6752009106407,24.3752691541549
"1777","China",2002,48154924648,55605006836,"Japan",103759931484,24.7415390851558,24.5976892471776
"1778","China",2003,66759534682,67894169218,"Japan",134653703900,24.9412159947457,24.9243629657038
"1779","China",2004,85090320808,84770040478,"Japan",169860361286,25.1632080210704,25.1669791270205
"1780","China",2005,90496104844,97479888133,"Japan",187975992977,25.3029119181135,25.2285726463282
"1781","China",2006,104436758682,106511281745,"Japan",210948040427,25.3915167483634,25.3718475450793
"1782","China",2007,117687564786,111930287142,"Japan",229617851928,25.4411420782155,25.4912991938554
"1783","China",2008,132715826829,125415029891,"Japan",258130856720,25.5548943135532,25.611476038912
"1784","China",2009,115277873416,107370090164,"Japan",222647963580,25.3995474901425,25.4706113413475
"1785","China",2010,155733269944,134260140871,"Japan",289993410815,25.6230451046967,25.7714105727546
"1786","China",2011,155979614069,178414356176,"Japan",334393970245,25.9073745256932,25.7729911566118
"1787","China",2012,138837242483,182128931081,"Japan",320966173564,25.9279806857505,25.6565681666292
"1788","China",2013,124539650058,175469908352,"Japan",300009558410,25.8907334027692,25.5478899765104
"1789","China",2014,121918493648,175984961987,"Japan",297903455635,25.8936643850784,25.5266185735591
"1790","China",2015,105945764521,155370429698,"Japan",261316194219,25.7690779716898,25.3861931446559
"1791","China",2016,110405310240,151422030443,"Japan",261827340683,25.7433366788765,25.4274240696326
"1792","China",2017,151030677117.5,163131595638,"Japan",314162272755.5,25.8178230472359,25.7407488128457
"1793","Ivory Coast",1962,0,0,"0",0,0,0
"1794","Ivory Coast",1963,0,0,"0",0,0,0
"1795","Ivory Coast",1964,0,0,"0",0,0,0
"1796","Ivory Coast",1965,0,0,"0",0,0,0
"1797","Ivory Coast",1966,0,0,"0",0,0,0
"1798","Ivory Coast",1967,0,0,"0",0,0,0
"1799","Ivory Coast",1968,0,0,"0",0,0,0
"1800","Ivory Coast",1969,0,0,"0",0,0,0
"1801","Ivory Coast",1970,0,0,"0",0,0,0
"1802","Ivory Coast",1971,0,0,"0",0,0,0
"1803","Ivory Coast",1972,0,0,"0",0,0,0
"1804","Ivory Coast",1973,0,0,"0",0,0,0
"1805","Ivory Coast",1974,0,0,"0",0,0,0
"1806","Ivory Coast",1975,0,0,"0",0,0,0
"1807","Ivory Coast",1976,0,0,"0",0,0,0
"1808","Ivory Coast",1977,0,0,"0",0,0,0
"1809","Ivory Coast",1978,0,0,"0",0,0,0
"1810","Ivory Coast",1979,0,0,"0",0,0,0
"1811","Ivory Coast",1980,0,0,"0",0,0,0
"1812","Ivory Coast",1981,0,0,"0",0,0,0
"1813","Ivory Coast",1982,0,0,"0",0,0,0
"1814","Ivory Coast",1983,0,0,"0",0,0,0
"1815","Ivory Coast",1984,0,0,"0",0,0,0
"1816","Ivory Coast",1985,0,0,"0",0,0,0
"1817","Ivory Coast",1986,0,0,"0",0,0,0
"1818","Ivory Coast",1987,0,0,"0",0,0,0
"1819","Ivory Coast",1988,0,0,"0",0,0,0
"1820","Ivory Coast",1989,0,0,"0",0,0,0
"1821","Ivory Coast",1990,0,0,"0",0,0,0
"1822","Ivory Coast",1991,0,0,"0",0,0,0
"1823","Ivory Coast",1992,0,0,"0",0,0,0
"1824","Ivory Coast",1993,0,0,"0",0,0,0
"1825","Ivory Coast",1994,0,0,"0",0,0,0
"1826","Ivory Coast",1995,0,0,"0",0,0,0
"1827","Ivory Coast",1996,0,0,"0",0,0,0
"1828","Ivory Coast",1997,0,0,"0",0,0,0
"1829","Ivory Coast",1998,0,0,"0",0,0,0
"1830","Ivory Coast",1999,0,0,"0",0,0,0
"1831","Ivory Coast",2000,0,0,"0",0,0,0
"1832","Ivory Coast",2001,0,0,"0",0,0,0
"1833","Ivory Coast",2002,0,0,"0",0,0,0
"1834","Ivory Coast",2003,0,0,"0",0,0,0
"1835","Ivory Coast",2004,0,0,"0",0,0,0
"1836","Ivory Coast",2005,0,0,"0",0,0,0
"1837","Ivory Coast",2006,0,0,"0",0,0,0
"1838","Ivory Coast",2007,0,0,"0",0,0,0
"1839","Ivory Coast",2008,0,0,"0",0,0,0
"1840","Ivory Coast",2009,0,0,"0",0,0,0
"1841","Ivory Coast",2010,0,0,"0",0,0,0
"1842","Ivory Coast",2011,0,0,"0",0,0,0
"1843","Ivory Coast",2012,0,0,"0",0,0,0
"1844","Ivory Coast",2013,0,0,"0",0,0,0
"1845","Ivory Coast",2014,0,0,"0",0,0,0
"1846","Ivory Coast",2015,0,0,"0",0,0,0
"1847","Ivory Coast",2016,0,0,"0",0,0,0
"1848","Ivory Coast",2017,0,0,"0",0,0,0
"1849","Cameroon",1962,3046000,464000,"Japan",3510000,13.0476398312084,14.9293398124372
"1850","Cameroon",1963,3166000,749000,"Japan",3915000,13.5264942624994,14.9679795194231
"1851","Cameroon",1964,6082000,1020000,"Japan",7102000,13.8353131852605,15.6208441472194
"1852","Cameroon",1965,3514000,1544000,"Japan",5058000,14.2498870095669,15.0722655477292
"1853","Cameroon",1966,3879000,2038000,"Japan",5917000,14.5274794927648,15.1710879464221
"1854","Cameroon",1967,4013000,1715000,"Japan",5728000,14.3549236385822,15.2050496492491
"1855","Cameroon",1968,4601000,1872000,"Japan",6473000,14.4425179360197,15.3417842291376
"1856","Cameroon",1969,4977000,3162000,"Japan",8139000,14.9667152967516,15.4203378578407
"1857","Cameroon",1970,5739000,6263000,"Japan",12002000,15.6501698615075,15.5627955370905
"1858","Cameroon",1971,6681000,9743000,"Japan",16424000,16.0920596364075,15.7147782349076
"1859","Cameroon",1972,7154000,9449000,"Japan",16603000,16.0614194737648,15.7831821988011
"1860","Cameroon",1973,6586000,16060000,"Japan",22646000,16.5918422664829,15.7004567419184
"1861","Cameroon",1974,9989000,16870000,"Japan",26859000,16.6410474545222,16.1169950455143
"1862","Cameroon",1975,23587000,14740000,"Japan",38327000,16.5060754447255,16.976206270766
"1863","Cameroon",1976,34394000,24758000,"Japan",59152000,17.0246592270739,17.3533926885263
"1864","Cameroon",1977,45325000,30498000,"Japan",75823000,17.2331716656571,17.6293693146052
"1865","Cameroon",1978,59850000,27722000,"Japan",87572000,17.1377368797554,17.9073519899683
"1866","Cameroon",1979,49724000,38392000,"Japan",88116000,17.4633596625202,17.7219982718937
"1867","Cameroon",1980,84867000,43833000,"Japan",128700000,17.5958975163223,18.2565958831415
"1868","Cameroon",1981,75966000,38798000,"Japan",114764000,17.4738792568732,18.1457964297304
"1869","Cameroon",1982,75689000,38214000,"Japan",113903000,17.4587124985816,18.1421433974132
"1870","Cameroon",1983,54182000,34978000,"Japan",89160000,17.3702298503913,17.8078593079303
"1871","Cameroon",1984,57628073,19877419,"Japan",77505492,16.8050949217903,17.869520385408
"1872","Cameroon",1985,69724826,15140853,"Japan",84865679,16.5329071452055,18.0600669959566
"1873","Cameroon",1986,124894017,36712899,"Japan",161606916,17.4186387226628,18.6429760716266
"1874","Cameroon",1987,83260742,14275268,"Japan",97536010,16.4740390874107,18.2374877115338
"1875","Cameroon",1988,45194765,16054095,"Japan",61248860,16.5914745151845,17.6264918195109
"1876","Cameroon",1989,50904832,18053905,"Japan",68958737,16.7088725628346,17.7454684082528
"1877","Cameroon",1990,40823974,8837792,"Japan",49661766,15.9945476296595,17.5247800648455
"1878","Cameroon",1991,42557019,7603681,"Japan",50160700,15.844143030106,17.5663553582514
"1879","Cameroon",1992,50725616,11775372,"Japan",62500988,16.2815207897244,17.7419415875157
"1880","Cameroon",1993,48913614,33909086,"Japan",82822700,17.3391935600376,17.7055663206056
"1881","Cameroon",1994,34031416,34080305,"Japan",68111721,17.3442302094159,17.3427946559552
"1882","Cameroon",1995,42868350,28761304,"Japan",71629654,17.1745414305403,17.57364434938
"1883","Cameroon",1996,31542090,27359218,"Japan",58901308,17.1245640684388,17.266833402364
"1884","Cameroon",1997,23845157,10317874,"Japan",34163031,16.1493882890432,16.9870916938823
"1885","Cameroon",1998,22253000,11012000,"Japan",33265000,16.2144961452446,16.9179873889483
"1886","Cameroon",1999,22710950,9581392,"Japan",32292342,16.0753334421056,16.938357744999
"1887","Cameroon",2000,21429199,4636855,"Japan",26066054,15.3495468926669,16.880264989243
"1888","Cameroon",2001,25291236,3881977,"Japan",29173213,15.1718551179125,17.0459684905243
"1889","Cameroon",2002,18633097,4213791,"Japan",22846888,15.2538732755335,16.7404499660136
"1890","Cameroon",2003,21583548,5989895,"Japan",27573443,15.6055844407226,16.8874419157723
"1891","Cameroon",2004,19830877,6414019,"Japan",26244896,15.6739966215009,16.8027507254384
"1892","Cameroon",2005,17910267,5462913,"Japan",23373180,15.5134927219353,16.7008846817985
"1893","Cameroon",2006,18404593,19675779,"Japan",38080372,16.7948989448766,16.7281108109947
"1894","Cameroon",2007,23646747,2200335,"Japan",25847082,14.6041201794635,16.978736115873
"1895","Cameroon",2008,41213425,2689068,"Japan",43902493,14.8047052231425,17.5342746107569
"1896","Cameroon",2009,25625384,5077825,"Japan",30703209,15.4403935782662,17.0590939806764
"1897","Cameroon",2010,34363704,4757171,"Japan",39120875,15.3751637217938,17.3525114490375
"1898","Cameroon",2011,33976257,3047844,"Japan",37024101,14.9299450133765,17.3411725151096
"1899","Cameroon",2012,27621226,4960772,"Japan",32581998,15.4170719317509,17.1340950930848
"1900","Cameroon",2013,28044900,30671400,"Japan",58716300,17.2388411822609,17.1493173552202
"1901","Cameroon",2014,32728578,4050681,"Japan",36779259,15.2143955730956,17.3037591991541
"1902","Cameroon",2015,26035633,5801206,"Japan",31836839,15.5735763849365,17.0749766577078
"1903","Cameroon",2016,27132837,4514674,"Japan",31647511,15.3228435384612,17.1162552497541
"1904","Cameroon",2017,69092135,3484264.5,"Japan",72576399.5,15.0637675325574,18.0509514617099
"1905","Democratic Republic of the Congo",1962,3461000,4554000,"Japan",8015000,15.3315165256058,15.0570681226175
"1906","Democratic Republic of the Congo",1963,1596000,5111000,"Japan",6707000,15.4469056377504,14.2830110569919
"1907","Democratic Republic of the Congo",1964,5135000,7351000,"Japan",12486000,15.8103469163562,15.4515904013448
"1908","Democratic Republic of the Congo",1965,7222000,3816000,"Japan",11038000,15.1547133115503,15.7926424808195
"1909","Democratic Republic of the Congo",1966,8007000,3887000,"Japan",11894000,15.1731482098344,15.8958267170548
"1910","Democratic Republic of the Congo",1967,5283000,8976000,"Japan",14259000,16.0100649067446,15.4800046761465
"1911","Democratic Republic of the Congo",1968,19991000,14162000,"Japan",34153000,16.4660728791939,16.8107927302379
"1912","Democratic Republic of the Congo",1969,38398000,33229000,"Japan",71627000,17.3189335465888,17.4635159328682
"1913","Democratic Republic of the Congo",1970,35918000,37610000,"Japan",73528000,17.4427805304465,17.3967491205608
"1914","Democratic Republic of the Congo",1971,64627000,26786000,"Japan",91413000,17.1033899209292,17.9841428380896
"1915","Democratic Republic of the Congo",1972,71904000,27128000,"Japan",99032000,17.1160769627876,18.0908424539672
"1916","Democratic Republic of the Congo",1973,57544000,81438000,"Japan",138982000,18.2153525525082,17.8680604305293
"1917","Democratic Republic of the Congo",1974,53751000,108752000,"Japan",162503000,18.5045806185686,17.7998728294501
"1918","Democratic Republic of the Congo",1975,56179000,59866000,"Japan",116045000,17.9076192892448,17.8440535795532
"1919","Democratic Republic of the Congo",1976,33388000,86688000,"Japan",120076000,18.277826023867,17.3237071119528
"1920","Democratic Republic of the Congo",1977,37008000,88795000,"Japan",125803000,18.3018409000708,17.4266446634534
"1921","Democratic Republic of the Congo",1978,23560000,83513000,"Japan",107073000,18.2405128663256,16.9750609167477
"1922","Democratic Republic of the Congo",1979,26079000,116195000,"Japan",142274000,18.5707803721964,17.0766409507293
"1923","Democratic Republic of the Congo",1980,45503000,134314000,"Japan",179817000,18.7156909002898,17.6332888158136
"1924","Democratic Republic of the Congo",1981,80063000,72121000,"Japan",152184000,18.0938558219825,18.1983243827227
"1925","Democratic Republic of the Congo",1982,51496000,60239000,"Japan",111735000,17.9138305410525,17.7570146927146
"1926","Democratic Republic of the Congo",1983,42924000,95128000,"Japan",138052000,18.3707339110996,17.5749416680292
"1927","Democratic Republic of the Congo",1984,40800639,76467175,"Japan",117267814,18.1523721217461,17.5242083010165
"1928","Democratic Republic of the Congo",1985,43562248,46452129,"Japan",90014377,17.6539328564041,17.5897014616763
"1929","Democratic Republic of the Congo",1986,47823631,50114608,"Japan",97938239,17.7298231004011,17.6830304476849
"1930","Democratic Republic of the Congo",1987,47319083,57387224,"Japan",104706307,17.8653322581183,17.6724242181885
"1931","Democratic Republic of the Congo",1988,61071754,65206148,"Japan",126277902,17.99306431693,17.9275600259265
"1932","Democratic Republic of the Congo",1989,67940465,49181896,"Japan",117122361,17.7110361462662,18.0341423649476
"1933","Democratic Republic of the Congo",1990,51698249,51292992,"Japan",102991241,17.7530646926221,17.7609344704332
"1934","Democratic Republic of the Congo",1991,38741917,88165615,"Japan",126907532,18.294727592357,17.4724326984566
"1935","Democratic Republic of the Congo",1992,18078470,74883264,"Japan",92961734,18.1314409789272,16.7102322854537
"1936","Democratic Republic of the Congo",1993,13073720,54452110,"Japan",67525830,17.8128321577403,16.3861146663735
"1937","Democratic Republic of the Congo",1994,39759811,72131029,"Japan",111890840,18.0939948702869,17.4983671862202
"1938","Democratic Republic of the Congo",1995,11209357,71954181,"Japan",83163538,18.0915400994078,16.2322594339028
"1939","Democratic Republic of the Congo",1996,14100701,74034825,"Japan",88135526,18.1200461485753,16.4617350704246
"1940","Democratic Republic of the Congo",1997,9595552,33892271,"Japan",43487823,17.3386975522558,16.0768102157327
"1941","Democratic Republic of the Congo",1998,8999000,37925000,"Japan",46924000,17.4511210831989,16.0126240180161
"1942","Democratic Republic of the Congo",1999,3242698,14048679,"Japan",17291377,16.4580389279714,14.9919162573022
"1943","Democratic Republic of the Congo",2000,9411287,16734439,"Japan",26145726,16.6329793695082,16.0574202716037
"1944","Democratic Republic of the Congo",2001,4926015,9218367,"Japan",14144382,16.0367084648786,15.410040902725
"1945","Democratic Republic of the Congo",2002,12294886,28124477,"Japan",40419363,17.1521508227604,16.3246939615276
"1946","Democratic Republic of the Congo",2003,6606625,12493933,"Japan",19100558,16.3407537244472,15.7035834914173
"1947","Democratic Republic of the Congo",2004,9777470,8436054,"Japan",18213524,15.9480252216983,16.0955913173381
"1948","Democratic Republic of the Congo",2005,16665321,2984407,"Japan",19649728,14.9089116251068,16.6288405314647
"1949","Democratic Republic of the Congo",2006,23555166,2083067,"Japan",25638233,14.5493518848722,16.9748557174275
"1950","Democratic Republic of the Congo",2007,20207739,2763240,"Japan",22970979,14.8319144622397,16.821576207812
"1951","Democratic Republic of the Congo",2008,38351211,22404864,"Japan",60756075,16.9247886361103,17.4622966628539
"1952","Democratic Republic of the Congo",2009,29379054,5095279,"Japan",34474333,15.4438249827079,17.1957925294169
"1953","Democratic Republic of the Congo",2010,31630406,757486,"Japan",32387892,13.5377603343467,17.2696294311147
"1954","Democratic Republic of the Congo",2011,66345324,1443233,"Japan",67788557,14.1823962938827,18.0103838415039
"1955","Democratic Republic of the Congo",2012,59654575,3983066,"Japan",63637641,15.1975624324508,17.9040814009686
"1956","Democratic Republic of the Congo",2013,48923174,1797939,"Japan",50721113,14.4021515668531,17.7057617481176
"1957","Democratic Republic of the Congo",2014,60531909,1144473,"Japan",61676382,13.9504548270087,17.9186812054508
"1958","Democratic Republic of the Congo",2015,59446368,1048992,"Japan",60495360,13.8633402610386,17.900585085879
"1959","Democratic Republic of the Congo",2016,41927242,10275516,"Japan",52202758,16.1452745360637,17.5514463406898
"1960","Democratic Republic of the Congo",2017,0,0,"0",0,0,0
"1961","Republic of the Congo",1962,392000,261000,"Japan",653000,12.4722756863048,12.8790171187726
"1962","Republic of the Congo",1963,380000,1336000,"Japan",1716000,14.1051906330787,12.8479265317026
"1963","Republic of the Congo",1964,444000,534000,"Japan",978000,13.1881511179423,13.0035798414144
"1964","Republic of the Congo",1965,707000,346000,"Japan",1053000,12.7541940540399,13.4687859448787
"1965","Republic of the Congo",1966,892000,146000,"Japan",1038000,11.8913619006905,13.7012214115621
"1966","Republic of the Congo",1967,983000,6869000,"Japan",7852000,15.742529093196,13.7983643991293
"1967","Republic of the Congo",1968,1443000,4543000,"Japan",5986000,15.3290981447415,14.182234837756
"1968","Republic of the Congo",1969,1678000,3164000,"Japan",4842000,14.9673476078697,14.3331131660093
"1969","Republic of the Congo",1970,978000,4129000,"Japan",5107000,15.2335458048682,13.793264949017
"1970","Republic of the Congo",1971,1473000,3013000,"Japan",4486000,14.9184468181124,14.2028116954448
"1971","Republic of the Congo",1972,1477000,5003000,"Japan",6480000,15.4255482904703,14.2055235615135
"1972","Republic of the Congo",1973,1446000,5693000,"Japan",7139000,15.5547479079332,14.1843116817008
"1973","Republic of the Congo",1974,2490000,6560000,"Japan",9050000,15.6965011609203,14.7277932684409
"1974","Republic of the Congo",1975,3110000,5923000,"Japan",9033000,15.5943536352591,14.9501332841554
"1975","Republic of the Congo",1976,4898000,5820000,"Japan",10718000,15.5768108197076,15.4043375164942
"1976","Republic of the Congo",1977,6185000,7983000,"Japan",14168000,15.8928248386279,15.6376375638087
"1977","Republic of the Congo",1978,5433000,8414000,"Japan",13847000,15.9454075431326,15.5080020255337
"1978","Republic of the Congo",1979,7199000,8158000,"Japan",15357000,15.9145095988596,15.7894526854514
"1979","Republic of the Congo",1980,17304000,14018000,"Japan",31322000,16.4558527760424,16.666448246615
"1980","Republic of the Congo",1981,24542000,17341000,"Japan",41883000,16.6685841977807,17.0158964935186
"1981","Republic of the Congo",1982,22975000,11429000,"Japan",34404000,16.2516645428797,16.949917226206
"1982","Republic of the Congo",1983,17146000,6300000,"Japan",23446000,15.6560601913618,16.6572754682208
"1983","Republic of the Congo",1984,23704460,7812196,"Japan",31516656,15.8711966602697,16.9811737740547
"1984","Republic of the Congo",1985,14719764,7343508,"Japan",22063272,15.8093272155742,16.5047016385278
"1985","Republic of the Congo",1986,18336987,4783334,"Japan",23120321,15.3806483508746,16.7244307255819
"1986","Republic of the Congo",1987,15304379,12421506,"Japan",27725885,16.3349398831573,16.543649554563
"1987","Republic of the Congo",1988,16259781,15598789,"Japan",31858570,16.5627038410014,16.6042051933585
"1988","Republic of the Congo",1989,14609337,9711217,"Japan",24320554,16.0887921671203,16.4971714028204
"1989","Republic of the Congo",1990,22855789,2425104,"Japan",25280893,14.7013849680321,16.9447149911385
"1990","Republic of the Congo",1991,20942350,1586748,"Japan",22529098,14.2771971967299,16.8572839825158
"1991","Republic of the Congo",1992,20320478,1418806,"Japan",21739284,14.1653262307985,16.8271397040199
"1992","Republic of the Congo",1993,17165348,3654883,"Japan",20820231,15.1115746397097,16.6584032584814
"1993","Republic of the Congo",1994,8316687,6765989,"Japan",15082676,15.7274190025455,15.9337745363805
"1994","Republic of the Congo",1995,8655706,13024559,"Japan",21680265,16.3823472870651,15.9737293146117
"1995","Republic of the Congo",1996,8297391,2904195,"Japan",11201586,14.8816668014328,15.9314516860031
"1996","Republic of the Congo",1997,5788834,3182994,"Japan",8971828,14.9733328212483,15.5714414475766
"1997","Republic of the Congo",1998,5190000,3513000,"Japan",8703000,15.071980931248,15.4622442551421
"1998","Republic of the Congo",1999,2313492,3304377,"Japan",5617869,15.0107585112298,14.6542686293591
"1999","Republic of the Congo",2000,5651549,18254437,"Japan",23905986,16.7199187317308,15.5474402248399
"2000","Republic of the Congo",2001,6518915,8095554,"Japan",14614469,15.9068255800591,15.690218509012
"2001","Republic of the Congo",2002,7116622,71583347,"Japan",78699969,18.0863730210802,15.7779437326045
"2002","Republic of the Congo",2003,8120346,10404035,"Japan",18524381,16.1577042696358,15.9098833220675
"2003","Republic of the Congo",2004,9476607,8180637,"Japan",17657244,15.9172805784076,16.0643368987732
"2004","Republic of the Congo",2005,6477585,1741263,"Japan",8218848,14.3701212699492,15.6838583136789
"2005","Republic of the Congo",2006,10094187,1383149,"Japan",11477336,14.1398733416478,16.1274702715677
"2006","Republic of the Congo",2007,8619395,4135219,"Japan",12754614,15.2350508475526,15.9695254545619
"2007","Republic of the Congo",2008,22880341,6084292,"Japan",28964633,15.6212209259499,16.945788628211
"2008","Republic of the Congo",2009,5912621,1447183,"Japan",7359804,14.1851294661728,15.5925997766892
"2009","Republic of the Congo",2010,11974859,3634167,"Japan",15609026,15.105890481753,16.2983199266617
"2010","Republic of the Congo",2011,11986689,936947,"Japan",12923636,13.7503819961203,16.2993073420792
"2011","Republic of the Congo",2012,20688553,1615529,"Japan",22304082,14.2951730151843,16.8450911101083
"2012","Republic of the Congo",2013,19758798,1600512,"Japan",21359310,14.2858341360209,16.7991094184743
"2013","Republic of the Congo",2014,16215163,1148774,"Japan",17363937,13.954205844708,16.6014573500936
"2014","Republic of the Congo",2015,10642222,1579763,"Japan",12221985,14.272785393752,16.1803398546613
"2015","Republic of the Congo",2016,13013918,691801,"Japan",13705719,13.4470536209886,16.3815299581105
"2016","Republic of the Congo",2017,2360634,473120,"Japan",2833754,13.0671043350863,14.6744407849912
"2017","Colombia",1962,17318000,2922000,"Japan",20240000,14.8877788712928,16.6672569809899
"2018","Colombia",1963,19237000,4269000,"Japan",23506000,15.2668901657401,16.7723460658883
"2019","Colombia",1964,26025000,4898000,"Japan",30923000,15.4043375164942,17.0745681724653
"2020","Colombia",1965,15906000,4405000,"Japan",20311000,15.2982508173524,16.5822069544992
"2021","Colombia",1966,27731000,8383000,"Japan",36114000,15.94171640362,17.1380614789684
"2022","Colombia",1967,21831000,9934000,"Japan",31765000,16.1114737746494,16.8988415359973
"2023","Colombia",1968,25801000,11027000,"Japan",36828000,16.2158573687408,17.0659238088306
"2024","Colombia",1969,43758000,15605000,"Japan",59363000,16.563101933687,17.5941850111944
"2025","Colombia",1970,59188000,26745000,"Japan",85933000,17.1018580979475,17.8962293766046
"2026","Colombia",1971,68528000,20648000,"Japan",89176000,16.8431290203806,18.0427529788373
"2027","Colombia",1972,72387000,41008000,"Japan",113395000,17.529277727586,18.0975372832224
"2028","Colombia",1973,89959000,56466000,"Japan",146425000,17.849149245069,18.314864568942
"2029","Colombia",1974,139867000,36066000,"Japan",175933000,17.4008611512494,18.7562025290376
"2030","Colombia",1975,138210000,35984000,"Japan",174194000,17.3985849531812,18.7442848255802
"2031","Colombia",1976,159758000,60713000,"Japan",220471000,17.9216684011386,18.8891707282153
"2032","Colombia",1977,211662000,122139000,"Japan",333801000,18.6206702983997,19.1705012207017
"2033","Colombia",1978,292274000,92938000,"Japan",385212000,18.3474431621298,19.493202276416
"2034","Colombia",1979,295461000,163999000,"Japan",459460000,18.9153708882089,19.5040474064049
"2035","Colombia",1980,461770000,173731000,"Japan",635501000,18.9730186839118,19.9505774895869
"2036","Colombia",1981,497644000,150211000,"Japan",647855000,18.8275515302985,20.0253955199173
"2037","Colombia",1982,607758000,141219000,"Japan",748977000,18.7658224348774,20.2252873343812
"2038","Colombia",1983,551423000,148989000,"Japan",700412000,18.8193830356811,20.1280127676899
"2039","Colombia",1984,393670598,137911093,"Japan",531581691,18.7421197818777,19.7910250718958
"2040","Colombia",1985,406803186,135475471,"Japan",542278657,18.7243011560666,19.8238400539664
"2041","Colombia",1986,332172549,241621291,"Japan",573793840,19.3028821451422,19.6211651177736
"2042","Colombia",1987,420452212,198669691,"Japan",619121903,19.1071541594,19.8568413852592
"2043","Colombia",1988,492020137,265018342,"Japan",757038479,19.3953095966496,20.0140302024808
"2044","Colombia",1989,429567248,260535299,"Japan",690102547,19.3782489147762,19.8782888598914
"2045","Colombia",1990,455693786,248027313,"Japan",703721099,19.3290494311296,19.937331619977
"2046","Colombia",1991,456345812,247311490,"Japan",703657302,19.3261591931996,19.9387614397184
"2047","Colombia",1992,524279747,203945318,"Japan",728225065,19.1333624668573,20.0775359681489
"2048","Colombia",1993,983809118,242388678,"Japan",1226197796,19.3060531031478,20.7069424504265
"2049","Colombia",1994,1029852451,352179124,"Japan",1382031575,19.6796504791294,20.7526813774702
"2050","Colombia",1995,1106184179,371404077,"Japan",1477588256,19.7328011842055,20.8241822533072
"2051","Colombia",1996,858091908,354794859,"Japan",1212886767,19.6870503184413,20.5702217705965
"2052","Colombia",1997,891409658,284952503,"Japan",1176362161,19.4678330682039,20.6083146530602
"2053","Colombia",1998,985916000,314180000,"Japan",1300096000,19.5654766280361,20.70908171624
"2054","Colombia",1999,473361712,243354070,"Japan",716715782,19.3100280189857,19.9753703730238
"2055","Colombia",2000,486993387,239313173,"Japan",726306560,19.2932835994203,20.0037611018992
"2056","Colombia",2001,499858261,177378527,"Japan",677236788,18.9937965776724,20.029835138199
"2057","Colombia",2002,556484932,205807564,"Japan",762292496,19.142452134819,20.1371506519431
"2058","Colombia",2003,578087364,203304535,"Japan",781391899,19.1302155852853,20.1752355640038
"2059","Colombia",2004,623555356,261239286,"Japan",884794642,19.380947349876,20.2509481018218
"2060","Colombia",2005,632772361,336264703,"Japan",969037064,19.6334092143184,20.2656212961566
"2061","Colombia",2006,848919318,326983997,"Japan",1175903315,19.6054217888261,20.5594747079577
"2062","Colombia",2007,1087475651,384972534,"Japan",1472448185,19.7686825494475,20.8071249307914
"2063","Colombia",2008,995810803,421522362,"Japan",1417333165,19.8593833873797,20.7190678406775
"2064","Colombia",2009,702289818,350674460,"Japan",1052964278,19.6753688866815,20.3698567229464
"2065","Colombia",2010,964293160,487753470,"Japan",1452046630,20.0053206517425,20.6869059142272
"2066","Colombia",2011,1447952053,700607504,"Japan",2148559557,20.3674583794896,21.0934160177926
"2067","Colombia",2012,1439035050,451947615,"Japan",1890982665,19.9290768350623,21.0872386217475
"2068","Colombia",2013,1173995561,440293103,"Japan",1614288664,19.9029512062835,20.8836787772549
"2069","Colombia",2014,1314187933,833541663,"Japan",2147729596,20.5411942445088,20.996484770374
"2070","Colombia",2015,929468365,970434996,"Japan",1899903361,20.6932549784228,20.6501233301195
"2071","Colombia",2016,920670095,645136746,"Japan",1565806841,20.2849728615916,20.6406123270094
"2072","Colombia",2017,1104432020,718920988.5,"Japan",1823353008.5,20.3932620188263,20.8225970307184
"2073","Costa Rica",1962,7999000,903000,"Japan",8902000,13.7134778323991,15.894827091831
"2074","Costa Rica",1963,7108000,1165000,"Japan",8273000,13.9682316449819,15.7767314682567
"2075","Costa Rica",1964,10312000,1125000,"Japan",11437000,13.9332935936207,16.1488188236012
"2076","Costa Rica",1965,16882000,1032000,"Japan",17914000,13.8470092250236,16.6417585235258
"2077","Costa Rica",1966,15778000,1358000,"Japan",17136000,14.1215235871008,16.5741271226372
"2078","Costa Rica",1967,16316000,1843000,"Japan",18159000,14.426905236652,16.6076567794196
"2079","Costa Rica",1968,14776000,2314000,"Japan",17090000,14.6544881867358,16.5085148008612
"2080","Costa Rica",1969,21913000,2355000,"Japan",24268000,14.6720512854327,16.9025906259775
"2081","Costa Rica",1970,28402000,16940000,"Japan",45342000,16.6451882471882,17.1619701231871
"2082","Costa Rica",1971,39132000,12692000,"Japan",51824000,16.3564824316852,17.4824511045595
"2083","Costa Rica",1972,39923000,7740000,"Japan",47663000,15.8619122455659,17.5024631568845
"2084","Costa Rica",1973,40970000,2797000,"Japan",43767000,14.8440579721841,17.5283506495231
"2085","Costa Rica",1974,71151000,9053000,"Japan",80204000,16.0186067524576,18.0803149372151
"2086","Costa Rica",1975,61148000,9089000,"Japan",70237000,16.0225754491009,17.9288077131031
"2087","Costa Rica",1976,88806000,10313000,"Japan",99119000,16.1489157932982,18.3019647732474
"2088","Costa Rica",1977,137087000,8452000,"Japan",145539000,15.9499136577181,18.7361263187384
"2089","Costa Rica",1978,135976000,11045000,"Japan",147021000,16.2174883948364,18.7279889575393
"2090","Costa Rica",1979,174002000,10990000,"Japan",184992000,16.2124963263798,18.9745773513656
"2091","Costa Rica",1980,172302000,13906000,"Japan",186208000,16.4478309596411,18.9647593090918
"2092","Costa Rica",1981,120538000,6791000,"Japan",127329000,15.7311087640959,18.6074756138789
"2093","Costa Rica",1982,38191000,10581000,"Japan",48772000,16.1745704978863,17.458110443724
"2094","Costa Rica",1983,44254000,7068000,"Japan",51322000,15.7710881124217,17.605456320813
"2095","Costa Rica",1984,72478808,5634156,"Japan",78112964,15.544357916066,18.0988047736476
"2096","Costa Rica",1985,85219291,5987171,"Japan",91206462,15.6051295713837,18.2607383863582
"2097","Costa Rica",1986,134682398,12296013,"Japan",146978411,16.3247856214544,18.7184299572664
"2098","Costa Rica",1987,145298429,13061428,"Japan",158359857,16.385174017336,18.7943003163692
"2099","Costa Rica",1988,98253859,16646020,"Japan",114899879,16.6276817067773,18.403065085296
"2100","Costa Rica",1989,138217985,19793445,"Japan",158011430,16.800861380246,18.7443425983126
"2101","Costa Rica",1990,200118867,20843788,"Japan",220962655,16.852566524167,19.1144220829652
"2102","Costa Rica",1991,121648381,24966999,"Japan",146615380,17.0330654708122,18.6166453184328
"2103","Costa Rica",1992,210187665,23258133,"Japan",233445798,16.9621654352812,19.1635113324778
"2104","Costa Rica",1993,226860140,17384855,"Japan",244244995,16.6711099828659,19.2398442622157
"2105","Costa Rica",1994,153016098,22557414,"Japan",175573512,16.9315743503643,18.8460536895082
"2106","Costa Rica",1995,113908828,34451308,"Japan",148360136,17.3550575227728,18.5509089319987
"2107","Costa Rica",1996,131566509,36833981,"Japan",168400490,17.4219313738098,18.6950230535857
"2108","Costa Rica",1997,348793875,40909895,"Japan",389703770,17.5268825232927,19.6699916896385
"2109","Costa Rica",1998,191299000,44236000,"Japan",235535000,17.6050494951774,19.0693482070053
"2110","Costa Rica",1999,270618627,73369239,"Japan",343987866,18.1110153185497,19.4162211072521
"2111","Costa Rica",2000,199961180,170786255,"Japan",370747435,18.9559233618416,19.1136338056725
"2112","Costa Rica",2001,210093390,151630636,"Japan",361724026,18.836958095189,19.1630627041114
"2113","Costa Rica",2002,418572028,120402569,"Japan",538974597,18.6063514278207,19.852359543001
"2114","Costa Rica",2003,281601653,185599112,"Japan",467200765,19.0390995938222,19.4560040522593
"2115","Costa Rica",2004,439272083,157834633,"Japan",597106716,18.8770584163129,19.900629558099
"2116","Costa Rica",2005,484619203,197762011,"Japan",682381214,19.1025749010735,19.9988739920577
"2117","Costa Rica",2006,531472536,245966626,"Japan",777439162,19.3207064180264,20.0911620817866
"2118","Costa Rica",2007,652482935,256361011,"Japan",908843946,19.3620972082655,20.2962955435624
"2119","Costa Rica",2008,736297200,306566937,"Japan",1042864137,19.5409466810137,20.4171443995339
"2120","Costa Rica",2009,460270976,294916571,"Japan",755187547,19.5022030641363,19.9473259522698
"2121","Costa Rica",2010,446305593,309321449,"Japan",755627042,19.5498915821633,19.9165144614502
"2122","Costa Rica",2011,845067923,238703630,"Japan",1083771553,19.2907332985667,20.5549275643395
"2123","Costa Rica",2012,947158449,291743836,"Japan",1238902285,19.4913867012299,20.6689769539443
"2124","Costa Rica",2013,791255272,339694448,"Japan",1130949720,19.6435570891645,20.4891311942757
"2125","Costa Rica",2014,483328179,259407652,"Japan",742735831,19.373911328255,19.996206440516
"2126","Costa Rica",2015,305435382,217105500,"Japan",522540882,19.1958939684751,19.5372487986551
"2127","Costa Rica",2016,320948989,303715638,"Japan",624664627,19.5316024202939,19.5867927556937
"2128","Costa Rica",2017,352973453,265673500.5,"Japan",618646953.5,19.3977786710931,19.6819034081036
"2129","Cuba",1962,10597000,35809000,"Japan",46406000,17.3937098164241,16.176081500157
"2130","Cuba",1963,2774000,22950000,"Japan",25724000,16.9488284944708,14.8358008798569
"2131","Cuba",1964,34395000,53448000,"Japan",87843000,17.7942197765875,17.3534217629423
"2132","Cuba",1965,3470000,29203000,"Japan",32673000,17.1897820016872,15.059665151923
"2133","Cuba",1966,6498000,22229000,"Japan",28727000,16.916908300673,15.6870049952112
"2134","Cuba",1967,7405000,26119000,"Japan",33524000,17.0781735768004,15.817666005684
"2135","Cuba",1968,2448000,33272000,"Japan",35720000,17.3202267604049,14.7107819226144
"2136","Cuba",1969,9796000,68044000,"Japan",77840000,18.0356651127116,16.0974846970542
"2137","Cuba",1970,39219000,110683000,"Japan",149902000,18.5221808176837,17.4846718812121
"2138","Cuba",1971,53851000,129039000,"Japan",182890000,18.6756252422162,17.8017315314964
"2139","Cuba",1972,50745000,145373000,"Japan",196118000,18.7948134111848,17.7423236488651
"2140","Cuba",1973,107172000,182492000,"Japan",289664000,19.0222168944096,18.489945578454
"2141","Cuba",1974,202969000,442064000,"Japan",645033000,19.9069652259401,19.1285638159852
"2142","Cuba",1975,438371000,340523000,"Japan",778894000,19.6459932289965,19.8985761417751
"2143","Cuba",1976,199544000,50296000,"Japan",249840000,17.733436109045,19.1115453213548
"2144","Cuba",1977,361375000,63086000,"Japan",424461000,17.9600094328471,19.7054267583008
"2145","Cuba",1978,211822000,106195000,"Japan",318017000,18.4807875846845,19.1712568573143
"2146","Cuba",1979,140654000,123795000,"Japan",264449000,18.634137529677,18.7618135318843
"2147","Cuba",1980,238735000,187412000,"Japan",426147000,19.04881995987,19.2908647081263
"2148","Cuba",1981,266830000,154250000,"Japan",421080000,18.8540852207498,19.4021223094625
"2149","Cuba",1982,125698000,114832000,"Japan",240530000,18.558980748652,18.6493927625349
"2150","Cuba",1983,104725000,92120000,"Japan",196845000,18.3386026329168,18.4668484247974
"2151","Cuba",1984,250297794,70273714,"Japan",320571508,18.0679083750519,19.3381619429393
"2152","Cuba",1985,300898808,81890448,"Japan",382789256,18.2208929119849,19.5222845801434
"2153","Cuba",1986,292681272,119691820,"Japan",412373092,18.6004308306826,19.4945947660141
"2154","Cuba",1987,113917195,104038330,"Japan",217955525,18.4602699468973,18.5509823827827
"2155","Cuba",1988,116665610,124231540,"Japan",240897150,18.6376576404746,18.5748223665958
"2156","Cuba",1989,54395304,120145555,"Japan",174540859,18.60421452404,17.8117883845707
"2157","Cuba",1990,71910231,87140362,"Japan",159050593,18.2830307328795,18.0909291074223
"2158","Cuba",1991,35725521,126724260,"Japan",162449781,18.6575241028896,17.3913758652988
"2159","Cuba",1992,17848424,103664661,"Japan",121513085,18.4566718340214,16.6974257709755
"2160","Cuba",1993,18191800,45724824,"Japan",63916624,17.6381519031359,16.7164815010686
"2161","Cuba",1994,23924298,56975982,"Japan",80900280,17.8581403685772,16.99040515318
"2162","Cuba",1995,18870379,80131829,"Japan",99002208,18.1991836989025,16.7531040019337
"2163","Cuba",1996,24003829,60167163,"Japan",84170992,17.9126372963426,16.9937239172535
"2164","Cuba",1997,22649497,34834822,"Japan",57484319,17.3661280766299,16.9356482021412
"2165","Cuba",1998,20284000,38765000,"Japan",59049000,17.4730283356352,16.825342955897
"2166","Cuba",1999,90141471,50688803,"Japan",140830274,17.7412155960446,18.3168908941529
"2167","Cuba",2000,76552254,34304268,"Japan",110856522,17.3507803358821,18.1534841244418
"2168","Cuba",2001,77594112,33214810,"Japan",110808922,17.318506418758,18.167002105986
"2169","Cuba",2002,62687428,25238779,"Japan",87926207,17.0438922188729,17.9536714751314
"2170","Cuba",2003,59277868,25234702,"Japan",84512570,17.0437306686913,17.8977465733931
"2171","Cuba",2004,143138726,23682956,"Japan",166821682,16.9802661912704,18.7793248298579
"2172","Cuba",2005,174154386,27997868,"Japan",202152254,17.1476389223833,18.9754527396443
"2173","Cuba",2006,146582772,16318548,"Japan",162901320,16.6078129329539,18.8031008234579
"2174","Cuba",2007,175936536,14877114,"Japan",190813650,16.5153346169453,18.9856338970648
"2175","Cuba",2008,64313290,13418795,"Japan",77732085,16.4121668941201,17.9792768552537
"2176","Cuba",2009,51850819,12328949,"Japan",64179768,16.3274606322536,17.7638812880792
"2177","Cuba",2010,30674490,11725024,"Japan",42399514,16.2772359192028,17.2389419225062
"2178","Cuba",2011,30724014,14429732,"Japan",45153746,16.484801358159,17.2405551217704
"2179","Cuba",2012,21807706,14935067,"Japan",36742773,16.5192224957287,16.8977739515363
"2180","Cuba",2013,30073198,15083049,"Japan",45156247,16.5290820884357,17.2191449011554
"2181","Cuba",2014,38803998,19006765,"Japan",57810763,16.7603055263906,17.4740338405222
"2182","Cuba",2015,34617227,19319578,"Japan",53936805,16.77662954386,17.3598620062952
"2183","Cuba",2016,43361915,16175404,"Japan",59537319,16.5990023748554,17.5850920792496
"2184","Cuba",2017,0,0,"0",0,0,0
"2185","Northern Cyprus",1962,0,0,"0",0,0,0
"2186","Northern Cyprus",1963,0,0,"0",0,0,0
"2187","Northern Cyprus",1964,0,0,"0",0,0,0
"2188","Northern Cyprus",1965,0,0,"0",0,0,0
"2189","Northern Cyprus",1966,0,0,"0",0,0,0
"2190","Northern Cyprus",1967,0,0,"0",0,0,0
"2191","Northern Cyprus",1968,0,0,"0",0,0,0
"2192","Northern Cyprus",1969,0,0,"0",0,0,0
"2193","Northern Cyprus",1970,0,0,"0",0,0,0
"2194","Northern Cyprus",1971,0,0,"0",0,0,0
"2195","Northern Cyprus",1972,0,0,"0",0,0,0
"2196","Northern Cyprus",1973,0,0,"0",0,0,0
"2197","Northern Cyprus",1974,0,0,"0",0,0,0
"2198","Northern Cyprus",1975,0,0,"0",0,0,0
"2199","Northern Cyprus",1976,0,0,"0",0,0,0
"2200","Northern Cyprus",1977,0,0,"0",0,0,0
"2201","Northern Cyprus",1978,0,0,"0",0,0,0
"2202","Northern Cyprus",1979,0,0,"0",0,0,0
"2203","Northern Cyprus",1980,0,0,"0",0,0,0
"2204","Northern Cyprus",1981,0,0,"0",0,0,0
"2205","Northern Cyprus",1982,0,0,"0",0,0,0
"2206","Northern Cyprus",1983,0,0,"0",0,0,0
"2207","Northern Cyprus",1984,0,0,"0",0,0,0
"2208","Northern Cyprus",1985,0,0,"0",0,0,0
"2209","Northern Cyprus",1986,0,0,"0",0,0,0
"2210","Northern Cyprus",1987,0,0,"0",0,0,0
"2211","Northern Cyprus",1988,0,0,"0",0,0,0
"2212","Northern Cyprus",1989,0,0,"0",0,0,0
"2213","Northern Cyprus",1990,0,0,"0",0,0,0
"2214","Northern Cyprus",1991,0,0,"0",0,0,0
"2215","Northern Cyprus",1992,0,0,"0",0,0,0
"2216","Northern Cyprus",1993,0,0,"0",0,0,0
"2217","Northern Cyprus",1994,0,0,"0",0,0,0
"2218","Northern Cyprus",1995,0,0,"0",0,0,0
"2219","Northern Cyprus",1996,0,0,"0",0,0,0
"2220","Northern Cyprus",1997,0,0,"0",0,0,0
"2221","Northern Cyprus",1998,0,0,"0",0,0,0
"2222","Northern Cyprus",1999,0,0,"0",0,0,0
"2223","Northern Cyprus",2000,0,0,"0",0,0,0
"2224","Northern Cyprus",2001,0,0,"0",0,0,0
"2225","Northern Cyprus",2002,0,0,"0",0,0,0
"2226","Northern Cyprus",2003,0,0,"0",0,0,0
"2227","Northern Cyprus",2004,0,0,"0",0,0,0
"2228","Northern Cyprus",2005,0,0,"0",0,0,0
"2229","Northern Cyprus",2006,0,0,"0",0,0,0
"2230","Northern Cyprus",2007,0,0,"0",0,0,0
"2231","Northern Cyprus",2008,0,0,"0",0,0,0
"2232","Northern Cyprus",2009,0,0,"0",0,0,0
"2233","Northern Cyprus",2010,0,0,"0",0,0,0
"2234","Northern Cyprus",2011,0,0,"0",0,0,0
"2235","Northern Cyprus",2012,0,0,"0",0,0,0
"2236","Northern Cyprus",2013,0,0,"0",0,0,0
"2237","Northern Cyprus",2014,0,0,"0",0,0,0
"2238","Northern Cyprus",2015,0,0,"0",0,0,0
"2239","Northern Cyprus",2016,0,0,"0",0,0,0
"2240","Northern Cyprus",2017,0,0,"0",0,0,0
"2241","Cyprus",1962,1180000,58000,"Japan",1238000,10.9681982895286,13.9810249964418
"2242","Cyprus",1963,2951000,122000,"Japan",3073000,11.7117763237154,14.8976546539251
"2243","Cyprus",1964,2205000,619000,"Japan",2824000,13.3358605516667,14.6062380668631
"2244","Cyprus",1965,3707000,23000,"Japan",3730000,10.0432494949113,15.1257334821329
"2245","Cyprus",1966,4709000,1981000,"Japan",6690000,14.4991123256807,15.3649861292257
"2246","Cyprus",1967,4899000,166000,"Japan",5065000,12.0197430673387,15.4045416606207
"2247","Cyprus",1968,4854000,4980000,"Japan",9834000,15.4209404490008,15.3953136652687
"2248","Cyprus",1969,6562000,170000,"Japan",6732000,12.0435537160324,15.6968059925032
"2249","Cyprus",1970,11258000,187000,"Japan",11445000,12.1388638958367,16.2365895450061
"2250","Cyprus",1971,13585000,399000,"Japan",13984000,12.896716695872,16.4244768008426
"2251","Cyprus",1972,18451000,268000,"Japan",18719000,12.498742259493,16.730629127524
"2252","Cyprus",1973,25040000,98000,"Japan",25138000,11.4927227576527,17.0359851041962
"2253","Cyprus",1974,13114000,719000,"Japan",13833000,13.4856166367032,16.3891909198057
"2254","Cyprus",1975,11985000,35000,"Japan",12020000,10.4631033404715,16.2991664258506
"2255","Cyprus",1976,19132000,62000,"Japan",19194000,11.0348896640272,16.7668728837823
"2256","Cyprus",1977,31292000,241000,"Japan",31533000,12.3925522124728,17.2588730317871
"2257","Cyprus",1978,41287000,11255000,"Japan",52542000,16.236323032323,17.536058238405
"2258","Cyprus",1979,51742000,6260000,"Japan",58002000,15.6496907430763,17.7617803887876
"2259","Cyprus",1980,84670000,6025000,"Japan",90695000,15.611428037341,18.2542719056185
"2260","Cyprus",1981,76377000,518000,"Japan",76895000,13.1577305212416,18.1511921616925
"2261","Cyprus",1982,109047000,798000,"Japan",109845000,13.5898638764319,18.5072895399171
"2262","Cyprus",1983,133372000,639000,"Japan",134011000,13.3676597333597,18.7086527743623
"2263","Cyprus",1984,116781555,385278,"Japan",117166833,12.8617204306192,18.5758156963673
"2264","Cyprus",1985,124765474,460568,"Japan",125226042,13.0402157893569,18.6419463249837
"2265","Cyprus",1986,108785918,1977917,"Japan",110763835,14.497554828707,18.5048924538623
"2266","Cyprus",1987,138082421,2201773,"Japan",140284194,14.6047735028491,18.7433613184597
"2267","Cyprus",1988,226620842,4959824,"Japan",231580666,15.4168808142006,19.2387888793806
"2268","Cyprus",1989,224004760,2993416,"Japan",226998176,14.9119257681554,19.2271778595935
"2269","Cyprus",1990,268250789,3666658,"Japan",271917447,15.1147911784554,19.4074328807569
"2270","Cyprus",1991,269493599,2383759,"Japan",271877358,14.6841892114534,19.4120551966398
"2271","Cyprus",1992,313778865,1884735,"Japan",315663600,14.4492977854271,19.5641990441785
"2272","Cyprus",1993,186295151,1683653,"Japan",187978804,14.3364763955446,19.0428428073211
"2273","Cyprus",1994,186328314,4549373,"Japan",190877687,15.3304999792337,19.0430208047003
"2274","Cyprus",1995,224789319,3088118,"Japan",227877437,14.943072401832,19.2306741615098
"2275","Cyprus",1996,215193635,4455635,"Japan",219649270,15.3096801452056,19.1870488086769
"2276","Cyprus",1997,249974062,3266449,"Japan",253240511,14.9992140200996,19.3368677184439
"2277","Cyprus",1998,328902000,2829000,"Japan",331731000,14.8554338502837,19.6112703920164
"2278","Cyprus",1999,222026910,2020899,"Japan",224047809,14.5190530198772,19.2183091487067
"2279","Cyprus",2000,202338374,2297611,"Japan",204635985,14.647380445429,19.1254519727307
"2280","Cyprus",2001,218160539,4273977,"Japan",222434516,15.268055333471,19.2007417671623
"2281","Cyprus",2002,252529661,2462925,"Japan",254992586,14.7168602259691,19.3470392690876
"2282","Cyprus",2003,236195062,3955303,"Japan",240150365,15.190567768133,19.2801685554971
"2283","Cyprus",2004,250349295,9727905,"Japan",260077200,16.0905091175154,19.3383676806787
"2284","Cyprus",2005,178438768,16413348,"Japan",194852116,16.6136054641945,18.999756063919
"2285","Cyprus",2006,160645511,22531439,"Japan",183176950,16.9304221807638,18.8947107004031
"2286","Cyprus",2007,231887192,17712871,"Japan",249600063,16.6898021084216,19.2617615699976
"2287","Cyprus",2008,278041628,21152838,"Japan",299194466,16.8672846388518,19.443281401452
"2288","Cyprus",2009,139230645,26196919,"Japan",165427564,17.0811523663966,18.751642432497
"2289","Cyprus",2010,85844394,1232962,"Japan",87077356,14.0249299625313,18.2680468432339
"2290","Cyprus",2011,276183859,1291677,"Japan",277475536,14.0714519320695,19.4365773576952
"2291","Cyprus",2012,212988912,460744,"Japan",213449656,13.0405978532009,19.1767506659807
"2292","Cyprus",2013,302083671,562150,"Japan",302645821,13.2395239971779,19.5262145932575
"2293","Cyprus",2014,261513816,2164144,"Japan",263677960,14.5875354601727,19.3819976737256
"2294","Cyprus",2015,266892855,1009410,"Japan",267902265,13.8248765597146,19.4023578436905
"2295","Cyprus",2016,187200274,668149,"Japan",187868423,13.4122664815382,19.0476895856819
"2296","Cyprus",2017,131043542.5,970515,"Japan",132014057.5,13.7855821374223,18.6910402114338
"2297","Czech Republic",1962,0,0,"0",0,0,0
"2298","Czech Republic",1963,0,0,"0",0,0,0
"2299","Czech Republic",1964,0,0,"0",0,0,0
"2300","Czech Republic",1965,0,0,"0",0,0,0
"2301","Czech Republic",1966,0,0,"0",0,0,0
"2302","Czech Republic",1967,0,0,"0",0,0,0
"2303","Czech Republic",1968,0,0,"0",0,0,0
"2304","Czech Republic",1969,0,0,"0",0,0,0
"2305","Czech Republic",1970,0,0,"0",0,0,0
"2306","Czech Republic",1971,0,0,"0",0,0,0
"2307","Czech Republic",1972,0,0,"0",0,0,0
"2308","Czech Republic",1973,0,0,"0",0,0,0
"2309","Czech Republic",1974,0,0,"0",0,0,0
"2310","Czech Republic",1975,0,0,"0",0,0,0
"2311","Czech Republic",1976,0,0,"0",0,0,0
"2312","Czech Republic",1977,0,0,"0",0,0,0
"2313","Czech Republic",1978,0,0,"0",0,0,0
"2314","Czech Republic",1979,0,0,"0",0,0,0
"2315","Czech Republic",1980,0,0,"0",0,0,0
"2316","Czech Republic",1981,0,0,"0",0,0,0
"2317","Czech Republic",1982,0,0,"0",0,0,0
"2318","Czech Republic",1983,0,0,"0",0,0,0
"2319","Czech Republic",1984,0,0,"0",0,0,0
"2320","Czech Republic",1985,0,0,"0",0,0,0
"2321","Czech Republic",1986,0,0,"0",0,0,0
"2322","Czech Republic",1987,0,0,"0",0,0,0
"2323","Czech Republic",1988,0,0,"0",0,0,0
"2324","Czech Republic",1989,0,0,"0",0,0,0
"2325","Czech Republic",1990,0,0,"0",0,0,0
"2326","Czech Republic",1991,0,0,"0",0,0,0
"2327","Czech Republic",1992,0,0,"0",0,0,0
"2328","Czech Republic",1993,203997883,98209600,"Japan",302207483,18.4026145282207,19.1336201743037
"2329","Czech Republic",1994,273357095,89437545,"Japan",362794640,18.3090511184255,19.4262895387028
"2330","Czech Republic",1995,396404541,143364920,"Japan",539769461,18.7809038257984,19.7979458159549
"2331","Czech Republic",1996,426006441,119503931,"Japan",545510372,18.5988598241923,19.8699650238377
"2332","Czech Republic",1997,526685447,88990972,"Japan",615676419,18.304045484349,20.0821140535422
"2333","Czech Republic",1998,589785000,89395000,"Japan",679180000,18.3085753101681,20.1952686216721
"2334","Czech Republic",1999,513950915,99051813,"Japan",613002728,18.4111536348282,20.0576383227504
"2335","Czech Republic",2000,553278469,144695571,"Japan",697974040,18.7901425829785,20.1313719933212
"2336","Czech Republic",2001,608757382,158379725,"Japan",767137107,18.8805060304147,20.2269303587763
"2337","Czech Republic",2002,842718600,165314449,"Japan",1008033049,18.9233599697395,20.5521436524107
"2338","Czech Republic",2003,1053051414,196018748,"Japan",1249070162,19.0937208656816,20.7749578951171
"2339","Czech Republic",2004,2036330027,253076611,"Japan",2289406638,19.3492028111307,21.4344150182746
"2340","Czech Republic",2005,2150919199,354800844,"Japan",2505720043,19.6870671872018,21.4891611221378
"2341","Czech Republic",2006,2519569373,383175299,"Japan",2902744672,19.7640031421712,21.6473538401373
"2342","Czech Republic",2007,3334480917,433514772,"Japan",3767995689,19.8874364297289,21.9275828571233
"2343","Czech Republic",2008,3733934106,475998952,"Japan",4209933058,19.9809262105126,22.0407282348829
"2344","Czech Republic",2009,2596368149,388290887,"Japan",2984659036,19.7772653254592,21.6773794396781
"2345","Czech Republic",2010,2323363592,496525921,"Japan",2819889513,20.0231462475389,21.5662817967823
"2346","Czech Republic",2011,1793656500,620630148,"Japan",2414286648,20.2462458875934,21.3075221106781
"2347","Czech Republic",2012,1601255697,724043848,"Japan",2325299545,20.400362512052,21.1940539690143
"2348","Czech Republic",2013,1418472748,785701417,"Japan",2204174165,20.4820874016318,21.0728466001851
"2349","Czech Republic",2014,1116165438,759087088,"Japan",1875252526,20.4476270692257,20.8331649318543
"2350","Czech Republic",2015,1054849236,669217684,"Japan",1724066920,20.3216199523106,20.7766636893972
"2351","Czech Republic",2016,1230805839,750960145,"Japan",1981765984,20.4368631390792,20.9309349454698
"2352","Czech Republic",2017,2200477067.5,903811322.5,"Japan",3104288390,20.622131182524,21.511940022666
"2353","Germany",1962,113730000,217598000,"Japan",331328000,19.1981598817274,18.5493377761606
"2354","Germany",1963,131016000,223022000,"Japan",354038000,19.2227809792669,18.6908300111118
"2355","Germany",1964,158943000,252773000,"Japan",411716000,19.3480024107356,18.8840562053454
"2356","Germany",1965,240600000,223981000,"Japan",464581000,19.2270717847932,19.2986463615049
"2357","Germany",1966,259382000,240468000,"Japan",499850000,19.2980975825243,19.3738124365369
"2358","Germany",1967,234270000,379164000,"Japan",613434000,19.7534793871295,19.271984854307
"2359","Germany",1968,292997000,431281000,"Japan",724278000,19.8822704077843,19.4956729280211
"2360","Germany",1969,416611000,476269000,"Japan",892880000,19.9814933786225,19.8476634906672
"2361","Germany",1970,573333000,655674000,"Japan",1229007000,20.3011742721677,20.1669772577081
"2362","Germany",1971,757452000,618538000,"Japan",1375990000,20.2428691868748,20.4454707270034
"2363","Germany",1972,1031707000,693166000,"Japan",1724873000,20.356780066709,20.7544805489657
"2364","Germany",1973,1392524000,1132619000,"Japan",2525143000,20.8477984870639,21.0543837648057
"2365","Germany",1974,1388360000,1499944000,"Japan",2888304000,21.1286936110243,21.0513890313957
"2366","Germany",1975,1785645000,1166389000,"Japan",2952034000,20.8771784884472,21.3030455314466
"2367","Germany",1976,2209243000,1240148000,"Japan",3449391000,20.9384965642798,21.5159157598613
"2368","Germany",1977,2834935000,1511628000,"Japan",4346563000,21.1364530526869,21.7652848461737
"2369","Germany",1978,3630300000,2011430000,"Japan",5641730000,21.422111748848,22.0125811264364
"2370","Germany",1979,4571066000,2605180000,"Japan",7176246000,21.6807676076533,22.2430122750454
"2371","Germany",1980,5828326000,2535443000,"Japan",8363769000,21.6536342121736,22.4859956605715
"2372","Germany",1981,5863821000,2430663000,"Japan",8294484000,21.6114298965911,22.4920672758261
"2373","Germany",1982,5360072000,2356736000,"Japan",7716808000,21.5805434478389,22.4022432447747
"2374","Germany",1983,6055467000,2426297000,"Japan",8481764000,21.6096320637179,22.5242273373192
"2375","Germany",1984,5820655926,2420382824,"Japan",8241038750,21.6071915563396,22.4846787944012
"2376","Germany",1985,6444135250,2638706461,"Japan",9082841711,21.6935546571328,22.5864362905573
"2377","Germany",1986,10051224654,3886312750,"Japan",13937537404,22.0807266658778,23.030960320147
"2378","Germany",1987,12774592729,5583491316,"Japan",18358084045,22.4430801015521,23.2707240922149
"2379","Germany",1988,14594664951,7376197123,"Japan",21970862074,22.7215240477623,23.4039218845656
"2380","Germany",1989,15491778164,8160813653,"Japan",23652591817,22.8226097133289,23.4635752791057
"2381","Germany",1990,18538311466,10481568056,"Japan",29019879522,23.0728841283109,23.6431053177477
"2382","Germany",1991,21602486152,9718751033,"Japan",31321237185,22.9973229526153,23.7960742446427
"2383","Germany",1992,22050390358,9722643125,"Japan",31773033483,22.9977233448938,23.8165961419932
"2384","Germany",1993,18379751784,8822190010,"Japan",27201941794,22.9005359765972,23.6345154491038
"2385","Germany",1994,18783787330,10057657745,"Japan",28841445075,23.0316001459804,23.6562599586583
"2386","Germany",1995,22052657510,12364300052,"Japan",34416957562,23.2380791291198,23.8166989535725
"2387","Germany",1996,20360842926,12731550080,"Japan",33092393006,23.2673490080102,23.7368794288523
"2388","Germany",1997,20793366647,9734198722,"Japan",30527565369,22.9989111633948,23.7578998615888
"2389","Germany",1998,23067419000,10502580000,"Japan",33569999000,23.0748867782128,23.861687025977
"2390","Germany",1999,20683359233,10490067310,"Japan",31173426543,23.0736946759213,23.752595312128
"2391","Germany",2000,21859333318,11552291559,"Japan",33411624877,23.1701496576115,23.8078938214255
"2392","Germany",2001,18261691619,11149704641,"Japan",29411396260,23.1346788449053,23.6280713485124
"2393","Germany",2002,16717711561,11198496191,"Japan",27916207752,23.1390453375719,23.5397345668744
"2394","Germany",2003,19226777589,12751443822,"Japan",31978221411,23.2689103430808,23.6795698104304
"2395","Germany",2004,23326605615,15335966912,"Japan",38662572527,23.4534666851496,23.8728604179666
"2396","Germany",2005,24017282597,15979753886,"Japan",39997036483,23.4945883757892,23.9020395163492
"2397","Germany",2006,26842196172,16612467016,"Japan",43454663188,23.533419275491,24.0132409702926
"2398","Germany",2007,25971617165,17338713290,"Japan",43310330455,23.5762076008165,23.9802701311868
"2399","Germany",2008,26463229541,18581732144,"Japan",45044961685,23.6454447922516,23.999022041889
"2400","Germany",2009,19743300467,14995177170,"Japan",34738477637,23.4309944643493,23.7060800538857
"2401","Germany",2010,23110301372,17253135616,"Japan",40363436988,23.5712597387453,23.8635443019092
"2402","Germany",2011,23094165143,23140889584,"Japan",46235054727,23.8648670015339,23.8628458313555
"2403","Germany",2012,20460485045,24498018004,"Japan",44958503049,23.9218580534288,23.7417613041781
"2404","Germany",2013,18680922363,23670751203,"Japan",42351673566,23.8875059964706,23.6507686455624
"2405","Germany",2014,18783804986,23946715539,"Japan",42730520525,23.8990970131527,23.6562608986174
"2406","Germany",2015,16020704759,20147147308,"Japan",36167852067,23.7263285425128,23.4971477700659
"2407","Germany",2016,17396994663,21874616801,"Japan",39271611464,23.8085927513681,23.5795633077317
"2408","Germany",2017,23292290675,23130247306,"Japan",46422537981,23.8644070051343,23.8713882704501
"2409","Djibouti",1962,315000,5000,"Japan",320000,8.51719319141624,12.6603279178078
"2410","Djibouti",1963,364000,7000,"Japan",371000,8.85366542803745,12.8049091466189
"2411","Djibouti",1964,624000,0,"Japan",624000,0,13.3439056473516
"2412","Djibouti",1965,1897000,5000,"Japan",1902000,8.51719319141624,14.4557842489172
"2413","Djibouti",1966,487000,0,"Japan",487000,0,13.0960194020647
"2414","Djibouti",1967,779000,1000,"Japan",780000,6.90775527898214,13.5657663248529
"2415","Djibouti",1968,1275000,0,"Japan",1275000,0,14.0584567365747
"2416","Djibouti",1969,1607000,0,"Japan",1607000,0,14.2898796447196
"2417","Djibouti",1970,2883000,55000,"Japan",2938000,10.9150884642146,14.8743419766205
"2418","Djibouti",1971,3502000,0,"Japan",3502000,0,15.0688447918279
"2419","Djibouti",1972,4696000,0,"Japan",4696000,0,15.3622216404901
"2420","Djibouti",1973,6694000,8000,"Japan",6702000,8.98719682066197,15.7167221607534
"2421","Djibouti",1974,7723000,29000,"Japan",7752000,10.2750511089686,15.8597134475514
"2422","Djibouti",1975,8680000,97000,"Japan",8777000,11.4824662574855,15.9765320866365
"2423","Djibouti",1976,13196000,3000,"Japan",13199000,8.00636756765025,16.3954243113306
"2424","Djibouti",1977,11635000,3000,"Japan",11638000,8.00636756765025,16.2695283547185
"2425","Djibouti",1978,17156000,3000,"Japan",17159000,8.00636756765025,16.6578585246189
"2426","Djibouti",1979,17228000,0,"Japan",17228000,0,16.6620465251561
"2427","Djibouti",1980,23826000,0,"Japan",23826000,0,16.9862879793414
"2428","Djibouti",1981,25546000,3000,"Japan",25549000,8.00636756765025,17.0559913065849
"2429","Djibouti",1982,25010000,1000,"Japan",25011000,6.90775527898214,17.0347863028538
"2430","Djibouti",1983,21160000,0,"Japan",21160000,0,16.8676231649544
"2431","Djibouti",1984,22086861,1412,"Japan",22088273,7.25276241805319,16.9104934648011
"2432","Djibouti",1985,20014823,0,"Japan",20014823,0,16.8119837070022
"2433","Djibouti",1986,20645609,43520,"Japan",20689129,10.6809758815298,16.8430132155352
"2434","Djibouti",1987,21557162,3764,"Japan",21560926,8.23323750070527,16.8862186626877
"2435","Djibouti",1988,20752873,0,"Japan",20752873,0,16.8481952528879
"2436","Djibouti",1989,18767210,41101,"Japan",18808311,10.6237877310886,16.7476217560653
"2437","Djibouti",1990,24787695,51100,"Japan",24838795,10.8415397761918,17.0258579186476
"2438","Djibouti",1991,24718058,71955,"Japan",24790013,11.1837962026043,17.0230446275972
"2439","Djibouti",1992,28743391,13862,"Japan",28757253,9.53690656247793,17.1739184205207
"2440","Djibouti",1993,22699756,59613,"Japan",22759369,10.9956289500739,16.9378647334952
"2441","Djibouti",1994,17738735,200091,"Japan",17938826,12.2065275420491,16.6912612245242
"2442","Djibouti",1995,19359070,160662,"Japan",19519732,11.9870580582996,16.7786716014688
"2443","Djibouti",1996,12079692,6298,"Japan",12085990,8.74798740166097,16.3070362534572
"2444","Djibouti",1997,18902533,0,"Japan",18902533,0,16.7548064922139
"2445","Djibouti",1998,17592000,0,"Japan",17592000,0,16.6829548112167
"2446","Djibouti",1999,23259169,21385,"Japan",23280554,9.97044502066101,16.9622099778474
"2447","Djibouti",2000,20142927,12424,"Japan",20155351,9.42738536482852,16.8183637673662
"2448","Djibouti",2001,11910713,0,"Japan",11910713,0,16.2929488051987
"2449","Djibouti",2002,15304581,15040,"Japan",15319621,9.61846859750383,16.5436627533126
"2450","Djibouti",2003,23720631,48105,"Japan",23768736,10.7811414007954,16.9818557337636
"2451","Djibouti",2004,30876972,3429,"Japan",30880401,8.14002395246292,17.2455212213181
"2452","Djibouti",2005,46745960,167747,"Japan",46913707,12.0302121709184,17.6602383928525
"2453","Djibouti",2006,44959737,0,"Japan",44959737,0,17.6212779138885
"2454","Djibouti",2007,73888859,130478,"Japan",74019337,11.7789599091578,18.1180726167725
"2455","Djibouti",2008,51758197,5128,"Japan",51763325,8.54247099860051,17.7620933737017
"2456","Djibouti",2009,94103260,3672348,"Japan",97775608,15.1163417974738,18.3599032479513
"2457","Djibouti",2010,36069426,6588665,"Japan",42658091,15.7008613062905,17.4009561392516
"2458","Djibouti",2011,61028544,1656076,"Japan",62684620,14.3199615065941,17.9268522471166
"2459","Djibouti",2012,43073013,5431490,"Japan",48504503,15.5077240557422,17.5784072104693
"2460","Djibouti",2013,11801325,90025,"Japan",11891350,11.4078426885171,16.2837223712676
"2461","Djibouti",2014,30449513,4981482,"Japan",35430995,15.4212379950911,17.2315805585604
"2462","Djibouti",2015,48188214,726488,"Japan",48914702,13.4959772443062,17.6906250262987
"2463","Djibouti",2016,30007079,321654,"Japan",30328733,12.6812317126393,17.2169438784573
"2464","Djibouti",2017,0,0,"0",0,0,0
"2465","Denmark",1962,25368000,9564000,"Japan",34932000,16.0735166075604,17.0489990952003
"2466","Denmark",1963,16649000,10534000,"Japan",27183000,16.1701186790255,16.627860712527
"2467","Denmark",1964,41102000,23047000,"Japan",64149000,16.9530461670926,17.531567340083
"2468","Denmark",1965,40909000,14562000,"Japan",55471000,16.4939259539368,17.5268606457056
"2469","Denmark",1966,55358000,16001000,"Japan",71359000,16.588161778251,17.8293317414535
"2470","Denmark",1967,49408000,21071000,"Japan",70479000,16.8634082454989,17.7156229123666
"2471","Denmark",1968,46992000,23921000,"Japan",70913000,16.9902672921929,17.6654879324205
"2472","Denmark",1969,57223000,27735000,"Japan",84958000,17.1382057114715,17.8624664734324
"2473","Denmark",1970,79151000,30099000,"Japan",109250000,17.2200025065759,18.1868679784503
"2474","Denmark",1971,81159000,35352000,"Japan",116511000,17.3808655257927,18.2119207515054
"2475","Denmark",1972,104410000,45565000,"Japan",149975000,17.6346504359124,18.4638360142663
"2476","Denmark",1973,204808000,77306000,"Japan",282114000,18.163282130209,19.1375835128667
"2477","Denmark",1974,257677000,115053000,"Japan",372730000,18.560903449725,19.3672174205723
"2478","Denmark",1975,215891000,146316000,"Japan",362207000,18.8012792243304,19.1902842086504
"2479","Denmark",1976,358849000,144740000,"Japan",503589000,18.7904495874023,19.6984122451568
"2480","Denmark",1977,412204000,166766000,"Japan",578970000,18.9321021901809,19.8370289304007
"2481","Denmark",1978,473732000,576243000,"Japan",1049975000,20.1720400046959,19.9761523189161
"2482","Denmark",1979,387764000,340002000,"Japan",727766000,19.6444620579101,19.7759074651074
"2483","Denmark",1980,439846000,320760000,"Japan",760606000,19.5862037379031,19.9019352236123
"2484","Denmark",1981,630548000,492691000,"Japan",1123239000,20.0153927606536,20.262099840527
"2485","Denmark",1982,519956000,266649000,"Japan",786605000,19.4014437447695,20.069254750575
"2486","Denmark",1983,585763000,373487000,"Japan",959250000,19.7383937560412,20.1884258288746
"2487","Denmark",1984,579775855,805213542,"Japan",1384989397,20.5066180697703,20.1781521299145
"2488","Denmark",1985,654314818,528764215,"Japan",1183079033,20.0860531721241,20.2990991666873
"2489","Denmark",1986,1163669322,717607557,"Japan",1881276879,20.3914333995899,20.8748440582663
"2490","Denmark",1987,1008314594,864977364,"Japan",1873291958,20.5782138957676,20.7315460551256
"2491","Denmark",1988,995322714,1038483482,"Japan",2033806196,20.7610272955208,20.7185775782158
"2492","Denmark",1989,914482872,1092630174,"Japan",2007113046,20.8118536302387,20.6338692962595
"2493","Denmark",1990,1168653054,1037148763,"Japan",2205801817,20.7597412110642,20.8791176866776
"2494","Denmark",1991,1101384122,1177894133,"Japan",2279278255,20.8869940480184,20.8198335184912
"2495","Denmark",1992,1243381986,1311873680,"Japan",2555255666,20.9947222423452,20.9411009119995
"2496","Denmark",1993,912938741,1415349740,"Japan",2328288481,21.0706425035788,20.6321793399226
"2497","Denmark",1994,1048992053,1484768591,"Japan",2533760644,21.1185247660817,20.7710955905454
"2498","Denmark",1995,1024475240,1741933146,"Japan",2766408386,21.2782613369135,20.7474463574644
"2499","Denmark",1996,864748448,1535285628,"Japan",2400034076,21.1519822775484,20.5779492110416
"2500","Denmark",1997,775596134,1295501522,"Japan",2071097656,20.9821637328017,20.4691424967922
"2501","Denmark",1998,841907000,1427508000,"Japan",2269415000,21.0791961036819,20.5511801148
"2502","Denmark",1999,759117347,1707229723,"Japan",2466347070,21.2581378487398,20.4476669307875
"2503","Denmark",2000,601102496,2038235845,"Japan",2639338341,21.4353504888002,20.2142760203881
"2504","Denmark",2001,547879297,1910976685,"Japan",2458855982,21.3708803017115,20.1215655597024
"2505","Denmark",2002,589567231,1963002537,"Japan",2552569768,21.3977410446495,20.1948993189367
"2506","Denmark",2003,468649473,2151977948,"Japan",2620627421,21.4896532319815,19.9653656546496
"2507","Denmark",2004,565186589,2630028052,"Japan",3195214641,21.6902603492389,20.1526664806092
"2508","Denmark",2005,661970896,2127547678,"Japan",2789518574,21.4782358285015,20.3107321491886
"2509","Denmark",2006,701624550,1894783238,"Japan",2596407788,21.3623702826585,20.3689089898582
"2510","Denmark",2007,636016438,1846410846,"Japan",2482427284,21.3365095083943,20.2707349668823
"2511","Denmark",2008,582982898,2202507458,"Japan",2785490356,21.512862301921,20.1836684094077
"2512","Denmark",2009,369328858,1987896433,"Japan",2357225291,21.4103428477473,19.7271980192015
"2513","Denmark",2010,348538930,2050798116,"Japan",2399337046,21.4414948792075,19.6692604892431
"2514","Denmark",2011,494980573,2409959565,"Japan",2904940138,21.6028758062999,20.0200290732982
"2515","Denmark",2012,402044662,2335173492,"Japan",2737218154,21.5713520259495,19.8120737399147
"2516","Denmark",2013,352872151,2032449732,"Japan",2385321883,21.4325076669771,19.6816163708249
"2517","Denmark",2014,434336723,2106755497,"Japan",2541092220,21.4684149218456,19.8893306506883
"2518","Denmark",2015,423906486,1829724133,"Japan",2253630619,21.3274310454417,19.8650234369843
"2519","Denmark",2016,416198239,2049981802,"Japan",2466180041,21.4410967529842,19.846672240776
"2520","Denmark",2017,435262396.5,1785677581,"Japan",2220939977.5,21.3030637773481,19.8914596175396
"2521","Dominican Republic",1962,11041000,1266000,"Japan",12307000,14.0513728816863,16.2171261744213
"2522","Dominican Republic",1963,9771000,251000,"Japan",10022000,12.4332082181139,16.0949293729265
"2523","Dominican Republic",1964,12089000,759000,"Japan",12848000,13.5397570563778,16.3078065061841
"2524","Dominican Republic",1965,5022000,173000,"Japan",5195000,12.0610468734799,15.4293388186997
"2525","Dominican Republic",1966,14200000,344000,"Japan",14544000,12.7483969363555,16.4687525225715
"2526","Dominican Republic",1967,11941000,180000,"Japan",12121000,12.1007121298723,16.2954884145155
"2527","Dominican Republic",1968,13053000,1661000,"Japan",14714000,14.3229303885954,16.3845285503709
"2528","Dominican Republic",1969,20713000,49000,"Japan",20762000,10.7995755770928,16.8462720804377
"2529","Dominican Republic",1970,33258000,6793000,"Japan",40051000,15.7314032281734,17.31980589763
"2530","Dominican Republic",1971,49527000,20163000,"Japan",69690000,16.8193597996202,17.7180285333781
"2531","Dominican Republic",1972,37806000,35762000,"Japan",73568000,17.3923964351173,17.4479783781522
"2532","Dominican Republic",1973,35435000,9696000,"Japan",45131000,16.0872239872912,17.3832105902265
"2533","Dominican Republic",1974,38067000,13046000,"Japan",51113000,16.3839921313382,17.4548583230472
"2534","Dominican Republic",1975,57039000,2795000,"Japan",59834000,14.8433426645713,17.8592458023598
"2535","Dominican Republic",1976,58248000,5178000,"Japan",63426000,15.4599294392936,17.8802203150567
"2536","Dominican Republic",1977,67483000,7344000,"Japan",74827000,15.8093942112825,18.0273862722709
"2537","Dominican Republic",1978,67248000,11680000,"Japan",78928000,16.2733885353644,18.023897836227
"2538","Dominican Republic",1979,69981000,18094000,"Japan",88075000,16.7110909495678,18.0637343345988
"2539","Dominican Republic",1980,113565000,20894000,"Japan",134459000,16.8549725943796,18.5478859181877
"2540","Dominican Republic",1981,82366000,10160000,"Japan",92526000,16.1339690001146,18.2266832883689
"2541","Dominican Republic",1982,64581000,11489000,"Japan",76070000,16.2569006138355,17.9834308078447
"2542","Dominican Republic",1983,65112000,15215000,"Japan",80327000,16.5377923413132,17.991619421989
"2543","Dominican Republic",1984,79556073,15553351,"Japan",95109424,16.5597866717654,18.1919726517575
"2544","Dominican Republic",1985,99031959,14211597,"Japan",113243556,16.4695688794024,18.4109531741861
"2545","Dominican Republic",1986,127074131,9644577,"Japan",136718708,16.0819063464395,18.6602811827926
"2546","Dominican Republic",1987,220456045,16748538,"Japan",237204583,16.6338215288438,19.2112088905762
"2547","Dominican Republic",1988,100721224,45151048,"Japan",145872272,17.6255240490751,18.4278671001285
"2548","Dominican Republic",1989,163862710,43745150,"Japan",207607860,17.5938913074799,18.9145395010497
"2549","Dominican Republic",1990,112936262,14732610,"Japan",127668872,16.505573962152,18.5423341644415
"2550","Dominican Republic",1991,103637524,19599320,"Japan",123236844,16.7910054297213,18.456410022983
"2551","Dominican Republic",1992,206676763,15968686,"Japan",222645449,16.5861402375324,19.1466665993678
"2552","Dominican Republic",1993,215890727,15686789,"Japan",231577516,16.56832945112,19.1902829441226
"2553","Dominican Republic",1994,180160947,17833565,"Japan",197994512,16.696592913768,19.0093611593405
"2554","Dominican Republic",1995,125417099,33415834,"Japan",158832933,17.3245404174667,18.6471555325294
"2555","Dominican Republic",1996,136945400,33378279,"Japan",170323679,17.3234159170498,18.7350928642082
"2556","Dominican Republic",1997,295134109,24068900,"Japan",319203009,16.9964311086734,19.5029404177814
"2557","Dominican Republic",1998,292514000,26146000,"Japan",318660000,17.0792067731039,19.4940230867386
"2558","Dominican Republic",1999,362106626,15658946,"Japan",377765572,16.5665529410256,19.7074492733809
"2559","Dominican Republic",2000,387273729,20973176,"Japan",408246905,16.8587548458688,19.7746423110457
"2560","Dominican Republic",2001,227811205,23822139,"Japan",251633344,16.9861259163484,19.2440277956518
"2561","Dominican Republic",2002,324810423,31763051,"Japan",356573474,17.2738142539611,19.5987522562541
"2562","Dominican Republic",2003,133194741,40423147,"Japan",173617888,17.5149131244053,18.7073228333091
"2563","Dominican Republic",2004,136850268,54655171,"Japan",191505439,17.8165543884217,18.7343979517976
"2564","Dominican Republic",2005,324940515,42874650,"Japan",367815165,17.5737913001518,19.5991526927726
"2565","Dominican Republic",2006,264492027,45897740,"Japan",310389767,17.6419264363458,19.393321665141
"2566","Dominican Republic",2007,347001194,78461418,"Japan",425462612,18.1781175714858,19.6648387788274
"2567","Dominican Republic",2008,303185317,64589252,"Japan",367774569,17.9835585772015,19.5298547837789
"2568","Dominican Republic",2009,153685049,41981546,"Japan",195666595,17.5527406987392,18.8504159298672
"2569","Dominican Republic",2010,288690315,63737730,"Japan",352428045,17.9702872528897,19.4808650971359
"2570","Dominican Republic",2011,160604506,99625550,"Japan",260230056,18.416929215762,18.8944554163685
"2571","Dominican Republic",2012,197400632,94148361,"Japan",291548993,18.360382404525,19.1007458865796
"2572","Dominican Republic",2013,168280114,94695979,"Japan",262976093,18.3661820968536,18.9411404941287
"2573","Dominican Republic",2014,213713105,73155715,"Japan",286868820,18.1081008095147,19.1801450426955
"2574","Dominican Republic",2015,238085500,79119005,"Japan",317204505,18.1864636693655,19.2881404108207
"2575","Dominican Republic",2016,272491778,88819200,"Japan",361310978,18.3021134008073,19.4231189991353
"2576","Dominican Republic",2017,324506369,59622083,"Japan",384128452,17.9035365835442,19.5978157210345
"2577","Algeria",1962,2133000,536000,"Japan",2669000,13.1918894400529,14.5730399974535
"2578","Algeria",1963,2349000,479000,"Japan",2828000,13.0794558763931,14.669500263641
"2579","Algeria",1964,6635000,84000,"Japan",6719000,11.3385720778255,15.7078692257484
"2580","Algeria",1965,15214000,52000,"Japan",15266000,10.8589989975636,16.5377266145394
"2581","Algeria",1966,15483000,606000,"Japan",16089000,13.3146352650515,16.555253205799
"2582","Algeria",1967,6070000,3103000,"Japan",9173000,14.9478799434305,15.6188691630357
"2583","Algeria",1968,9086000,1526000,"Japan",10612000,14.2381604908265,16.0222453253015
"2584","Algeria",1969,15816000,3957000,"Japan",19773000,15.1909967203676,16.5765326438326
"2585","Algeria",1970,20211000,4155000,"Japan",24366000,15.2398229862717,16.8217375686109
"2586","Algeria",1971,42398000,440000,"Japan",42838000,12.9945300058944,17.5626117492783
"2587","Algeria",1972,23295000,6e+05,"Japan",23895000,13.3046849341983,16.963749303233
"2588","Algeria",1973,50787000,5665000,"Japan",56452000,15.5498174524442,17.7431509742875
"2589","Algeria",1974,155082000,34080000,"Japan",189162000,17.3442212599254,18.8594645672534
"2590","Algeria",1975,220233000,36732000,"Japan",256965000,17.4191588677155,19.2101966347846
"2591","Algeria",1976,285367000,10248000,"Japan",295615000,16.1425931225587,19.4692866291318
"2592","Algeria",1977,435584000,24223000,"Japan",459807000,17.0028131529934,19.8921982174027
"2593","Algeria",1978,779737000,38337000,"Japan",818074000,17.4619260452589,20.4744672413029
"2594","Algeria",1979,427546000,57534000,"Japan",485080000,17.8678866353639,19.8735724428916
"2595","Algeria",1980,453800000,451466000,"Japan",905266000,19.9280106234454,19.93316713031
"2596","Algeria",1981,586949000,701412000,"Japan",1288361000,20.3686060041639,20.1904484915647
"2597","Algeria",1982,677209000,525081000,"Japan",1202290000,20.0790630943694,20.3334904981527
"2598","Algeria",1983,624211000,344576000,"Japan",968787000,19.6578252336664,20.2519990102025
"2599","Algeria",1984,785635978,77007091,"Japan",862643069,18.1594080664869,20.4820041107991
"2600","Algeria",1985,551690686,99280277,"Japan",650970963,18.4134574889454,20.1284980957365
"2601","Algeria",1986,390249474,116514676,"Japan",506764150,18.5735277972849,19.782296769505
"2602","Algeria",1987,201227401,141681700,"Japan",342909101,18.7690935502376,19.1199461747899
"2603","Algeria",1988,217755087,277201056,"Japan",494956143,19.4402536347966,19.1988815350773
"2604","Algeria",1989,296719034,143582955,"Japan",440301989,18.7824235097617,19.5082962355458
"2605","Algeria",1990,456999905,133487087,"Japan",590486992,18.7095153045345,19.940193740981
"2606","Algeria",1991,366863957,110270733,"Japan",477134690,18.518449109033,19.7205016479233
"2607","Algeria",1992,355192388,68076040,"Japan",423268428,18.0361358736751,19.6881701386725
"2608","Algeria",1993,353167776,77194438,"Japan",430362214,18.1618379657674,19.6824537881039
"2609","Algeria",1994,234064749,97342778,"Japan",331407527,18.3937491011035,19.2711083401744
"2610","Algeria",1995,341003839,80484045,"Japan",421487884,18.2035695239871,19.6474042932489
"2611","Algeria",1996,216493793,95818944,"Japan",312312737,18.3779709686948,19.1930724352499
"2612","Algeria",1997,185106643,73563462,"Japan",258670105,18.1136590202145,19.0364426656085
"2613","Algeria",1998,202766000,82451000,"Japan",285217000,18.2277147354591,19.127563162766
"2614","Algeria",1999,321789035,87488612,"Japan",409277647,18.2870191942864,19.589406717983
"2615","Algeria",2000,245117719,18180264,"Japan",263297983,16.7158471680603,19.317249138827
"2616","Algeria",2001,186399511,55269263,"Japan",241668774,17.827727489181,19.0434028368218
"2617","Algeria",2002,335431909,34516857,"Japan",369948766,17.3569583713669,19.6309295399778
"2618","Algeria",2003,344699104,53546071,"Japan",398245175,17.7960529814847,19.658182432122
"2619","Algeria",2004,591822233,107649854,"Japan",699472087,18.4943944255266,20.19871686566
"2620","Algeria",2005,712948820,41155806,"Japan",754104626,17.5328755686947,20.384920194596
"2621","Algeria",2006,640967140,114756944,"Japan",755724084,18.5583269192352,20.2784887499204
"2622","Algeria",2007,969068332,338725438,"Japan",1307793770,19.6407004197803,20.6918456854286
"2623","Algeria",2008,1268372743,879780126,"Japan",2148152869,20.5951825773989,20.9610006111197
"2624","Algeria",2009,1067333653,152606725,"Japan",1219940378,18.8433747453062,20.7884294623531
"2625","Algeria",2010,1404558671,418336963,"Japan",1822895634,19.8517977973184,21.062988977221
"2626","Algeria",2011,584965885,192936574,"Japan",777902459,19.0778720607334,20.1870640872564
"2627","Algeria",2012,617537763,248758228,"Japan",866295991,19.3319920108429,20.2412507792524
"2628","Algeria",2013,589663466,615835557,"Japan",1205499023,20.2384905329374,20.1950625355158
"2629","Algeria",2014,380674801,903219003,"Japan",1283893804,20.6214756102152,19.7574560279353
"2630","Algeria",2015,246278915,542978956,"Japan",789257871,20.1125811220828,19.3219752524429
"2631","Algeria",2016,220139076,237827029,"Japan",457966105,19.2870541985036,19.2097700682217
"2632","Algeria",2017,280281254.5,269114017.5,"Japan",549395272,19.4106457046415,19.4513041373379
"2633","Ecuador",1962,3776000,6207000,"Japan",9983000,15.6411882453958,15.1441758062475
"2634","Ecuador",1963,5950000,30893000,"Japan",36843000,17.2460401789877,15.5989017775218
"2635","Ecuador",1964,8104000,23376000,"Japan",31480000,16.9672204129726,15.9078683249107
"2636","Ecuador",1965,10345000,6224000,"Japan",16569000,15.6439233448404,16.1520138691618
"2637","Ecuador",1966,11788000,11986000,"Japan",23774000,16.2992498600003,16.2825926228397
"2638","Ecuador",1967,13976000,12918000,"Japan",26894000,16.3741322455746,16.452852130796
"2639","Ecuador",1968,16631000,41525000,"Japan",58156000,17.5418062134636,16.6267789816523
"2640","Ecuador",1969,20994000,44793000,"Japan",65787000,17.6175624351769,16.8597472405779
"2641","Ecuador",1970,24948000,84674000,"Japan",109622000,18.2543191467371,17.0323042166282
"2642","Ecuador",1971,51215000,64802000,"Japan",116017000,17.9868470250437,17.7515430158528
"2643","Ecuador",1972,39309000,71572000,"Japan",110881000,18.0862144939939,17.4869640582548
"2644","Ecuador",1973,54525000,46506000,"Japan",101031000,17.6550918944917,17.814169870052
"2645","Ecuador",1974,88534000,22174000,"Japan",110708000,16.9144309893144,18.2988972169906
"2646","Ecuador",1975,148693000,13490000,"Japan",162183000,16.4174592281839,18.8173943356754
"2647","Ecuador",1976,160172000,22078000,"Japan",182250000,16.9100921955604,18.8917587957994
"2648","Ecuador",1977,219183000,28915000,"Japan",248098000,17.1798710495745,19.2054175552861
"2649","Ecuador",1978,183893000,24839000,"Japan",208732000,17.0279255565702,19.0298646246848
"2650","Ecuador",1979,202340000,36240000,"Japan",238580000,17.4056740391391,19.125460008742
"2651","Ecuador",1980,307451000,255030000,"Japan",562481000,19.3568917432617,19.5438262829199
"2652","Ecuador",1981,294208000,408935000,"Japan",703143000,19.8290667771719,19.499797558148
"2653","Ecuador",1982,238339000,24068000,"Japan",262407000,16.9963937153224,19.2892045879313
"2654","Ecuador",1983,91769000,25931000,"Japan",117700000,17.0709497221395,18.3347851079286
"2655","Ecuador",1984,121664385,21030619,"Japan",142695004,16.8614899813874,18.6167768692782
"2656","Ecuador",1985,177521890,43189922,"Japan",220711812,17.5811177389616,18.9946044832196
"2657","Ecuador",1986,241089739,70163955,"Japan",311253694,18.0663452755911,19.3006797831416
"2658","Ecuador",1987,256056020,62850186,"Japan",318906206,17.9562644524234,19.3609068066295
"2659","Ecuador",1988,216555343,75437749,"Japan",291993092,18.1388183575622,19.1933566986061
"2660","Ecuador",1989,141397866,94209041,"Japan",235606907,18.3610267115866,18.7670882193751
"2661","Ecuador",1990,153511651,100823213,"Japan",254334864,18.4288791747878,18.8492870243912
"2662","Ecuador",1991,211765110,94447999,"Japan",306213109,18.3635599658748,19.1709882466838
"2663","Ecuador",1992,297783143,115833217,"Japan",413616360,18.567661929984,19.511876071508
"2664","Ecuador",1993,313323418,91856012,"Japan",405179430,18.3357328220288,19.5627464993787
"2665","Ecuador",1994,478720904,116612759,"Japan",595333663,18.5743692512801,19.9866283216775
"2666","Ecuador",1995,327365784,171867910,"Japan",499233694,18.9622367746252,19.6065887091931
"2667","Ecuador",1996,190381509,207232167,"Japan",397613676,19.1493503024392,19.0645405590088
"2668","Ecuador",1997,437228044,176324061,"Japan",613552105,18.9878341156509,19.8959654567658
"2669","Ecuador",1998,477818000,196634000,"Japan",674452000,19.0968546907046,19.9847404648128
"2670","Ecuador",1999,128495441,219119232,"Japan",347614673,19.2051265779841,18.6714039830709
"2671","Ecuador",2000,113463457,229859878,"Japan",343323335,19.2529804551469,18.5469913782862
"2672","Ecuador",2001,340595400,202238148,"Japan",542833548,19.1249565114441,19.6462058205233
"2673","Ecuador",2002,351344417,162139032,"Japan",513483449,18.9039647473568,19.6772775453382
"2674","Ecuador",2003,281884942,154821562,"Japan",436706504,18.8577837988257,19.4570095385526
"2675","Ecuador",2004,319077048,151984670,"Japan",471061718,18.8392902184612,19.5809431613661
"2676","Ecuador",2005,313433199,122589785,"Japan",436022984,18.6243542582561,19.5630968139925
"2677","Ecuador",2006,413926927,169179771,"Japan",583106698,18.9464724412513,19.8412000113799
"2678","Ecuador",2007,444171817,182099165,"Japan",626270982,19.0200619592947,19.9117220207661
"2679","Ecuador",2008,688691369,171383137,"Japan",860074506,18.9594121753906,20.3503037881291
"2680","Ecuador",2009,503892034,145429801,"Japan",649321835,18.795204060797,20.0378725848337
"2681","Ecuador",2010,621224729,258072026,"Japan",879296755,19.3687492744677,20.2472034568818
"2682","Ecuador",2011,659797826,556230301,"Japan",1216028127,20.1366929768851,20.3074440218155
"2683","Ecuador",2012,647359696,1200977624,"Japan",1848337320,20.90640174873,20.2884126423439
"2684","Ecuador",2013,520136187,1089333329,"Japan",1609469516,20.8088317212981,20.0696012333274
"2685","Ecuador",2014,535606315,1159453423,"Japan",1695059738,20.8712145439522,20.0989099622271
"2686","Ecuador",2015,423876789,775351241,"Japan",1199228030,20.4688266988406,19.8649533789851
"2687","Ecuador",2016,249882722,504703743,"Japan",754586465,20.0394821675699,19.3365022537591
"2688","Ecuador",2017,456131601.5,565713214,"Japan",1021844815.5,20.1535978187112,19.9382919256225
"2689","Egypt",1962,16437000,10644000,"Japan",27081000,16.1805069110797,16.6150454491887
"2690","Egypt",1963,24403000,16830000,"Japan",41233000,16.638673566167,17.0102166335253
"2691","Egypt",1964,17850000,21759000,"Japan",39609000,16.8955380230137,16.6975140661899
"2692","Egypt",1965,15117000,27980000,"Japan",43097000,17.1470005272016,16.5313304963308
"2693","Egypt",1966,26677000,17789000,"Japan",44466000,16.6940908467074,17.0993123289113
"2694","Egypt",1967,9039000,19119000,"Japan",28158000,16.7661931629645,16.0170591067805
"2695","Egypt",1968,10258000,27083000,"Japan",37341000,17.114416782738,16.1435684469314
"2696","Egypt",1969,5766000,40868000,"Japan",46634000,17.5258579186935,15.5674891571805
"2697","Egypt",1970,11850000,47342000,"Japan",59192000,17.6729084087285,16.2878384255454
"2698","Egypt",1971,11833000,39873000,"Japan",51706000,17.5012099610716,16.2864027963667
"2699","Egypt",1972,10950000,33203000,"Japan",44153000,17.3181507912502,16.2088500142268
"2700","Egypt",1973,13959000,47943000,"Japan",61902000,17.6855233632354,16.4516350194949
"2701","Egypt",1974,25519000,168344000,"Japan",193863000,18.9415200629006,17.0549338307201
"2702","Egypt",1975,129956000,12578000,"Japan",142534000,16.3474598140856,18.6827064895904
"2703","Egypt",1976,189255000,67880000,"Japan",257135000,18.0332519983303,19.0586058700121
"2704","Egypt",1977,248788000,78684000,"Japan",327472000,18.1809503890338,19.3321116861549
"2705","Egypt",1978,338527000,82829000,"Japan",421356000,18.2322887995811,19.6401144107989
"2706","Egypt",1979,186159000,94665000,"Japan",280824000,18.3658549016686,19.0421117052206
"2707","Egypt",1980,227524000,141772000,"Japan",369296000,18.7697306913513,19.2427662852966
"2708","Egypt",1981,383816000,207690000,"Japan",591506000,19.1515571413223,19.7656738290483
"2709","Egypt",1982,412009000,166569000,"Japan",578578000,18.9309201959532,19.8365557517354
"2710","Egypt",1983,851032000,257225000,"Japan",1108257000,19.3654617462261,20.5619602886509
"2711","Egypt",1984,807890761,230332478,"Japan",1038223239,19.2550343795982,20.5099374105633
"2712","Egypt",1985,374909776,495303804,"Japan",870213580,20.0206818777228,19.7421959576532
"2713","Egypt",1986,519887572,229966472,"Japan",749854044,19.2534440823484,20.0691231384712
"2714","Egypt",1987,509804394,200654150,"Japan",710458544,19.1170933372443,20.0495376689354
"2715","Egypt",1988,440174162,209875507,"Japan",650049669,19.1620250890827,19.9026810292867
"2716","Egypt",1989,333929473,104111520,"Japan",438040993,18.4609731902867,19.6264403699612
"2717","Egypt",1990,377389330,104042619,"Japan",481431949,18.4603111712383,19.748787918109
"2718","Egypt",1991,329771893,79267230,"Japan",409039123,18.18833536034,19.6139117400796
"2719","Egypt",1992,369730169,81663949,"Japan",451394118,18.2181232017362,19.7282840245807
"2720","Egypt",1993,442683151,90584852,"Japan",533268003,18.3217975605663,19.908364837344
"2721","Egypt",1994,410015589,71613764,"Japan",481629353,18.086797848093,19.831705738891
"2722","Egypt",1995,335284900,83023831,"Japan",418308731,18.2346382450316,19.6304911761247
"2723","Egypt",1996,389764708,62372719,"Japan",452137427,17.948638542229,19.781053802201
"2724","Egypt",1997,487550992,74423242,"Japan",561974234,18.1252788434921,20.0049054419064
"2725","Egypt",1998,1066864000,81490000,"Japan",1148354000,18.2159908712964,20.7879893409736
"2726","Egypt",1999,568804030,119759258,"Japan",688563288,18.6009941023317,20.1590465215196
"2727","Egypt",2000,514687167,140463077,"Japan",655150244,18.7604552150478,20.0590698313415
"2728","Egypt",2001,398741906,67770212,"Japan",466512118,18.0316333053352,19.8038249134247
"2729","Egypt",2002,328166164,62178452,"Japan",390344616,17.9455190668202,19.6090306356322
"2730","Egypt",2003,411476607,58441938,"Japan",469918545,17.8835443065146,19.8352627283488
"2731","Egypt",2004,410403028,51552123,"Japan",461955151,17.7581039508964,19.8326502299613
"2732","Egypt",2005,470187603,102940538,"Japan",573128141,18.4496620785207,19.9686423283462
"2733","Egypt",2006,527385408,355081783,"Japan",882467191,19.6878586955554,20.0834421636964
"2734","Egypt",2007,518250096,741940472,"Japan",1260190568,20.4247795714982,20.0659684945189
"2735","Egypt",2008,1733376079,1410954639,"Japan",3144330718,21.0675323611784,21.2733368345231
"2736","Egypt",2009,1313657664,272187883,"Japan",1585845547,19.4220031321284,20.9960811933847
"2737","Egypt",2010,1328043684,415932632,"Japan",1743976316,19.8460338628038,21.006972782038
"2738","Egypt",2011,1338219444,665357863,"Japan",2003577307,20.3158355937244,21.0146057941731
"2739","Egypt",2012,1749008884,1012773449,"Japan",2761782333,20.7359583935682,21.282315112444
"2740","Egypt",2013,1204962045,558732037,"Japan",1763694082,20.1411805548294,20.9097139054676
"2741","Egypt",2014,1417051468,118493713,"Japan",1535545181,18.5903704622797,21.071844118802
"2742","Egypt",2015,1279528054,73222250,"Japan",1352750304,18.1090098944932,20.969757139076
"2743","Egypt",2016,1140371925,82977033,"Japan",1223348958,18.234074416626,20.8546202961449
"2744","Egypt",2017,891078499,96684241,"Japan",987762740,18.3869609792007,20.6079430836868
"2745","Eritrea",1962,0,0,"0",0,0,0
"2746","Eritrea",1963,0,0,"0",0,0,0
"2747","Eritrea",1964,0,0,"0",0,0,0
"2748","Eritrea",1965,0,0,"0",0,0,0
"2749","Eritrea",1966,0,0,"0",0,0,0
"2750","Eritrea",1967,0,0,"0",0,0,0
"2751","Eritrea",1968,0,0,"0",0,0,0
"2752","Eritrea",1969,0,0,"0",0,0,0
"2753","Eritrea",1970,0,0,"0",0,0,0
"2754","Eritrea",1971,0,0,"0",0,0,0
"2755","Eritrea",1972,0,0,"0",0,0,0
"2756","Eritrea",1973,0,0,"0",0,0,0
"2757","Eritrea",1974,0,0,"0",0,0,0
"2758","Eritrea",1975,0,0,"0",0,0,0
"2759","Eritrea",1976,0,0,"0",0,0,0
"2760","Eritrea",1977,0,0,"0",0,0,0
"2761","Eritrea",1978,0,0,"0",0,0,0
"2762","Eritrea",1979,0,0,"0",0,0,0
"2763","Eritrea",1980,0,0,"0",0,0,0
"2764","Eritrea",1981,0,0,"0",0,0,0
"2765","Eritrea",1982,0,0,"0",0,0,0
"2766","Eritrea",1983,0,0,"0",0,0,0
"2767","Eritrea",1984,0,0,"0",0,0,0
"2768","Eritrea",1985,0,0,"0",0,0,0
"2769","Eritrea",1986,0,0,"0",0,0,0
"2770","Eritrea",1987,0,0,"0",0,0,0
"2771","Eritrea",1988,0,0,"0",0,0,0
"2772","Eritrea",1989,0,0,"0",0,0,0
"2773","Eritrea",1990,0,0,"0",0,0,0
"2774","Eritrea",1991,0,0,"0",0,0,0
"2775","Eritrea",1992,0,0,"0",0,0,0
"2776","Eritrea",1993,6574895,505702,"Japan",7080597,13.1337028419742,15.6987691663188
"2777","Eritrea",1994,12043422,1877237,"Japan",13920659,14.4453115729148,16.3040291767314
"2778","Eritrea",1995,22962639,610759,"Japan",23573398,13.3224577249918,16.949379061835
"2779","Eritrea",1996,28256152,285776,"Japan",28541928,12.5629635661443,17.1568217617598
"2780","Eritrea",1997,15289258,1899606,"Japan",17188864,14.4571570542118,16.5426610482777
"2781","Eritrea",1998,0,0,"0",0,0,0
"2782","Eritrea",1999,7087751,5364,"Japan",7093115,8.58746524440157,15.7738786408531
"2783","Eritrea",2000,3051384,60483,"Japan",3111867,11.0101176127978,14.9311058161527
"2784","Eritrea",2001,5694103,14520,"Japan",5708623,9.58328228837879,15.5549416358732
"2785","Eritrea",2002,6724017,152205,"Japan",6876222,11.9329835753813,15.7211963017644
"2786","Eritrea",2003,5010816,25786,"Japan",5036602,10.1575869879708,15.42710933405
"2787","Eritrea",2004,4963366,733456,"Japan",5696822,13.5055228883992,15.4175946975688
"2788","Eritrea",2005,3708133,103947,"Japan",3812080,11.5516364328408,15.1260390734173
"2789","Eritrea",2006,2098186,21449,"Japan",2119635,9.97343330322279,14.5565837198714
"2790","Eritrea",2007,3314921,3119,"Japan",3318040,8.0452677166078,15.0139443502472
"2791","Eritrea",2008,3477915,50821,"Japan",3528736,10.836064933973,15.0619435342648
"2792","Eritrea",2009,1160952,292057,"Japan",1453009,12.5847042676798,13.9647509161561
"2793","Eritrea",2010,1728177,9139,"Japan",1737316,9.1203062492722,14.362577653656
"2794","Eritrea",2011,918524,182012,"Japan",1100536,12.1118278979513,13.730523312855
"2795","Eritrea",2012,1243621,16219,"Japan",1259840,9.69393867348769,14.0335378434828
"2796","Eritrea",2013,693745,0,"Japan",693745,0,13.4498597368096
"2797","Eritrea",2014,603360,0,"Japan",603360,0,13.3102693124922
"2798","Eritrea",2015,850928,27965,"Japan",878893,10.2387090072557,13.6540827976307
"2799","Eritrea",2016,1170215,22494,"Japan",1192709,10.021003885964,13.9726980505758
"2800","Eritrea",2017,0,0,"0",0,0,0
"2801","Spain",1962,13534000,8264000,"Japan",21798000,15.9274192897816,16.4207155957743
"2802","Spain",1963,25675000,4064000,"Japan",29739000,15.2176782682405,17.0610283137789
"2803","Spain",1964,19986000,19778000,"Japan",39764000,16.8000807668121,16.8105425864039
"2804","Spain",1965,31861000,20461000,"Japan",52322000,16.8340311931487,17.2768932492731
"2805","Spain",1966,35130000,24456000,"Japan",59586000,17.0123861425528,17.374566024242
"2806","Spain",1967,34042000,22104000,"Japan",56146000,16.9112691455854,17.3431056143501
"2807","Spain",1968,41683000,23986000,"Japan",65669000,16.9929808847738,17.5456039297865
"2808","Spain",1969,89840000,19556000,"Japan",109396000,16.7887927026807,18.3135408683945
"2809","Spain",1970,146040000,32678000,"Japan",178718000,17.3022126265729,18.7993911147517
"2810","Spain",1971,110987000,56847000,"Japan",167834000,17.8558740063199,18.5249236353007
"2811","Spain",1972,175677000,55627000,"Japan",231304000,17.8341792528605,18.9841576396369
"2812","Spain",1973,248806000,85194000,"Japan",3.34e+08,18.2604415667846,19.3321840342941
"2813","Spain",1974,347682000,133705000,"Japan",481387000,18.7111464385307,19.6667988268719
"2814","Spain",1975,384709000,118150000,"Japan",502859000,18.5874655615972,19.767997762302
"2815","Spain",1976,672986000,164480000,"Japan",837466000,18.9182995402311,20.3272350850152
"2816","Spain",1977,566393000,157075000,"Japan",723468000,18.8722339562533,20.1547987415104
"2817","Spain",1978,524027000,252397000,"Japan",776424000,19.3465138026653,20.0770537676754
"2818","Spain",1979,595872000,376758000,"Japan",972630000,19.7471136294856,20.2055364368636
"2819","Spain",1980,842770000,389418000,"Japan",1232188000,19.7801638747955,20.5522046436272
"2820","Spain",1981,861145000,456797000,"Japan",1317942000,19.9397496488589,20.5737734570398
"2821","Spain",1982,1008618000,368332000,"Japan",1376950000,19.724495263332,20.7318469139676
"2822","Spain",1983,981765000,396160000,"Japan",1377925000,19.7973287280204,20.7048625301445
"2823","Spain",1984,798769146,378923999,"Japan",1177693145,19.7528462125948,20.4985825333218
"2824","Spain",1985,927605862,317245619,"Japan",1244851481,19.5751868551648,20.64811748286
"2825","Spain",1986,1574913646,344629505,"Japan",1919543151,19.6579804994027,21.1774662797844
"2826","Spain",1987,1991992407,413224403,"Japan",2405216810,19.8395013520331,21.4124011843546
"2827","Spain",1988,2802619692,574058784,"Japan",3376678476,20.16824236019,21.7538204210084
"2828","Spain",1989,3080286686,627021312,"Japan",3707307998,20.2564910884502,21.8482885094704
"2829","Spain",1990,3513215882,851072785,"Japan",4364288667,20.5620082116699,21.9797976606619
"2830","Spain",1991,3924064177,733682139,"Japan",4657746316,20.4135864396507,22.0903937335107
"2831","Spain",1992,4196380210,696735335,"Japan",4893115545,20.3619161763833,22.1574881358635
"2832","Spain",1993,3077024729,664455986,"Japan",3741480715,20.314479197656,21.8472289699781
"2833","Spain",1994,2966969789,1036172926,"Japan",4003142715,20.758799883843,21.8108069958642
"2834","Spain",1995,3408176611,1365273158,"Japan",4773449769,21.0346203613138,21.9494432670473
"2835","Spain",1996,3094075538,1407556787,"Japan",4501632325,21.0651212631678,21.8527550031496
"2836","Spain",1997,3636901597,1066842197,"Japan",4703743794,20.787968904233,22.0143979464951
"2837","Spain",1998,4035629000,1164250000,"Japan",5199879000,20.8753429398268,22.1184280125169
"2838","Spain",1999,4212484137,1260668111,"Japan",5473152248,20.954907664204,22.1613183669205
"2839","Spain",2000,3967191209,1225285764,"Japan",5192476973,20.926439930473,22.1013241772162
"2840","Spain",2001,3491112233,1164751751,"Japan",4655863984,20.8757738119869,21.9734862137934
"2841","Spain",2002,3611266453,1027781345,"Japan",4639047798,20.7506682819393,22.0073243657745
"2842","Spain",2003,4893664624,1253719598,"Japan",6147384222,20.949380648093,22.3112072716253
"2843","Spain",2004,6414167052,1572021375,"Japan",7986188427,21.1756281281892,22.58177498278
"2844","Spain",2005,6602818248,1582726140,"Japan",8185544388,21.1824146022472,22.6107624021099
"2845","Spain",2006,6680984644,1765739574,"Japan",8446724218,21.2918354616627,22.6225312154288
"2846","Spain",2007,7341401561,1822645058,"Japan",9164046619,21.3235546115467,22.7167956097096
"2847","Spain",2008,6660836509,2247922255,"Japan",8908758764,21.5332721843051,22.6195109155634
"2848","Spain",2009,3853357206,2108734979,"Japan",5962092185,21.4693540686218,22.0722106068321
"2849","Spain",2010,4068784875,2397397933,"Japan",6466182808,21.5976497915529,22.126610235313
"2850","Spain",2011,3139634347,3388634548,"Japan",6528268895,21.9436928889972,21.8673721800857
"2851","Spain",2012,2410594015,3776776419,"Japan",6187370434,22.0521366835314,21.6031390333311
"2852","Spain",2013,2068079156,3530256666,"Japan",5598335822,21.9846364151634,21.4498860694558
"2853","Spain",2014,2287428431,3985509051,"Japan",6272937482,22.105930882812,21.55069406763
"2854","Spain",2015,2361965692,3552269011,"Japan",5914234703,21.9908523942874,21.5827600296373
"2855","Spain",2016,2822495617,3645358837,"Japan",6467854454,22.0167206439264,21.7608873011082
"2856","Spain",2017,3714428458,3157313497.5,"Japan",6871741955.5,21.8729873439361,22.0354906561741
"2857","Estonia",1962,0,0,"0",0,0,0
"2858","Estonia",1963,0,0,"0",0,0,0
"2859","Estonia",1964,0,0,"0",0,0,0
"2860","Estonia",1965,0,0,"0",0,0,0
"2861","Estonia",1966,0,0,"0",0,0,0
"2862","Estonia",1967,0,0,"0",0,0,0
"2863","Estonia",1968,0,0,"0",0,0,0
"2864","Estonia",1969,0,0,"0",0,0,0
"2865","Estonia",1970,0,0,"0",0,0,0
"2866","Estonia",1971,0,0,"0",0,0,0
"2867","Estonia",1972,0,0,"0",0,0,0
"2868","Estonia",1973,0,0,"0",0,0,0
"2869","Estonia",1974,0,0,"0",0,0,0
"2870","Estonia",1975,0,0,"0",0,0,0
"2871","Estonia",1976,0,0,"0",0,0,0
"2872","Estonia",1977,0,0,"0",0,0,0
"2873","Estonia",1978,0,0,"0",0,0,0
"2874","Estonia",1979,0,0,"0",0,0,0
"2875","Estonia",1980,0,0,"0",0,0,0
"2876","Estonia",1981,0,0,"0",0,0,0
"2877","Estonia",1982,0,0,"0",0,0,0
"2878","Estonia",1983,0,0,"0",0,0,0
"2879","Estonia",1984,0,0,"0",0,0,0
"2880","Estonia",1985,0,0,"0",0,0,0
"2881","Estonia",1986,0,0,"0",0,0,0
"2882","Estonia",1987,0,0,"0",0,0,0
"2883","Estonia",1988,0,0,"0",0,0,0
"2884","Estonia",1989,0,0,"0",0,0,0
"2885","Estonia",1990,0,0,"0",0,0,0
"2886","Estonia",1991,0,0,"0",0,0,0
"2887","Estonia",1992,2020290,5855641,"Japan",7875931,15.5829160280993,14.5187516234294
"2888","Estonia",1993,6576418,6375886,"Japan",12952304,15.668033619744,15.6990007781749
"2889","Estonia",1994,5409840,14891447,"Japan",20301287,16.5162975792536,15.503730075524
"2890","Estonia",1995,42830723,12817908,"Japan",55648631,16.3663538136138,17.5727662301402
"2891","Estonia",1996,58712489,16754734,"Japan",75467223,16.6341914031696,17.8881630219637
"2892","Estonia",1997,214288640,8675622,"Japan",222964262,15.976027581515,19.1828344492394
"2893","Estonia",1998,19879000,7328000,"Japan",27207000,15.8072131853361,16.8051744561167
"2894","Estonia",1999,174964176,9174802,"Japan",184138978,16.0319713712906,18.9800918023607
"2895","Estonia",2000,251173999,20976207,"Japan",272150206,16.858899353358,19.3416564800355
"2896","Estonia",2001,202215609,35649847,"Japan",237865456,17.3892554130903,19.1248450574169
"2897","Estonia",2002,203143335,17442549,"Japan",220585884,16.6744231240219,19.1294223715901
"2898","Estonia",2003,296707253,23157221,"Japan",319864474,16.9578172121051,19.5082565305302
"2899","Estonia",2004,333657558,20715929,"Japan",354373487,16.8464134792175,19.6256257495375
"2900","Estonia",2005,442248914,25573620,"Japan",467822534,17.0570719094018,19.9073834353765
"2901","Estonia",2006,538858608,54828469,"Japan",593687077,17.8197201243203,20.1049637716406
"2902","Estonia",2007,549232462,71969192,"Japan",621201654,18.0917486965209,20.1240323379044
"2903","Estonia",2008,467892129,59288589,"Japan",527180718,17.8979274171207,19.9637483337244
"2904","Estonia",2009,241455633,63781442,"Japan",305237075,17.9709728282589,19.3021962998937
"2905","Estonia",2010,241025994,63118287,"Japan",304144281,17.9605210953504,19.3004153445597
"2906","Estonia",2011,129693927,123199090,"Japan",252893017,18.6293122226728,18.6806878247517
"2907","Estonia",2012,203358132,177968913,"Japan",381327045,18.9971194469365,19.1304791796827
"2908","Estonia",2013,289232989,106368912,"Japan",395601901,18.4824239117277,19.4827431115913
"2909","Estonia",2014,113853441,92857464,"Japan",206710905,18.3465762302542,18.5504225739962
"2910","Estonia",2015,95593792,86501504,"Japan",182095296,18.2756723590342,18.3756184386746
"2911","Estonia",2016,118518183,94407845,"Japan",212926028,18.3631347314764,18.5905769498063
"2912","Estonia",2017,195514374.5,107739740.5,"Japan",303254115,18.4952290666376,19.0911444615409
"2913","Ethiopia",1962,14166000,4328000,"Japan",18494000,15.2806160995085,16.4663552852957
"2914","Ethiopia",1963,14135000,5489000,"Japan",19624000,15.518256647532,16.4641645491098
"2915","Ethiopia",1964,17926000,4292000,"Japan",22218000,15.2722633827327,16.7017627308994
"2916","Ethiopia",1965,21491000,4309000,"Japan",25800000,15.276216416598,16.8831448008073
"2917","Ethiopia",1966,17856000,5352000,"Japan",23208000,15.4929808807902,16.6978501441632
"2918","Ethiopia",1967,17889000,5902000,"Japan",23791000,15.590801834485,16.6996965567734
"2919","Ethiopia",1968,14500000,6720000,"Japan",21220000,15.7205987124993,16.4896592073908
"2920","Ethiopia",1969,17931000,8367000,"Japan",26298000,15.9398059552777,16.7020416164745
"2921","Ethiopia",1970,25439000,9113000,"Japan",34552000,16.0252125234783,17.0517939874875
"2922","Ethiopia",1971,26338000,10226000,"Japan",36564000,16.1404440546221,17.0865233212523
"2923","Ethiopia",1972,28767000,14155000,"Japan",42922000,16.4655784765281,17.1747394548039
"2924","Ethiopia",1973,28711000,22983000,"Japan",51694000,16.9502653701671,17.17279088256
"2925","Ethiopia",1974,35405000,26513000,"Japan",61918000,17.093145736706,17.382363611068
"2926","Ethiopia",1975,36401000,30139000,"Japan",66540000,17.2213305721119,17.4101068047571
"2927","Ethiopia",1976,56934000,22022000,"Japan",78956000,16.9075525116557,17.857403260184
"2928","Ethiopia",1977,63122000,32588000,"Japan",95710000,17.2994546804127,17.960579919678
"2929","Ethiopia",1978,51097000,21269000,"Japan",72366000,16.8727611714967,17.7492363450357
"2930","Ethiopia",1979,60091000,28165000,"Japan",88256000,17.153590630311,17.9113706378757
"2931","Ethiopia",1980,62652000,28812000,"Japan",91464000,17.1763025249914,17.9531061621807
"2932","Ethiopia",1981,52559000,30649000,"Japan",83208000,17.2381105933868,17.7774469060844
"2933","Ethiopia",1982,70313000,31699000,"Japan",102012000,17.2717956926086,18.0684672614488
"2934","Ethiopia",1983,60189000,30970000,"Japan",91159000,17.2485295519494,17.9130001693304
"2935","Ethiopia",1984,49579308,29914581,"Japan",79493889,17.2138565783569,17.7190841272331
"2936","Ethiopia",1985,56791081,37782304,"Japan",94573385,17.4473514028261,17.8548898467138
"2937","Ethiopia",1986,66098791,39600698,"Japan",105699489,17.494357302332,18.0066610141857
"2938","Ethiopia",1987,115707485,39518616,"Japan",155226101,17.4922824099878,18.5665758832434
"2939","Ethiopia",1988,65317455,52247858,"Japan",117565313,17.7715094527536,17.9947698632744
"2940","Ethiopia",1989,54447335,50004456,"Japan",104451791,17.7276226794215,17.8127444621601
"2941","Ethiopia",1990,47534768,45144720,"Japan",92679488,17.6253838874672,17.6769719591491
"2942","Ethiopia",1991,55285953,44376901,"Japan",99662854,17.6082296442789,17.8280294197589
"2943","Ethiopia",1992,46511447,39665864,"Japan",86177311,17.4960015269088,17.6552090123052
"2944","Ethiopia",1993,62364365,41154938,"Japan",103519303,17.5328544778879,17.948504596497
"2945","Ethiopia",1994,61593128,58855614,"Japan",120448742,17.890597782193,17.9360608638391
"2946","Ethiopia",1995,88759646,54470079,"Japan",143229725,17.8131620996984,18.3014426677377
"2947","Ethiopia",1996,83735140,50855296,"Japan",134590436,17.7444948244949,18.2431692800906
"2948","Ethiopia",1997,65587624,73598761,"Japan",139186385,18.1141387493183,17.9988975775795
"2949","Ethiopia",1998,76984000,83254000,"Japan",160238000,18.2374067337186,18.1591081660184
"2950","Ethiopia",1999,75137854,58712083,"Japan",133849937,17.8881561068864,18.134835037681
"2951","Ethiopia",2000,48197019,53776693,"Japan",101973712,17.8003507156536,17.6908077306352
"2952","Ethiopia",2001,45500520,40951859,"Japan",86452379,17.5279077640583,17.6332343124273
"2953","Ethiopia",2002,46462124,38250120,"Japan",84712244,17.4596572554868,17.6541480010071
"2954","Ethiopia",2003,61322130,40831972,"Japan",102154102,17.5249759599497,17.9316513471767
"2955","Ethiopia",2004,88413999,66176500,"Japan",154590499,18.0078359729909,18.2975408747988
"2956","Ethiopia",2005,132252792,67011916,"Japan",199264708,18.0203810122879,18.700225740011
"2957","Ethiopia",2006,208266590,83100949,"Japan",291367539,18.2355666797364,19.1543294997038
"2958","Ethiopia",2007,385455875,70834583,"Japan",456290458,18.075857899858,19.7699372826784
"2959","Ethiopia",2008,85398421,28802512,"Japan",114200933,17.1759731635248,18.2628381691265
"2960","Ethiopia",2009,316881561,9501085,"Japan",326382646,16.0669165605756,19.5740386374208
"2961","Ethiopia",2010,420961191,40847184,"Japan",461808375,17.5253484417656,19.8580512044997
"2962","Ethiopia",2011,78360984,48508421,"Japan",126869405,17.6972479697019,18.176836708389
"2963","Ethiopia",2012,130442568,61787391,"Japan",192229959,17.9392098724849,18.6864435959041
"2964","Ethiopia",2013,106224802,91137014,"Japan",197361816,18.3278745804808,18.4810681799954
"2965","Ethiopia",2014,109032800,104831682,"Japan",213864482,18.4678665933253,18.507159312358
"2966","Ethiopia",2015,125014873,87151384,"Japan",212166257,18.2831572104697,18.6439432721885
"2967","Ethiopia",2016,100858264,76515329,"Japan",177373593,18.1530016578085,18.4292267624877
"2968","Ethiopia",2017,0,0,"0",0,0,0
"2969","Finland",1962,5434000,2159000,"Japan",7593000,14.5851557094969,15.5081860689684
"2970","Finland",1963,6820000,3024000,"Japan",9844000,14.9220910162816,15.7353700298196
"2971","Finland",1964,11915000,2742000,"Japan",14657000,14.8241981391044,16.293308668515
"2972","Finland",1965,20889000,2563000,"Japan",23452000,14.7566890053462,16.8547332625928
"2973","Finland",1966,25541000,4246000,"Japan",29787000,15.2614879212453,17.05579556207
"2974","Finland",1967,29338000,12169000,"Japan",41507000,16.3144022923189,17.1943941620298
"2975","Finland",1968,25381000,6829000,"Japan",32210000,15.7366888079432,17.0495114205775
"2976","Finland",1969,41098000,7464000,"Japan",48562000,15.8256020215093,17.531470016482
"2977","Finland",1970,62262000,11217000,"Japan",73479000,16.2329410426274,17.9468618458155
"2978","Finland",1971,71781000,5524000,"Japan",77305000,15.5246127935113,18.0891303750439
"2979","Finland",1972,84143000,15764000,"Japan",99907000,16.573239417297,18.248028290352
"2980","Finland",1973,122754000,34613000,"Japan",157367000,17.3597398920053,18.625692910666
"2981","Finland",1974,142836000,61364000,"Japan",204200000,17.9323339019468,18.777207676938
"2982","Finland",1975,174493000,33504000,"Japan",207997000,17.3271753926524,18.977395184189
"2983","Finland",1976,173944000,43255000,"Japan",217199000,17.5826233915966,18.974243966297
"2984","Finland",1977,214523000,65899000,"Japan",280422000,18.0036338248508,19.1839275166913
"2985","Finland",1978,218609000,91238000,"Japan",309847000,18.3289820349298,19.202795303948
"2986","Finland",1979,312143000,150885000,"Japan",463028000,18.8320285152187,19.5589719741045
"2987","Finland",1980,507724000,119523000,"Japan",627247000,18.5990193794354,20.0454485508114
"2988","Finland",1981,513029000,124835000,"Japan",637864000,18.6425034232992,20.0558429317517
"2989","Finland",1982,563080000,169754000,"Japan",732834000,18.9498608881903,20.148932271924
"2990","Finland",1983,701542000,171625000,"Japan",873167000,18.9608224220524,20.368791327418
"2991","Finland",1984,627903968,186181118,"Japan",814085086,19.042230510576,20.257897795542
"2992","Finland",1985,633121447,196770411,"Japan",829891858,19.0975481806689,20.2661728211055
"2993","Finland",1986,897664237,261852464,"Japan",1159516701,19.383291788613,20.6153066554572
"2994","Finland",1987,1276225547,285119685,"Japan",1561345232,19.4684195974481,20.9671727672204
"2995","Finland",1988,1397419199,416694626,"Japan",1814113825,19.8478641997412,21.0578929430751
"2996","Finland",1989,1623810852,488680488,"Japan",2112491340,20.0072194351081,21.2080416014593
"2997","Finland",1990,1576417782,414543673,"Japan",1990961455,19.8426888900774,21.1784208833534
"2998","Finland",1991,1186174005,372994414,"Japan",1559168419,19.7370740016246,20.8939988426118
"2999","Finland",1992,1051195723,319337918,"Japan",1370533641,19.5817604041577,20.7731941370029
"3000","Finland",1993,943063124,388068244,"Japan",1331131368,19.7766917687193,20.664643777912
"3001","Finland",1994,1383048956,593779837,"Japan",1976828793,20.20201916384,21.0475562874118
"3002","Finland",1995,1688516647,1044336938,"Japan",2732853585,20.7666480118862,21.2471162567878
"3003","Finland",1996,1454715445,1051069976,"Japan",2505785421,20.7730745070245,21.0980761479967
"3004","Finland",1997,1645680298,661647186,"Japan",2307327484,20.3102430201704,21.2214196906886
"3005","Finland",1998,1827195000,719554000,"Japan",2546749000,20.394142133595,21.3260478409949
"3006","Finland",1999,1775214376,699244005,"Japan",2474458381,20.365510316538,21.2971870277923
"3007","Finland",2000,1624642888,772426113,"Japan",2397069001,20.4650469155598,21.2085538673463
"3008","Finland",2001,1237981145,785944139,"Japan",2023925284,20.4823962778933,20.9367477808828
"3009","Finland",2002,1313171409,912820159,"Japan",2225991568,20.6320494410623,20.9957109713474
"3010","Finland",2003,1528885474,1083648815,"Japan",2612534289,20.8035997160716,21.1478048585373
"3011","Finland",2004,1691337974,1234289126,"Japan",2925627100,20.9337610348236,21.2487857532435
"3012","Finland",2005,1719583774,1086573228,"Japan",2806157002,20.8062947534568,21.2653481066266
"3013","Finland",2006,1799390172,1203522036,"Japan",3002912208,20.9085181249491,21.3107136511118
"3014","Finland",2007,1874661703,1494566904,"Japan",3369228607,21.1251023054979,21.3516940550236
"3015","Finland",2008,1571134147,1732650064,"Japan",3303784211,21.2729179023047,21.1750635821352
"3016","Finland",2009,1000287050,1014429656,"Japan",2014716706,20.7375923762357,20.7235528457554
"3017","Finland",2010,979861709,1301608935,"Japan",2281470644,20.9868669784737,20.7029220064062
"3018","Finland",2011,1095695957,1666639215,"Japan",2762335172,21.2340749895768,20.8146555754902
"3019","Finland",2012,666060099,1386735876,"Japan",2052795975,21.0502185318829,20.3168904631721
"3020","Finland",2013,523859989,1428220105,"Japan",1952080094,21.0796948241403,20.0767350100171
"3021","Finland",2014,448866657,1529883663,"Japan",1978750320,21.1484575322049,19.9222364238716
"3022","Finland",2015,355995373,1383909095,"Japan",1739904468,21.0481780091812,19.6904282915408
"3023","Finland",2016,365368566,1385640298,"Japan",1751008864,21.0494281787791,19.7164171719351
"3024","Finland",2017,623213932,1663464189.5,"Japan",2286678121.5,21.2321681259894,20.250400407855
"3025","Fiji",1962,2933000,1832000,"Japan",4765000,14.4209188242162,14.8915363479596
"3026","Fiji",1963,5292000,1560000,"Japan",6852000,14.2601963792257,15.481706804217
"3027","Fiji",1964,7728000,1299000,"Japan",9027000,14.0771052956527,15.8603606548745
"3028","Fiji",1965,7333000,1226000,"Japan",8559000,14.0192673954783,15.8078952670759
"3029","Fiji",1966,8329000,1132000,"Japan",9461000,13.9394965377453,15.9352539589175
"3030","Fiji",1967,10694000,2477000,"Japan",13171000,14.7225587084715,16.1851933944908
"3031","Fiji",1968,10033000,1720000,"Japan",11753000,14.3578348487896,16.1213902179077
"3032","Fiji",1969,12694000,2832000,"Japan",15526000,14.8564937337957,16.3566399988486
"3033","Fiji",1970,15738000,10453000,"Japan",26191000,16.1623995765148,16.5715887280771
"3034","Fiji",1971,21837000,6970000,"Japan",28807000,15.7571257827367,16.8991163367685
"3035","Fiji",1972,25229000,5478000,"Japan",30707000,15.5162506288052,17.043504684477
"3036","Fiji",1973,32706000,8461000,"Japan",41167000,15.9509779279066,17.3030691052745
"3037","Fiji",1974,49112000,18559000,"Japan",67671000,16.7364654045604,17.7096139620895
"3038","Fiji",1975,42063000,13875000,"Japan",55938000,16.4455992175968,17.5546790523714
"3039","Fiji",1976,47247000,622000,"Japan",47869000,13.3406953717213,17.6708997178248
"3040","Fiji",1977,49761000,4774000,"Japan",54535000,15.3786950858809,17.7227421026563
"3041","Fiji",1978,52194000,7608000,"Japan",59802000,15.8447108832074,17.7704781037177
"3042","Fiji",1979,69420000,11262000,"Japan",80682000,16.2369447847967,18.0556855683979
"3043","Fiji",1980,82211000,42823000,"Japan",125034000,17.572585899391,18.2247996710247
"3044","Fiji",1981,103320000,40628000,"Japan",143948000,17.5199680420415,18.4533415261919
"3045","Fiji",1982,75780000,8023000,"Japan",83803000,15.8978229747358,18.1433449635547
"3046","Fiji",1983,61369000,12452000,"Japan",73821000,16.3373918105436,17.932415379626
"3047","Fiji",1984,68993054,6907331,"Japan",75900385,15.7480938693204,18.0495163908276
"3048","Fiji",1985,62964566,9505987,"Japan",72470553,16.0674323685978,17.9580826816802
"3049","Fiji",1986,58427005,17131639,"Japan",75558644,16.6564375458167,17.8832887553014
"3050","Fiji",1987,43266425,36720816,"Japan",79987241,17.4188543456919,17.5828874880344
"3051","Fiji",1988,44226911,22239344,"Japan",66466255,16.9173735305088,17.6048440079302
"3052","Fiji",1989,71692576,29892996,"Japan",101585572,17.213134763429,18.0878977576706
"3053","Fiji",1990,74941241,27876746,"Japan",102817987,17.1433034225543,18.1322149111073
"3054","Fiji",1991,67715809,35494540,"Japan",103210349,17.3848894397999,18.0308302261316
"3055","Fiji",1992,59062675,29234245,"Japan",88296920,17.1908513540489,17.8941097261768
"3056","Fiji",1993,58132888,28894449,"Japan",87027337,17.1791600585091,17.8782421201912
"3057","Fiji",1994,61072214,52567101,"Japan",113639315,17.7776010257548,17.9275675580218
"3058","Fiji",1995,41937946,53750244,"Japan",95688190,17.7998587644966,17.5517016075129
"3059","Fiji",1996,37519595,61017269,"Japan",98536864,17.9266674804335,17.440373887801
"3060","Fiji",1997,35836298,32154833,"Japan",67991131,17.2860733239441,17.3944718483253
"3061","Fiji",1998,39316000,42309000,"Japan",81625000,17.5605103873425,17.4871421186687
"3062","Fiji",1999,42461857,33316208,"Japan",75778065,17.3215545632644,17.5641167485633
"3063","Fiji",2000,25087851,28863975,"Japan",53951826,17.1781048357133,17.0378942630202
"3064","Fiji",2001,35023550,34245518,"Japan",69269068,17.3490662527956,17.3715312503297
"3065","Fiji",2002,35786319,40717142,"Japan",76503461,17.5221597411029,17.3930762274947
"3066","Fiji",2003,53509441,35965976,"Japan",89475417,17.3980839384102,17.7953686635874
"3067","Fiji",2004,53991468,35887085,"Japan",89878553,17.3958880394296,17.8043365920452
"3068","Fiji",2005,62365742,49618491,"Japan",111984233,17.719874124641,17.9485266761702
"3069","Fiji",2006,60047946,46342289,"Japan",106390235,17.651565471519,17.910653901076
"3070","Fiji",2007,48193466,40566905,"Japan",88760371,17.5184631443751,17.6907340096657
"3071","Fiji",2008,47782691,47892573,"Japan",95675264,17.6844709981672,17.6821740189122
"3072","Fiji",2009,34564628,45310500,"Japan",79875128,17.629049351674,17.3583414049717
"3073","Fiji",2010,41498574,69851310,"Japan",111349884,18.0618793979653,17.5411696231648
"3074","Fiji",2011,29255674,92531350,"Japan",121787024,18.3430580639815,17.1915840957359
"3075","Fiji",2012,36403024,104885788,"Japan",141288812,18.4683825827772,17.4101624060794
"3076","Fiji",2013,45524704,44859239,"Japan",90383943,17.6190401230248,17.6337656816348
"3077","Fiji",2014,55977775,60688053,"Japan",116665828,17.9212574162297,17.8404652949237
"3078","Fiji",2015,61908113,46575146,"Japan",108483259,17.6565776091759,17.9411617953023
"3079","Fiji",2016,114128274,37755039,"Japan",151883313,17.4466295081949,18.5528335843102
"3080","Fiji",2017,82323592,38522676,"Japan",120846268,17.4667576128862,18.2261682831348
"3081","Falkland Islands",1962,0,0,"0",0,0,0
"3082","Falkland Islands",1963,0,0,"0",0,0,0
"3083","Falkland Islands",1964,0,0,"0",0,0,0
"3084","Falkland Islands",1965,0,0,"0",0,0,0
"3085","Falkland Islands",1966,0,0,"0",0,0,0
"3086","Falkland Islands",1967,0,0,"0",0,0,0
"3087","Falkland Islands",1968,0,0,"0",0,0,0
"3088","Falkland Islands",1969,0,0,"0",0,0,0
"3089","Falkland Islands",1970,32000,0,"Japan",32000,0,10.3734911817819
"3090","Falkland Islands",1971,36000,0,"Japan",36000,0,10.4912742174382
"3091","Falkland Islands",1972,21000,0,"Japan",21000,0,9.95227771670556
"3092","Falkland Islands",1973,41000,485000,"Japan",526000,13.0919041699196,10.6213273456864
"3093","Falkland Islands",1974,45000,1953000,"Japan",1998000,14.4848772098588,10.7144177687525
"3094","Falkland Islands",1975,49000,0,"Japan",49000,0,10.7995755770928
"3095","Falkland Islands",1976,32000,75000,"Japan",107000,11.2252433925184,10.3734911817819
"3096","Falkland Islands",1977,58000,74000,"Japan",132000,11.2118203721863,10.9681982895286
"3097","Falkland Islands",1978,62000,83000,"Japan",145000,11.3265958867787,11.0348896640272
"3098","Falkland Islands",1979,47000,810000,"Japan",857000,13.6047895266486,10.7579028806922
"3099","Falkland Islands",1980,88000,524000,"Japan",612000,13.1692469633032,11.3850920934603
"3100","Falkland Islands",1981,208000,413000,"Japan",621000,12.9312028719432,12.2452933586835
"3101","Falkland Islands",1982,4000,550000,"Japan",554000,13.2176735572087,8.29404964010203
"3102","Falkland Islands",1983,9000,882000,"Japan",891000,13.6899473349889,9.10497985631836
"3103","Falkland Islands",1984,2304,656265,"Japan",658569,13.3943199497696,7.74240202181578
"3104","Falkland Islands",1985,47045,979746,"Japan",1026791,13.7950486333794,10.7588598694409
"3105","Falkland Islands",1986,27726,293145,"Japan",320871,12.5884226461323,10.2301258800983
"3106","Falkland Islands",1987,114400,806334,"Japan",920734,13.6002533277116,11.6474563579278
"3107","Falkland Islands",1988,55783,151120,"Japan",206903,11.9258295021754,10.9292244424531
"3108","Falkland Islands",1989,115435,306111,"Japan",421546,12.6317030602565,11.6564628799664
"3109","Falkland Islands",1990,91168,1196620,"Japan",1287788,13.9950114738215,11.4204592372976
"3110","Falkland Islands",1991,67923,875490,"Japan",943413,13.6825390085983,11.1261299896211
"3111","Falkland Islands",1992,38212,85475,"Japan",123687,11.3559792145075,10.5509048813899
"3112","Falkland Islands",1993,9559,98683,"Japan",108242,11.4996679714783,9.16523839806376
"3113","Falkland Islands",1994,7502,165096,"Japan",172598,12.014282401874,8.92292493064183
"3114","Falkland Islands",1995,32442,703605,"Japan",736047,13.4639723981307,10.3872091586101
"3115","Falkland Islands",1996,889619,18188,"Japan",907807,9.8085173149449,13.698548560164
"3116","Falkland Islands",1997,38178,1500315,"Japan",1538493,14.2211856440255,10.5500147124608
"3117","Falkland Islands",1998,0,1681000,"Japan",1681000,14.3348994123908,0
"3118","Falkland Islands",1999,90349,1035616,"Japan",1125965,13.8505069767209,11.4114352278905
"3119","Falkland Islands",2000,61368,987242,"Japan",1048610,13.8026704757988,11.0246438056391
"3120","Falkland Islands",2001,35886,640527,"Japan",676413,13.3700465539972,10.4881025262726
"3121","Falkland Islands",2002,22942,2400924,"Japan",2423866,14.6913642212247,10.0407245708412
"3122","Falkland Islands",2003,70958,953473,"Japan",1024431,13.7678663868938,11.1698434316934
"3123","Falkland Islands",2004,29242,539848,"Japan",569090,13.1990428974356,10.2833613109774
"3124","Falkland Islands",2005,14571,1460292,"Japan",1474863,14.1941469736872,9.58678853101385
"3125","Falkland Islands",2006,28553,925906,"Japan",954459,13.7385279965966,10.2595172883729
"3126","Falkland Islands",2007,32741,712349,"Japan",745090,13.4763232388401,10.3963833941361
"3127","Falkland Islands",2008,161562,286547,"Japan",448109,12.565657850548,11.9926442489025
"3128","Falkland Islands",2009,15137,245283,"Japan",260420,12.4101679249506,9.62489735676257
"3129","Falkland Islands",2010,91152,1111756,"Japan",1202908,13.9214513052552,11.4202837217202
"3130","Falkland Islands",2011,6845,1271017,"Japan",1277862,14.0553279253772,8.83127373772255
"3131","Falkland Islands",2012,25519,844088,"Japan",869607,13.6460120335457,10.147178551738
"3132","Falkland Islands",2013,9939,558017,"Japan",567956,13.2321447068492,9.20422169096801
"3133","Falkland Islands",2014,77819,165350,"Japan",243169,12.0158197184099,11.2621408962889
"3134","Falkland Islands",2015,78583,750974,"Japan",829557,13.529126309641,11.271910670037
"3135","Falkland Islands",2016,83371,337598,"Japan",420969,12.7296111175158,11.331055806055
"3136","Falkland Islands",2017,0,0,"0",0,0,0
"3137","France",1962,25223000,46344000,"Japan",71567000,17.6516023917586,17.0432668346384
"3138","France",1963,40112000,50607000,"Japan",90719000,17.7396004646106,17.5071860993802
"3139","France",1964,47783000,70451000,"Japan",118234000,18.0704279906724,17.6821804856682
"3140","France",1965,59471000,62491000,"Japan",121962000,17.9505331043376,17.9009993567423
"3141","France",1966,77958000,64255000,"Japan",142213000,17.9783700997234,18.1716807780929
"3142","France",1967,89302000,87387000,"Japan",176689000,18.2858570881439,18.3075344420125
"3143","France",1968,122124000,127356000,"Japan",249480000,18.662496872532,18.6205474799621
"3144","France",1969,160932000,149483000,"Japan",310415000,18.8226932319547,18.8964924734811
"3145","France",1970,191151000,186555000,"Japan",377706000,19.0442366597381,19.0685742495866
"3146","France",1971,276519000,198573000,"Japan",475092000,19.1066673486715,19.4377900926599
"3147","France",1972,367883000,300730000,"Japan",668613000,19.5217234101922,19.7232755107986
"3148","France",1973,544128000,537564000,"Japan",1081692000,20.1025583806453,20.1146950712605
"3149","France",1974,947567000,592878000,"Japan",1540445000,20.2004992022378,20.6694082048219
"3150","France",1975,999519000,500569000,"Japan",1500088000,20.0312560093553,20.7227847212288
"3151","France",1976,1229825000,534663000,"Japan",1764488000,20.0971471998437,20.9301377197857
"3152","France",1977,1382918000,560987000,"Japan",1943905000,20.1452082903129,21.0474615964757
"3153","France",1978,1648549000,754428000,"Japan",2402977000,20.4414704041833,21.2231613440258
"3154","France",1979,2058755000,1078618000,"Japan",3137373000,20.7989464290278,21.4453672681113
"3155","France",1980,2772271000,1296130000,"Japan",4068401000,20.9826487384879,21.7429326768433
"3156","France",1981,2747292000,1172277000,"Japan",3919569000,20.8822138482983,21.7338815361897
"3157","France",1982,3059755000,1215533000,"Japan",4275288000,20.9184485006732,21.8416006843458
"3158","France",1983,2750838000,1295990000,"Japan",4046828000,20.9825407187973,21.7351714294777
"3159","France",1984,2497295847,1114581542,"Japan",3611877389,20.8317448727616,21.6384743222029
"3160","France",1985,2753390855,1282889151,"Japan",4036280006,20.9723805205621,21.7360990272395
"3161","France",1986,4261080429,1682107502,"Japan",5943187931,21.2433133096534,22.1727885869021
"3162","France",1987,5506217836,2609922845,"Japan",8116140681,21.6825864965414,22.4291438062696
"3163","France",1988,6749154930,3909895806,"Japan",10659050736,22.0867765625068,22.6326831384377
"3164","France",1989,7315520993,5040176464,"Japan",12355697457,22.3407069311152,22.7132640914387
"3165","France",1990,8726154076,6905906124,"Japan",15632060200,22.6556428424248,22.8895905686086
"3166","France",1991,8773952967,5281286768,"Japan",14055239735,22.3874356110337,22.8950532791791
"3167","France",1992,9047011055,4904233163,"Japan",13951244218,22.3133645799232,22.9257002699413
"3168","France",1993,7663902158,4632039465,"Japan",12295941623,22.2562630972585,22.759787111093
"3169","France",1994,7654367738,5123295599,"Japan",12777663337,22.3570637406097,22.7585422680009
"3170","France",1995,8617073283,6012778320,"Japan",14629851603,22.5171527615356,22.8770113376358
"3171","France",1996,8049929445,5627128518,"Japan",13677057963,22.4508651166605,22.8089291637422
"3172","France",1997,8534310277,5144940144,"Japan",13679250421,22.3612795723455,22.8673603787968
"3173","France",1998,9535386000,5664406000,"Japan",15199792000,22.4574678715598,22.9782755576125
"3174","France",1999,9194963087,5532638803,"Japan",14727601890,22.4339307182327,22.9419216805303
"3175","France",2000,10295357935,5754643203,"Japan",16050001138,22.4732728794572,23.0549589446702
"3176","France",2001,8857494917,5551174415,"Japan",14408669332,22.4372753486256,22.9045298208398
"3177","France",2002,8832171948,5884021389,"Japan",14716193337,22.4955062747912,22.9016667950416
"3178","France",2003,10451169503,6512848465,"Japan",16964017968,22.5970427496962,23.069979723258
"3179","France",2004,11918088242,7525191720,"Japan",19443279962,22.7415221249977,23.2013231033384
"3180","France",2005,11549474106,7649942748,"Japan",19199416854,22.7579640008353,23.1699057409296
"3181","France",2006,11578968260,8073984006,"Japan",19652952266,22.8119128784488,23.1724562084034
"3182","France",2007,11721865863,9010817460,"Japan",20732683323,22.921691632531,23.1847218117514
"3183","France",2008,12009122048,9527767110,"Japan",21536889158,22.9774762260055,23.2089323686177
"3184","France",2009,9161773507,8221877706,"Japan",17383651213,22.8300644513149,22.9383056111929
"3185","France",2010,10035092661,9244769146,"Japan",19279861807,22.9473237307869,23.0293540529338
"3186","France",2011,8042229019,11729896252,"Japan",19772125271,23.1854066549009,22.8079721228822
"3187","France",2012,6536484829,12696144258,"Japan",19232629087,23.2645641825823,22.6006653699966
"3188","France",2013,6200380115,11569205729,"Japan",17769585844,23.1716127266166,22.5478764359891
"3189","France",2014,5850339534,11384192978,"Japan",17234532512,23.1554916492769,22.4897655365059
"3190","France",2015,5179056266,9363620324,"Japan",14542676590,22.9600978394053,22.3678886885887
"3191","France",2016,6153329281,10123095040,"Japan",16276424321,23.0380852880401,22.5402591187937
"3192","France",2017,8914047152.5,8995438593.5,"Japan",17909485746,22.91998346286,22.9108942011696
"3193","Gabon",1962,192000,268000,"Japan",460000,12.498742259493,12.1652506510099
"3194","Gabon",1963,205000,323000,"Japan",528000,12.6854076022048,12.2307652581205
"3195","Gabon",1964,471000,469000,"Japan",940000,13.0583580474284,13.0626133729986
"3196","Gabon",1965,725000,485000,"Japan",1210000,13.0919041699196,13.4939269338368
"3197","Gabon",1966,960000,4e+05,"Japan",1360000,12.8992198260901,13.774688563444
"3198","Gabon",1967,753000,3718000,"Japan",4471000,15.1286964472635,13.531820506782
"3199","Gabon",1968,1072000,1829000,"Japan",2901000,14.419279927373,13.8850366206129
"3200","Gabon",1969,806000,2623000,"Japan",3429000,14.779829258849,13.5998390214888
"3201","Gabon",1970,604000,2884000,"Japan",3488000,14.874688777387,13.311329476917
"3202","Gabon",1971,1048000,4873000,"Japan",5921000,15.3992203218256,13.8623941438631
"3203","Gabon",1972,1741000,7837000,"Japan",9578000,15.874366666035,14.3699702187503
"3204","Gabon",1973,5309000,8876000,"Japan",14185000,15.9988615630346,15.4849140515658
"3205","Gabon",1974,7519000,6867000,"Japan",14386000,15.7422378876028,15.8329437083602
"3206","Gabon",1975,9612000,12723000,"Japan",22335000,16.3589219371248,16.0785228758385
"3207","Gabon",1976,11417000,17841000,"Japan",29258000,16.6970097373568,16.2506140306585
"3208","Gabon",1977,29676000,6926000,"Japan",36602000,15.7507930039445,17.2058491962916
"3209","Gabon",1978,15364000,6062000,"Japan",21426000,15.6175503365999,16.5475376684479
"3210","Gabon",1979,17498000,13040000,"Japan",30538000,16.3835321144628,16.6775971466483
"3211","Gabon",1980,44496000,19776000,"Japan",64272000,16.7999796392396,17.6109098554559
"3212","Gabon",1981,51136000,7826000,"Japan",58962000,15.8729620817525,17.7499993081081
"3213","Gabon",1982,45640000,10786000,"Japan",56426000,16.1937595548793,17.6362950829581
"3214","Gabon",1983,43254000,9510000,"Japan",52764000,16.0678544345216,17.5826002726148
"3215","Gabon",1984,37471689,28538265,"Japan",66009954,17.166756376294,17.4390962458148
"3216","Gabon",1985,44659874,13799296,"Japan",58459170,16.4401281343334,17.6145859830557
"3217","Gabon",1986,40537000,13871018,"Japan",54408018,16.445312185416,17.5177256952632
"3218","Gabon",1987,30683578,37907261,"Japan",68590839,17.4506532348164,17.2392381508707
"3219","Gabon",1988,44252295,26747400,"Japan",70999695,17.1019478303207,17.6054177924801
"3220","Gabon",1989,34989356,52416101,"Japan",87405457,17.7747243730856,17.3705544589158
"3221","Gabon",1990,37474420,100093737,"Japan",137568157,18.4216176748955,17.4391691248485
"3222","Gabon",1991,60077236,138558144,"Japan",198635380,18.7468006077695,17.9111415590356
"3223","Gabon",1992,53009863,80575381,"Japan",133585244,18.2047037141684,17.7859885485426
"3224","Gabon",1993,52111857,344566941,"Japan",396678798,19.6577989430394,17.7689030624047
"3225","Gabon",1994,32725972,180757731,"Japan",213483703,19.0126681898727,17.3036795713818
"3226","Gabon",1995,40562300,101947649,"Japan",142509949,18.4399699943952,17.5183496217539
"3227","Gabon",1996,49613613,125097113,"Japan",174710726,18.6446008976329,17.7197758096843
"3228","Gabon",1997,65057534,42542355,"Japan",107599889,17.5660107258656,17.9907825748174
"3229","Gabon",1998,34162000,47388000,"Japan",81550000,17.6738795900568,17.3466244731801
"3230","Gabon",1999,42464496,39360831,"Japan",81825327,17.4882817427303,17.5641788965281
"3231","Gabon",2000,43860117,11585376,"Japan",55445493,16.2652541710837,17.5965159685291
"3232","Gabon",2001,52733194,10754063,"Japan",63487257,16.1907941946199,17.7807556824012
"3233","Gabon",2002,27652894,31639768,"Japan",59292662,17.2699253683463,17.1352409459167
"3234","Gabon",2003,30073323,150851557,"Japan",180924880,18.8318068450275,17.2191490576718
"3235","Gabon",2004,28041882,7183806,"Japan",35225688,15.7873398841452,17.1492097362806
"3236","Gabon",2005,45228293,12044743,"Japan",57273036,16.3041388571493,17.6272334003041
"3237","Gabon",2006,47368627,74114586,"Japan",121483213,18.1211229130007,17.6734706898905
"3238","Gabon",2007,50832181,133542226,"Japan",184374407,18.7099282854179,17.7440401962342
"3239","Gabon",2008,47686775,437941660,"Japan",485628435,19.8975962631223,17.6801646637479
"3240","Gabon",2009,48398836,19513069,"Japan",67911905,16.786595004175,17.6949863218109
"3241","Gabon",2010,49595613,44802695,"Japan",94398308,17.6177788518259,17.7194129402028
"3242","Gabon",2011,86775339,642625449,"Japan",729400788,20.2810726070364,18.2788330263596
"3243","Gabon",2012,72356621,2741325465,"Japan",2813682086,21.7317073867292,18.0971175203308
"3244","Gabon",2013,44933988,2265038343,"Japan",2309972331,21.5408575242149,17.6207050374012
"3245","Gabon",2014,46351608,1457806554,"Japan",1504158162,21.1001987827179,17.651766541931
"3246","Gabon",2015,36134260,270773678,"Japan",306907938,19.4167938933918,17.4027520037293
"3247","Gabon",2016,27124701,54933402,"Japan",82058103,17.8216321367708,17.1159553467227
"3248","Gabon",2017,0,0,"0",0,0,0
"3249","United Kingdom",1962,149095000,145785000,"Japan",294880000,18.7976434915878,18.8200942446321
"3250","United Kingdom",1963,147573000,149164000,"Japan",296737000,18.8205569297563,18.8098335265682
"3251","United Kingdom",1964,205137000,185316000,"Japan",390453000,19.0375730339931,19.1391886065775
"3252","United Kingdom",1965,218867000,162629000,"Japan",381496000,18.9069820909587,19.2039747973598
"3253","United Kingdom",1966,216111000,214433000,"Japan",430544000,19.1835078932272,19.1913027225417
"3254","United Kingdom",1967,250801000,257098000,"Japan",507899000,19.3649678931316,19.3401703539559
"3255","United Kingdom",1968,276298000,257369000,"Japan",533667000,19.366021410753,19.4369905513586
"3256","United Kingdom",1969,250557000,330409000,"Japan",580966000,19.6158418389495,19.339196997515
"3257","United Kingdom",1970,317178000,395207000,"Japan",712385000,19.7949202362317,19.574973688447
"3258","United Kingdom",1971,484189000,417172000,"Japan",901361000,19.8490091647447,19.997985884325
"3259","United Kingdom",1972,776846000,500825000,"Japan",1277671000,20.031767296632,20.4707526904899
"3260","United Kingdom",1973,1081507000,759432000,"Japan",1840939000,20.4480813434046,20.8016212758283
"3261","United Kingdom",1974,1320587000,876134000,"Japan",2196721000,20.5910296052388,21.001342171666
"3262","United Kingdom",1975,1482160000,810049000,"Japan",2292209000,20.5126052976282,21.116766320206
"3263","United Kingdom",1976,1428137000,745674000,"Japan",2173811000,20.4297990653378,21.0796366346374
"3264","United Kingdom",1977,1850593000,915792000,"Japan",2766385000,20.6352998226173,21.338771965215
"3265","United Kingdom",1978,2455414000,1188682000,"Japan",3644096000,20.8961109672435,21.6215612194134
"3266","United Kingdom",1979,3153806000,1448895000,"Japan",4602701000,21.0940670338912,21.8718758144008
"3267","United Kingdom",1980,3953589000,1725383000,"Japan",5678972000,21.2687148917705,22.0978896109204
"3268","United Kingdom",1981,4422366000,1735270000,"Japan",6157636000,21.2744288578343,22.2099406839349
"3269","United Kingdom",1982,4622529000,1346126000,"Japan",5968655000,21.0204966744861,22.2542077948673
"3270","United Kingdom",1983,5035172000,1489211000,"Japan",6524383000,21.1215122864518,22.3397135234074
"3271","United Kingdom",1984,4534161329,2048131486,"Japan",6582292815,21.4401937442112,22.2349059704455
"3272","United Kingdom",1985,4760743695,1634556158,"Japan",6395299853,21.2146371414459,22.2836697314312
"3273","United Kingdom",1986,6514321279,3245046062,"Japan",9759367341,21.9003953817629,22.5972688638922
"3274","United Kingdom",1987,8130644175,2771645067,"Japan",10902289242,21.7427068678682,22.8189059916846
"3275","United Kingdom",1988,10390194994,3830165682,"Japan",14220360676,22.0661738982112,23.0641284093502
"3276","United Kingdom",1989,10578376826,4094706416,"Japan",14673083242,22.1329608583969,23.082077832514
"3277","United Kingdom",1990,10982933766,4817157540,"Japan",15800091306,22.2954498690628,23.1196084291417
"3278","United Kingdom",1991,10306473910,4594317841,"Japan",14900791751,22.2480861249324,23.0560380696881
"3279","United Kingdom",1992,11467076932,4466064088,"Japan",15933141020,22.2197733404629,23.1627458909711
"3280","United Kingdom",1993,11265705242,4471298191,"Japan",15737003433,22.2209446264498,23.1450290135759
"3281","United Kingdom",1994,11874586678,5328728149,"Japan",17203314827,22.3963784254488,23.1976663801982
"3282","United Kingdom",1995,13376004875,6432876564,"Japan",19808881439,22.584687641254,23.3167282577474
"3283","United Kingdom",1996,12490998683,6441135953,"Japan",18932134636,22.5859707517251,23.2482741164943
"3284","United Kingdom",1997,14196376937,5251712891,"Japan",19448089828,22.3818201252895,23.3762526237168
"3285","United Kingdom",1998,15722071000,5575818000,"Japan",21297889000,22.4417048699867,23.4783313582727
"3286","United Kingdom",1999,13729420050,5334421273,"Japan",19063841323,22.3974462384027,23.3428068162129
"3287","United Kingdom",2000,14097678272,5900793934,"Japan",19998472206,22.4983527438898,23.369275959212
"3288","United Kingdom",2001,12012456157,5387293572,"Japan",17399749729,22.4073089755401,23.2092099614547
"3289","United Kingdom",2002,11413618509,4878697011,"Japan",16292315520,22.3081440152164,23.1580730854254
"3290","United Kingdom",2003,12191246944,5291643009,"Japan",17482889953,22.3893946223069,23.2239840675789
"3291","United Kingdom",2004,13674205453,6013619553,"Japan",19687825006,22.5172926592856,23.3387770814092
"3292","United Kingdom",2005,14637269611,6047922873,"Japan",20685192484,22.5229807232622,23.406836826105
"3293","United Kingdom",2006,13850666535,6033225516,"Japan",19883892051,22.5205476161142,23.3515991936925
"3294","United Kingdom",2007,14261792301,6811252774,"Japan",21073045075,22.6418419011289,23.3808499313417
"3295","United Kingdom",2008,14431166980,6809621942,"Japan",21240788922,22.641602440442,23.3926560782571
"3296","United Kingdom",2009,9826526298,5341362427,"Japan",15167888725,22.3987465935191,23.0083513310334
"3297","United Kingdom",2010,12322564757,5679293587,"Japan",18001858344,22.4600926934592,23.2346979517136
"3298","United Kingdom",2011,15960503908,7204032186,"Japan",23164536094,22.6979067320458,23.4933830016526
"3299","United Kingdom",2012,13156232011,7223198436,"Japan",20379430447,22.700563688433,23.3001614004932
"3300","United Kingdom",2013,10938506437,6489043048,"Japan",17427549485,22.5933809065594,23.115555101494
"3301","United Kingdom",2014,11008371048,6308622772,"Japan",17316993820,22.5651832285044,23.1219218246914
"3302","United Kingdom",2015,10610489027,6464649935,"Japan",17075138962,22.5896146999857,23.0851088796506
"3303","United Kingdom",2016,13548050313,6457043160,"Japan",20005093473,22.5884373347871,23.3295084855797
"3304","United Kingdom",2017,13590072817.5,7363108339.5,"Japan",20953181157,22.7197480092679,23.3326054232629
"3305","Georgia",1962,0,0,"0",0,0,0
"3306","Georgia",1963,0,0,"0",0,0,0
"3307","Georgia",1964,0,0,"0",0,0,0
"3308","Georgia",1965,0,0,"0",0,0,0
"3309","Georgia",1966,0,0,"0",0,0,0
"3310","Georgia",1967,0,0,"0",0,0,0
"3311","Georgia",1968,0,0,"0",0,0,0
"3312","Georgia",1969,0,0,"0",0,0,0
"3313","Georgia",1970,0,0,"0",0,0,0
"3314","Georgia",1971,0,0,"0",0,0,0
"3315","Georgia",1972,0,0,"0",0,0,0
"3316","Georgia",1973,0,0,"0",0,0,0
"3317","Georgia",1974,0,0,"0",0,0,0
"3318","Georgia",1975,0,0,"0",0,0,0
"3319","Georgia",1976,0,0,"0",0,0,0
"3320","Georgia",1977,0,0,"0",0,0,0
"3321","Georgia",1978,0,0,"0",0,0,0
"3322","Georgia",1979,0,0,"0",0,0,0
"3323","Georgia",1980,0,0,"0",0,0,0
"3324","Georgia",1981,0,0,"0",0,0,0
"3325","Georgia",1982,0,0,"0",0,0,0
"3326","Georgia",1983,0,0,"0",0,0,0
"3327","Georgia",1984,0,0,"0",0,0,0
"3328","Georgia",1985,0,0,"0",0,0,0
"3329","Georgia",1986,0,0,"0",0,0,0
"3330","Georgia",1987,0,0,"0",0,0,0
"3331","Georgia",1988,0,0,"0",0,0,0
"3332","Georgia",1989,0,0,"0",0,0,0
"3333","Georgia",1990,0,0,"0",0,0,0
"3334","Georgia",1991,0,0,"0",0,0,0
"3335","Georgia",1992,4967371,948761,"Japan",5916132,13.7629122018277,15.4184012842737
"3336","Georgia",1993,2031987,3359322,"Japan",5391309,15.0272497258636,14.5245246900222
"3337","Georgia",1994,680159,660411,"Japan",1340570,13.4006176474612,13.4300818733492
"3338","Georgia",1995,1739895,2579952,"Japan",4319847,14.7632813520736,14.3693353245423
"3339","Georgia",1996,2090729,1383678,"Japan",3474407,14.1402557291309,14.5530233669508
"3340","Georgia",1997,3249154,594409,"Japan",3843563,13.29532291359,14.9939052127277
"3341","Georgia",1998,2886000,244000,"Japan",3130000,12.4049235042753,14.875382018316
"3342","Georgia",1999,6695073,1297248,"Japan",7992321,14.0757556555059,15.7168824407074
"3343","Georgia",2000,3856551,2143090,"Japan",5999641,14.577759270774,15.165283818695
"3344","Georgia",2001,6237365,9765669,"Japan",16003034,16.0943836299309,15.6460683755211
"3345","Georgia",2002,6098556,4732512,"Japan",10831068,15.3699666977201,15.6235625798092
"3346","Georgia",2003,13044009,2392355,"Japan",15436364,14.687788794412,16.3838395058635
"3347","Georgia",2004,10216169,6837925,"Japan",17054094,15.7379948810019,16.1394822192358
"3348","Georgia",2005,9660219,3599853,"Japan",13260072,15.0964035692593,16.0835268767392
"3349","Georgia",2006,40859032,10877200,"Japan",51736232,16.2021794133299,17.5256384564221
"3350","Georgia",2007,55610596,4567152,"Japan",60177748,15.3344003738555,17.8338843166032
"3351","Georgia",2008,100371160,2738440,"Japan",103109600,14.8228989731613,18.4243854729614
"3352","Georgia",2009,63966052,6817408,"Japan",70783460,15.734989898928,17.9738630630922
"3353","Georgia",2010,88934814,7949777,"Japan",96884591,15.8886544359226,18.3034142323745
"3354","Georgia",2011,191867188,8885893,"Japan",200753081,15.999975520992,19.0723139614704
"3355","Georgia",2012,328884590,8580785,"Japan",337465375,15.9650359591205,19.6112174569148
"3356","Georgia",2013,368265223,5788261,"Japan",374053484,15.5713424590133,19.724313951217
"3357","Georgia",2014,380021288,9909335,"Japan",389930623,16.1089878001192,19.7557378301682
"3358","Georgia",2015,134716878,10534979,"Japan",145251857,16.170211611863,18.7186859341993
"3359","Georgia",2016,174395374,9181404,"Japan",183576778,16.0326906920788,18.976835543858
"3360","Georgia",2017,163377424,11398400,"Japan",174775824,16.2489835526374,18.91157356683
"3361","Ghana",1962,21674000,7995000,"Japan",29669000,15.8943269042502,16.8916239434651
"3362","Ghana",1963,22543000,11023000,"Japan",33566000,16.2154945569455,16.9309351544363
"3363","Ghana",1964,18242000,13911000,"Japan",32153000,16.4481904520417,16.7192371857222
"3364","Ghana",1965,19452000,7935000,"Japan",27387000,15.8867939119426,16.7834604505058
"3365","Ghana",1966,18680000,16632000,"Japan",35312000,16.62683910852,16.742963990765
"3366","Ghana",1967,17714000,19274000,"Japan",36988000,16.7742675953934,16.6898658453517
"3367","Ghana",1968,16988000,33543000,"Japan",50531000,17.3283387557976,16.6480177704153
"3368","Ghana",1969,20350000,41738000,"Japan",62088000,17.5469225427969,16.8285914698529
"3369","Ghana",1970,25253000,32243000,"Japan",57496000,17.2888115233828,17.0444555185093
"3370","Ghana",1971,40443000,40662000,"Japan",81105000,17.5208045533463,17.5154041333413
"3371","Ghana",1972,16714000,46831000,"Japan",63545000,17.6620559347647,16.6317572495435
"3372","Ghana",1973,32048000,77925000,"Japan",109973000,18.1712573836177,17.2827453368877
"3373","Ghana",1974,45768000,77126000,"Japan",122894000,18.1609510060701,17.6390957149305
"3374","Ghana",1975,51343000,69844000,"Japan",121187000,18.0617747416242,17.7540391656697
"3375","Ghana",1976,44883000,80018000,"Japan",124901000,18.1977621673295,17.6195696618645
"3376","Ghana",1977,58181000,148796000,"Japan",206977000,18.8180867982815,17.8790693989207
"3377","Ghana",1978,40910000,105427000,"Japan",146337000,18.4735293282493,17.5268850899056
"3378","Ghana",1979,33230000,112149000,"Japan",145379000,18.5353389022612,17.3189636403308
"3379","Ghana",1980,27743000,123413000,"Japan",151156000,18.6310470123471,17.1384941140835
"3380","Ghana",1981,33318000,119603000,"Japan",152921000,18.5996884827783,17.3216083494518
"3381","Ghana",1982,22724000,77096000,"Japan",99820000,18.1605619565133,16.9389321926592
"3382","Ghana",1983,17026000,65221000,"Japan",82247000,17.9932920609279,16.6502521454261
"3383","Ghana",1984,30236712,64270435,"Japan",94507147,17.9786102856457,17.2245673732053
"3384","Ghana",1985,41580200,60386271,"Japan",101966471,17.9162723357437,17.5431346503874
"3385","Ghana",1986,33548871,66522555,"Japan",100071426,18.0130516210523,17.328513769549
"3386","Ghana",1987,54970395,66678524,"Japan",121648919,18.015393480029,17.8223053255487
"3387","Ghana",1988,55169219,68844722,"Japan",124013941,18.047364120796,17.8259157289041
"3388","Ghana",1989,60732702,63547404,"Japan",124280106,17.9672967050407,17.9219928588978
"3389","Ghana",1990,70237620,64819391,"Japan",135057011,17.9871153603852,18.0673946228902
"3390","Ghana",1991,76672748,63227045,"Japan",139899793,17.9622426947975,18.1550568968127
"3391","Ghana",1992,85694972,58132326,"Japan",143827298,17.8782324526393,18.2663047120686
"3392","Ghana",1993,74420432,50246416,"Japan",124666848,17.7324497789767,18.1252410857571
"3393","Ghana",1994,144302665,56919977,"Japan",201222642,17.8571569271099,18.787423492042
"3394","Ghana",1995,92535613,62200169,"Japan",154735782,17.9458682747475,18.3431041337925
"3395","Ghana",1996,98288092,63888438,"Japan",162176530,17.9726489640092,18.4034134384102
"3396","Ghana",1997,80350782,66641791,"Japan",146992573,18.014842431212,18.2019123825211
"3397","Ghana",1998,77831000,73478000,"Japan",151309000,18.1124965996501,18.170050367369
"3398","Ghana",1999,84691439,58630415,"Japan",143321854,17.8867641472029,18.2545250801338
"3399","Ghana",2000,40995385,43672284,"Japan",84667669,17.5922242254451,17.5289700573575
"3400","Ghana",2001,49258410,43727810,"Japan",92986220,17.5934948420985,17.7125906724256
"3401","Ghana",2002,46816407,61646497,"Japan",108462904,17.9369269651979,17.6617442763732
"3402","Ghana",2003,72170308,104317932,"Japan",176488240,18.4629538323265,18.0945392727406
"3403","Ghana",2004,149325525,94957773,"Japan",244283298,18.3689428560109,18.8216392123977
"3404","Ghana",2005,109231593,68251547,"Japan",177483140,18.0387106584391,18.5089808926189
"3405","Ghana",2006,112074286,71227087,"Japan",183301373,18.0813837394283,18.5346724772516
"3406","Ghana",2007,152521372,113252512,"Japan",265773884,18.5451305030969,18.8428152884547
"3407","Ghana",2008,176660843,54909465,"Japan",231570308,17.8211962959914,18.9897423111481
"3408","Ghana",2009,112169355,111556338,"Japan",223725693,18.5300402947994,18.5355203854043
"3409","Ghana",2010,134682918,125908056,"Japan",260590974,18.651062484259,18.7184338181941
"3410","Ghana",2011,182521880,175399673,"Japan",357921553,18.9825777735905,19.0223806142115
"3411","Ghana",2012,199292654,137753967,"Japan",337046621,18.7409798041307,19.1102849254972
"3412","Ghana",2013,123582099,100357873,"Japan",223939972,18.4242530855352,18.6324162624019
"3413","Ghana",2014,116787635,93916814,"Japan",210704449,18.3579199909815,18.5758677580283
"3414","Ghana",2015,104867738,121529353,"Japan",226397091,18.6156663800444,18.4682104760156
"3415","Ghana",2016,124417405,184645886,"Japan",309063291,19.0339504190255,18.6391526400582
"3416","Ghana",2017,161681877,156666041.5,"Japan",318347918.5,18.8696269735668,18.9011412403441
"3417","Guinea",1962,239000,13000,"Japan",252000,9.47270463644367,12.3842188309136
"3418","Guinea",1963,43000,1000,"Japan",44000,6.90775527898214,10.6689553946757
"3419","Guinea",1964,572000,15000,"Japan",587000,9.61580548008435,13.2568942703619
"3420","Guinea",1965,83000,75000,"Japan",158000,11.2252433925184,11.3265958867787
"3421","Guinea",1966,120000,34000,"Japan",154000,10.4341158035983,11.6952470217642
"3422","Guinea",1967,183000,110000,"Japan",293000,11.6082356447746,12.1172414318236
"3423","Guinea",1968,81000,18000,"Japan",99000,9.7981270368783,11.3022044336546
"3424","Guinea",1969,99000,4000,"Japan",103000,8.29404964010203,11.5028751291167
"3425","Guinea",1970,444000,0,"Japan",444000,0,13.0035798414144
"3426","Guinea",1971,119000,88000,"Japan",207000,11.3850920934603,11.6868787720937
"3427","Guinea",1972,424000,1000,"Japan",425000,6.90775527898214,12.9574887342141
"3428","Guinea",1973,2106000,205000,"Japan",2311000,12.2307652581205,14.5603009716761
"3429","Guinea",1974,753000,1251000,"Japan",2004000,14.039453789449,13.531820506782
"3430","Guinea",1975,2975000,479000,"Japan",3454000,13.0794558763931,14.9057545969619
"3431","Guinea",1976,1557000,127000,"Japan",1684000,11.7519423654407,14.2582714508161
"3432","Guinea",1977,9297000,3000,"Japan",9300000,8.00636756765025,16.045202325438
"3433","Guinea",1978,1864000,1592000,"Japan",3456000,14.2805016453865,14.4382352742277
"3434","Guinea",1979,2079000,50000,"Japan",2129000,10.8197782844103,14.5473975668402
"3435","Guinea",1980,3298000,46000,"Japan",3344000,10.7363966754712,15.0088267821017
"3436","Guinea",1981,3697000,43000,"Japan",3740000,10.6689553946757,15.1230322379188
"3437","Guinea",1982,4127000,109000,"Japan",4236000,11.5991031612113,15.2330613087347
"3438","Guinea",1983,3277000,218000,"Japan",3495000,12.2922503417712,15.002438927681
"3439","Guinea",1984,4243297,266890,"Japan",4510187,12.4945918674745,15.2608511193779
"3440","Guinea",1985,3828148,761376,"Japan",4589524,13.5428826015512,15.1578916932945
"3441","Guinea",1986,1530155,957606,"Japan",2487761,13.7721916988704,14.2408795954269
"3442","Guinea",1987,9570739,1924130,"Japan",11494869,14.4699844754928,16.0742209809285
"3443","Guinea",1988,9931577,1040387,"Japan",10971964,13.8551033172844,16.1112298350939
"3444","Guinea",1989,8517077,2702574,"Japan",11219651,14.8097152101743,15.9575837648244
"3445","Guinea",1990,18909683,6586731,"Japan",25496414,15.7005677287747,16.755184676877
"3446","Guinea",1991,23398893,1636571,"Japan",25035464,14.3081137572557,16.9681992715166
"3447","Guinea",1992,23216951,551943,"Japan",23768894,13.2212000590579,16.960393216396
"3448","Guinea",1993,20040212,3647342,"Japan",23687554,15.1095092411002,16.8132514129673
"3449","Guinea",1994,24075699,8096946,"Japan",32172645,15.9069975115093,16.9967135494949
"3450","Guinea",1995,23683826,13327217,"Japan",37011043,16.4053188931636,16.9803029258748
"3451","Guinea",1996,16012645,9795628,"Japan",25808273,16.0974467216496,16.5888892805716
"3452","Guinea",1997,20156643,5688134,"Japan",25844777,15.5538928085562,16.8190444694447
"3453","Guinea",1998,19367000,6316000,"Japan",25683000,15.6585966543577,16.7790811447099
"3454","Guinea",1999,17003640,3088503,"Japan",20092143,14.9431970654629,16.6489379967476
"3455","Guinea",2000,13248073,2915989,"Japan",16164062,14.8857195998128,16.3993626658577
"3456","Guinea",2001,16497623,7414070,"Japan",23911693,15.8188901042452,16.618726867887
"3457","Guinea",2002,20028081,510288,"Japan",20538369,13.1427305511965,16.8126458967617
"3458","Guinea",2003,15464575,1025404,"Japan",16489979,13.8405972392408,16.5540624823141
"3459","Guinea",2004,14350862,1217042,"Japan",15567904,14.011933882467,16.4793205680522
"3460","Guinea",2005,13740730,1045974,"Japan",14786704,13.8604590667015,16.4358749728959
"3461","Guinea",2006,47588287,625500,"Japan",48213787,13.3463066088891,17.6780972174925
"3462","Guinea",2007,9879595,280967,"Japan",10160562,12.5459925036971,16.105982076981
"3463","Guinea",2008,19548754,233896,"Japan",19782650,12.3626318511007,16.7884221083492
"3464","Guinea",2009,23944507,1345463,"Japan",25289970,14.1122487497,16.9912495026974
"3465","Guinea",2010,17749301,406704,"Japan",18156005,12.9158409271064,16.6918566928286
"3466","Guinea",2011,26067620,333369,"Japan",26400989,12.7170052635721,17.0762044890687
"3467","Guinea",2012,34095865,460794,"Japan",34556659,13.0407063674457,17.344686673904
"3468","Guinea",2013,28198592,194916,"Japan",28393508,12.1803239755074,17.1547826055838
"3469","Guinea",2014,30764484,289605,"Japan",31054089,12.576273204538,17.2418714657099
"3470","Guinea",2015,11303086,134967,"Japan",11438053,11.8127855830947,16.2405863437434
"3471","Guinea",2016,7478503,1118198,"Japan",8596701,13.9272290189843,15.8275431962314
"3472","Guinea",2017,0,0,"0",0,0,0
"3473","Gambia",1962,1698000,0,"Japan",1698000,0,14.3449616458534
"3474","Gambia",1963,1317000,0,"Japan",1317000,0,14.0908669807254
"3475","Gambia",1964,1873000,389000,"Japan",2262000,12.8713346226006,14.4430519814262
"3476","Gambia",1965,2141000,44000,"Japan",2185000,10.6919449129004,14.5767835675718
"3477","Gambia",1966,3226000,1000,"Japan",3227000,6.90775527898214,14.9867535376673
"3478","Gambia",1967,2644000,0,"Japan",2644000,0,14.7878034799537
"3479","Gambia",1968,3743000,0,"Japan",3743000,0,15.1353979868866
"3480","Gambia",1969,2023000,0,"Japan",2023000,0,14.5200921161499
"3481","Gambia",1970,2105000,0,"Japan",2105000,0,14.5598260250986
"3482","Gambia",1971,3501000,8000,"Japan",3509000,8.98719682066197,15.0685591999368
"3483","Gambia",1972,3942000,42000,"Japan",3984000,10.6454248972655,15.1871987666948
"3484","Gambia",1973,3428000,191000,"Japan",3619000,12.1600287070288,15.0474875586998
"3485","Gambia",1974,1543000,73000,"Japan",1616000,11.1982147201305,14.2492391313453
"3486","Gambia",1975,2192000,2000,"Japan",2194000,7.60090245954208,14.60032492705
"3487","Gambia",1976,4534000,0,"Japan",4534000,0,15.3271151100496
"3488","Gambia",1977,2848000,14000,"Japan",2862000,9.5468126085974,14.862127551514
"3489","Gambia",1978,1909000,35000,"Japan",1944000,10.4631033404715,14.4620901027079
"3490","Gambia",1979,3108000,10000,"Japan",3118000,9.21034037197618,14.9494899904697
"3491","Gambia",1980,4719000,31000,"Japan",4750000,10.3417424834673,15.3671074707085
"3492","Gambia",1981,3344000,0,"Japan",3344000,0,15.0226782531867
"3493","Gambia",1982,5856000,0,"Japan",5856000,0,15.5829773346233
"3494","Gambia",1983,4350000,0,"Japan",4350000,0,15.2856864030649
"3495","Gambia",1984,4320350,44797,"Japan",4365147,10.7098964518752,15.278846975457
"3496","Gambia",1985,5201478,1058131,"Japan",6259609,13.872014702261,15.464453373935
"3497","Gambia",1986,4316554,8027155,"Japan",12343709,15.8983407267566,15.277967956715
"3498","Gambia",1987,8098864,9689223,"Japan",17788087,16.0865247948934,15.9072343628936
"3499","Gambia",1988,9994288,40450801,"Japan",50445089,17.5155970034977,16.1175242877615
"3500","Gambia",1989,6754650,83892555,"Japan",90647205,18.2450474309089,15.7257417145626
"3501","Gambia",1990,7834238,57220395,"Japan",65054633,17.8624209487431,15.8740141731396
"3502","Gambia",1991,10568944,37211707,"Japan",47780651,17.4321339740354,16.1734304474629
"3503","Gambia",1992,10488140,32559517,"Japan",43047657,17.2985802648363,16.1657556529254
"3504","Gambia",1993,13254706,33744317,"Japan",46999023,17.3343225759193,16.39986321715
"3505","Gambia",1994,6370280,37147996,"Japan",43518276,17.4304203842006,15.6671539826263
"3506","Gambia",1995,5610203,18356060,"Japan",23966263,16.7254703231775,15.5400974622274
"3507","Gambia",1996,7240232,13539580,"Japan",20779812,16.4211278057649,15.7951638080474
"3508","Gambia",1997,6663856,8009199,"Japan",14673055,15.8961013140442,15.7122088539519
"3509","Gambia",1998,6354000,8907000,"Japan",15261000,16.002348042414,15.6645950938116
"3510","Gambia",1999,5292370,17161427,"Japan",22453797,16.6581748070748,15.4817767186285
"3511","Gambia",2000,6027608,3225957,"Japan",9253565,14.9867402083782,15.6118608067533
"3512","Gambia",2001,4843931,536829,"Japan",5380760,13.1934348870254,15.3932371391276
"3513","Gambia",2002,6029659,138866,"Japan",6168525,11.8412647183613,15.6122010165239
"3514","Gambia",2003,4862516,287169,"Japan",5149685,12.5678261716117,15.3970665573919
"3515","Gambia",2004,3211095,818932,"Japan",4030027,13.6157563313052,14.9821225584328
"3516","Gambia",2005,3655536,601789,"Japan",4257325,13.3076621645132,15.111753288841
"3517","Gambia",2006,4797009,769982,"Japan",5566991,13.5541224169333,15.383503156655
"3518","Gambia",2007,4396324,1222159,"Japan",5618483,14.0161295248158,15.2962792951564
"3519","Gambia",2008,3659037,281973,"Japan",3941010,12.5495666006556,15.1127105560027
"3520","Gambia",2009,4903207,2533,"Japan",4905740,7.83715965000168,15.4054000387917
"3521","Gambia",2010,3977172,13421,"Japan",3990593,9.50457592339781,15.1960815719345
"3522","Gambia",2011,4828916,0,"Japan",4828916,0,15.3901325697986
"3523","Gambia",2012,12787011,41751,"Japan",12828762,10.639478682088,16.3639404480416
"3524","Gambia",2013,1025500,2481,"Japan",1027981,7.8164169836918,13.8406908564946
"3525","Gambia",2014,3271479,20789,"Japan",3292268,9.94217927964711,15.0007527341975
"3526","Gambia",2015,872487,57650,"Japan",930137,10.9621455256972,13.6791030332343
"3527","Gambia",2016,1565978,0,"Japan",1565978,0,14.2640211069029
"3528","Gambia",2017,2749995.5,0,"Japan",2749995.5,0,14.8271098332778
"3529","Guinea Bissau",1962,0,0,"0",0,0,0
"3530","Guinea Bissau",1963,0,0,"0",0,0,0
"3531","Guinea Bissau",1964,0,0,"0",0,0,0
"3532","Guinea Bissau",1965,0,0,"0",0,0,0
"3533","Guinea Bissau",1966,0,0,"0",0,0,0
"3534","Guinea Bissau",1967,0,0,"0",0,0,0
"3535","Guinea Bissau",1968,0,0,"0",0,0,0
"3536","Guinea Bissau",1969,0,0,"0",0,0,0
"3537","Guinea Bissau",1970,0,0,"0",0,0,0
"3538","Guinea Bissau",1971,0,0,"0",0,0,0
"3539","Guinea Bissau",1972,0,0,"0",0,0,0
"3540","Guinea Bissau",1973,0,0,"0",0,0,0
"3541","Guinea Bissau",1974,0,0,"0",0,0,0
"3542","Guinea Bissau",1975,0,0,"0",0,0,0
"3543","Guinea Bissau",1976,0,0,"0",0,0,0
"3544","Guinea Bissau",1977,0,0,"0",0,0,0
"3545","Guinea Bissau",1978,0,0,"0",0,0,0
"3546","Guinea Bissau",1979,0,0,"0",0,0,0
"3547","Guinea Bissau",1980,0,0,"0",0,0,0
"3548","Guinea Bissau",1981,0,0,"0",0,0,0
"3549","Guinea Bissau",1982,0,0,"0",0,0,0
"3550","Guinea Bissau",1983,0,0,"0",0,0,0
"3551","Guinea Bissau",1984,0,0,"0",0,0,0
"3552","Guinea Bissau",1985,0,0,"0",0,0,0
"3553","Guinea Bissau",1986,0,0,"0",0,0,0
"3554","Guinea Bissau",1987,0,0,"0",0,0,0
"3555","Guinea Bissau",1988,0,0,"0",0,0,0
"3556","Guinea Bissau",1989,0,0,"0",0,0,0
"3557","Guinea Bissau",1990,0,0,"0",0,0,0
"3558","Guinea Bissau",1991,0,0,"0",0,0,0
"3559","Guinea Bissau",1992,0,0,"0",0,0,0
"3560","Guinea Bissau",1993,0,0,"0",0,0,0
"3561","Guinea Bissau",1994,0,0,"0",0,0,0
"3562","Guinea Bissau",1995,0,0,"0",0,0,0
"3563","Guinea Bissau",1996,0,0,"0",0,0,0
"3564","Guinea Bissau",1997,0,0,"0",0,0,0
"3565","Guinea Bissau",1998,0,0,"0",0,0,0
"3566","Guinea Bissau",1999,0,0,"0",0,0,0
"3567","Guinea Bissau",2000,0,0,"0",0,0,0
"3568","Guinea Bissau",2001,0,0,"0",0,0,0
"3569","Guinea Bissau",2002,0,0,"0",0,0,0
"3570","Guinea Bissau",2003,0,0,"0",0,0,0
"3571","Guinea Bissau",2004,0,0,"0",0,0,0
"3572","Guinea Bissau",2005,0,0,"0",0,0,0
"3573","Guinea Bissau",2006,0,0,"0",0,0,0
"3574","Guinea Bissau",2007,0,0,"0",0,0,0
"3575","Guinea Bissau",2008,0,0,"0",0,0,0
"3576","Guinea Bissau",2009,0,0,"0",0,0,0
"3577","Guinea Bissau",2010,0,0,"0",0,0,0
"3578","Guinea Bissau",2011,0,0,"0",0,0,0
"3579","Guinea Bissau",2012,0,0,"0",0,0,0
"3580","Guinea Bissau",2013,0,0,"0",0,0,0
"3581","Guinea Bissau",2014,0,0,"0",0,0,0
"3582","Guinea Bissau",2015,0,0,"0",0,0,0
"3583","Guinea Bissau",2016,0,0,"0",0,0,0
"3584","Guinea Bissau",2017,0,0,"0",0,0,0
"3585","Equatorial Guinea",1962,177000,0,"Japan",177000,0,12.083905011556
"3586","Equatorial Guinea",1963,364000,0,"Japan",364000,0,12.8049091466189
"3587","Equatorial Guinea",1964,668000,0,"Japan",668000,0,13.4120434525188
"3588","Equatorial Guinea",1965,1016000,0,"Japan",1016000,0,13.8313839071206
"3589","Equatorial Guinea",1966,1026000,0,"Japan",1026000,0,13.8411783047129
"3590","Equatorial Guinea",1967,1024000,128000,"Japan",1152000,11.7597855429018,13.8392270845816
"3591","Equatorial Guinea",1968,525000,0,"Japan",525000,0,13.1711535415738
"3592","Equatorial Guinea",1969,295000,1000,"Japan",296000,6.90775527898214,12.594730635322
"3593","Equatorial Guinea",1970,476000,0,"Japan",476000,0,13.0731731332136
"3594","Equatorial Guinea",1971,251000,0,"Japan",251000,0,12.4332082181139
"3595","Equatorial Guinea",1972,321000,8000,"Japan",329000,8.98719682066197,12.6791964021122
"3596","Equatorial Guinea",1973,1000,0,"Japan",1000,0,6.90775527898214
"3597","Equatorial Guinea",1974,3000,4000,"Japan",7000,8.29404964010203,8.00636756765025
"3598","Equatorial Guinea",1975,205000,1000,"Japan",206000,6.90775527898214,12.2307652581205
"3599","Equatorial Guinea",1976,0,0,"0",0,0,0
"3600","Equatorial Guinea",1977,19000,0,"Japan",19000,0,9.85219425814858
"3601","Equatorial Guinea",1978,1000,0,"Japan",1000,0,6.90775527898214
"3602","Equatorial Guinea",1979,0,10000,"Japan",10000,9.21034037197618,0
"3603","Equatorial Guinea",1980,22000,0,"Japan",22000,0,9.99879773234045
"3604","Equatorial Guinea",1981,17000,6000,"Japan",23000,8.69951474821019,9.74096862303835
"3605","Equatorial Guinea",1982,63000,38000,"Japan",101000,10.5453414387085,11.0508900053737
"3606","Equatorial Guinea",1983,484000,4000,"Japan",488000,8.29404964010203,13.0898401856988
"3607","Equatorial Guinea",1984,258292,362506,"Japan",620798,12.800796304864,12.461846006866
"3608","Equatorial Guinea",1985,367683,0,"Japan",367683,0,12.8149764328782
"3609","Equatorial Guinea",1986,62530,0,"Japan",62530,0,11.0434017205613
"3610","Equatorial Guinea",1987,202804,444818,"Japan",647622,13.0054204887256,12.2199952743705
"3611","Equatorial Guinea",1988,173275,8630,"Japan",181905,9.06299978407747,12.0626352067862
"3612","Equatorial Guinea",1989,376610,147550,"Japan",524160,11.9019223803711,12.8389654482249
"3613","Equatorial Guinea",1990,187734,12241,"Japan",199975,9.41254625207551,12.1427813462879
"3614","Equatorial Guinea",1991,116593,6095,"Japan",122688,8.71522404191537,11.6664445167911
"3615","Equatorial Guinea",1992,910146,0,"Japan",910146,0,13.7213603051844
"3616","Equatorial Guinea",1993,546770,6920687,"Japan",7467457,15.7500256001228,13.2117835176597
"3617","Equatorial Guinea",1994,358528,13192100,"Japan",13550628,16.3951287235446,12.7897620391797
"3618","Equatorial Guinea",1995,326681,14790326,"Japan",15117007,16.5094838763643,12.6967394385671
"3619","Equatorial Guinea",1996,1255927,13242840,"Japan",14498767,16.3989675869816,14.0433845033021
"3620","Equatorial Guinea",1997,3408681,31801478,"Japan",35210159,17.2750233246578,15.0418359709129
"3621","Equatorial Guinea",1998,3097000,35652000,"Japan",38749000,17.3893158042327,14.9459444589553
"3622","Equatorial Guinea",1999,567292,45108576,"Japan",45675868,17.6245829416063,13.2486294413291
"3623","Equatorial Guinea",2000,11492148,37796692,"Japan",49288840,17.4477321435328,16.2571745775226
"3624","Equatorial Guinea",2001,977988,13389584,"Japan",14367572,16.4099876492236,13.793252679003
"3625","Equatorial Guinea",2002,1429910,43255225,"Japan",44685135,17.5826285932939,14.1731220631925
"3626","Equatorial Guinea",2003,3609889,17396,"Japan",3627285,9.76399557371753,15.0991875819139
"3627","Equatorial Guinea",2004,7746017,43042174,"Japan",50788191,17.5776909836946,15.8626893337356
"3628","Equatorial Guinea",2005,5967170,204140563,"Japan",210107733,19.1343193488471,15.6017833361269
"3629","Equatorial Guinea",2006,16245778,294357317,"Japan",310603095,19.5003049512916,16.6033436175975
"3630","Equatorial Guinea",2007,7731289,524874621,"Japan",532605910,20.0786699748917,15.8607861595726
"3631","Equatorial Guinea",2008,10875127,1002923104,"Japan",1013798231,20.7261846769852,16.2019888130318
"3632","Equatorial Guinea",2009,11972426,691460210,"Japan",703432636,20.3543161658372,16.2981167303487
"3633","Equatorial Guinea",2010,25136396,323971997,"Japan",349108393,19.5961676410091,17.0398273936501
"3634","Equatorial Guinea",2011,8010996,1322915177,"Japan",1330926173,21.0031036058893,15.8963256558837
"3635","Equatorial Guinea",2012,5576253,2900835347,"Japan",2906411600,21.7882645831499,15.5340276034204
"3636","Equatorial Guinea",2013,9392699,2013085033,"Japan",2022477732,21.4229342246394,16.0554432433232
"3637","Equatorial Guinea",2014,9099481,854438831,"Japan",863538312,20.5659554734053,16.0237279368936
"3638","Equatorial Guinea",2015,9221082,208351101,"Japan",217572183,19.154735200196,16.0370029422266
"3639","Equatorial Guinea",2016,1281576,127048164,"Japan",128329740,18.6600768166225,14.0636011285291
"3640","Equatorial Guinea",2017,0,0,"0",0,0,0
"3641","Greece",1962,19810000,3e+06,"Japan",22810000,14.9141228466324,16.8016974186747
"3642","Greece",1963,13845000,5982000,"Japan",19827000,15.604265518172,16.4434347145872
"3643","Greece",1964,27034000,3858000,"Japan",30892000,15.1656594724478,17.1126058910259
"3644","Greece",1965,39051000,7231000,"Japan",46282000,15.7938878971571,17.4803790421167
"3645","Greece",1966,47298000,7407000,"Japan",54705000,15.8179360569954,17.6719785692701
"3646","Greece",1967,31891000,11225000,"Japan",43116000,16.2336539915926,17.277834396287
"3647","Greece",1968,66116000,6827000,"Japan",72943000,15.7363958964004,18.0069213330194
"3648","Greece",1969,110708000,8222000,"Japan",118930000,15.92232404644,18.522406662457
"3649","Greece",1970,249633000,13411000,"Japan",263044000,16.4115858236931,19.3355023972588
"3650","Greece",1971,221036000,14801000,"Japan",235837000,16.5102053040193,19.2138361421435
"3651","Greece",1972,178614000,22750000,"Japan",201364000,16.9400757033612,19.0007376107925
"3652","Greece",1973,243455000,15964000,"Japan",259419000,16.5858467451508,19.3104426784803
"3653","Greece",1974,242266000,37636000,"Japan",279902000,17.4434715971088,19.3055468540257
"3654","Greece",1975,443809000,39459000,"Japan",483268000,17.490772716119,19.9109048476623
"3655","Greece",1976,735675000,28148000,"Japan",763823000,17.1529868620686,20.4162990030828
"3656","Greece",1977,1036090000,38216000,"Japan",1074306000,17.4587648340519,20.7587198495974
"3657","Greece",1978,976427000,34095000,"Japan",1010522000,17.3446613039369,20.6994105487021
"3658","Greece",1979,915940000,75373000,"Japan",991313000,18.1379596786629,20.6354614183096
"3659","Greece",1980,1164321000,35599000,"Japan",1199920000,17.3878281055401,20.8754039214331
"3660","Greece",1981,424724000,36854000,"Japan",461578000,17.4224747188769,19.8669501041648
"3661","Greece",1982,633288000,37807000,"Japan",671095000,17.4480048286303,20.2664358529414
"3662","Greece",1983,641754000,28907000,"Japan",670661000,17.1795943382863,20.2797156106529
"3663","Greece",1984,790542149,68951042,"Japan",859493191,18.0489072744897,20.4882295326105
"3664","Greece",1985,577178580,57007381,"Japan",634185961,17.8586913086436,20.1736622739883
"3665","Greece",1986,625017593,66798984,"Japan",691816577,18.0171984288104,20.2532903561045
"3666","Greece",1987,491732944,63487848,"Japan",555220792,17.9663590754706,20.0134463303411
"3667","Greece",1988,636221115,122980843,"Japan",759201958,18.6275391532392,20.2710567259772
"3668","Greece",1989,969979288,162402489,"Japan",1132381777,18.9055883119291,20.6927852766564
"3669","Greece",1990,1062827338,136367608,"Japan",1199194946,18.7308647971654,20.7841984941386
"3670","Greece",1991,1304454615,95527263,"Japan",1399981878,18.3749222411501,20.9890508708281
"3671","Greece",1992,1361246320,103093637,"Japan",1464339957,18.4511482303028,21.0316665288102
"3672","Greece",1993,1349641498,89420338,"Japan",1439061836,18.308858708678,21.0231048370932
"3673","Greece",1994,745547543,105241717,"Japan",850789260,18.4717703290926,20.4296294634421
"3674","Greece",1995,622688872,96655324,"Japan",719344196,18.386661847461,20.2495575491193
"3675","Greece",1996,828692458,82885668,"Japan",911578126,18.232972722168,20.5353596647763
"3676","Greece",1997,897599397,67846310,"Japan",965445707,18.0327555580942,20.615234420941
"3677","Greece",1998,988742000,70382000,"Japan",1059124000,18.0694481066179,20.7119439859894
"3678","Greece",1999,1186482302,99785356,"Japan",1286267658,18.4185319970484,20.8942587175889
"3679","Greece",2000,1060519837,80136114,"Japan",1140655951,18.1992371718543,20.7820250371217
"3680","Greece",2001,783446757,66645617,"Japan",850092374,18.0148998409863,20.4792136621226
"3681","Greece",2002,860596934,70071246,"Japan",930668180,18.0650230824064,20.5731368157317
"3682","Greece",2003,1740701270,104256418,"Japan",1844957688,18.4623639802974,21.2775538977142
"3683","Greece",2004,1396016656,114508547,"Japan",1510525203,18.5561600244609,21.0568887724475
"3684","Greece",2005,1046993665,111291340,"Japan",1158285005,18.5276620054917,20.7691887181957
"3685","Greece",2006,1457531059,69586414,"Japan",1527117473,18.058079905101,21.1000097857389
"3686","Greece",2007,1530818868,51666053,"Japan",1582484921,17.7603115087255,21.1490686370213
"3687","Greece",2008,1215328622,92912655,"Japan",1308241277,18.3471704162505,20.9182803479502
"3688","Greece",2009,874597294,55791693,"Japan",930388987,17.8371355453014,20.5892741029525
"3689","Greece",2010,671450985,58138991,"Japan",729589976,17.8783470982832,20.3249515779648
"3690","Greece",2011,224447345,69159583,"Japan",293606928,18.0519271892644,19.2291516942071
"3691","Greece",2012,143921382,79597899,"Japan",223519281,18.1924982559939,18.7847777501174
"3692","Greece",2013,153096295,80954616,"Japan",234050911,18.2093992593158,18.8465776604657
"3693","Greece",2014,163694956,72402831,"Japan",236097787,18.0977559588014,18.9135152294048
"3694","Greece",2015,212198256,70339545,"Japan",282537801,18.068844716408,19.1730315654487
"3695","Greece",2016,172090898,105284913,"Japan",277375811,18.4721806904859,18.9635333719273
"3696","Greece",2017,167447807,102758661.5,"Japan",270206468.5,18.4478937046248,18.936182260672
"3697","Greenland",1962,0,0,"0",0,0,0
"3698","Greenland",1963,0,0,"0",0,0,0
"3699","Greenland",1964,0,0,"0",0,0,0
"3700","Greenland",1965,0,0,"0",0,0,0
"3701","Greenland",1966,0,0,"0",0,0,0
"3702","Greenland",1967,0,0,"0",0,0,0
"3703","Greenland",1968,0,0,"0",0,0,0
"3704","Greenland",1969,0,0,"0",0,0,0
"3705","Greenland",1970,503000,287000,"Japan",790000,12.5672374947418,13.1283454490819
"3706","Greenland",1971,461000,190000,"Japan",651000,12.1547793511426,13.0411533219788
"3707","Greenland",1972,833000,114000,"Japan",947000,11.6439537273766,13.632788921149
"3708","Greenland",1973,1072000,834000,"Japan",1906000,13.6339886813409,13.8850366206129
"3709","Greenland",1974,787000,627000,"Japan",1414000,13.3487018196151,13.5759835273995
"3710","Greenland",1975,612000,40000,"Japan",652000,10.5966347330961,13.3244875614945
"3711","Greenland",1976,467000,51000,"Japan",518000,10.8395809117065,13.054084536651
"3712","Greenland",1977,1385000,1902000,"Japan",3287000,14.4584165220875,14.1412106976036
"3713","Greenland",1978,404000,643000,"Japan",1047000,13.3739000032198,12.9091701569433
"3714","Greenland",1979,553000,390000,"Japan",943000,12.8739020181058,13.2231132805045
"3715","Greenland",1980,2476000,296000,"Japan",2772000,12.5981147333062,14.7221549127866
"3716","Greenland",1981,1696000,3574000,"Japan",5270000,15.0891959747015,14.343783095334
"3717","Greenland",1982,1146000,1054000,"Japan",2200000,13.8681030080834,13.9517881762568
"3718","Greenland",1983,1415000,2904000,"Japan",4319000,14.8815996549268,14.1626400890595
"3719","Greenland",1984,1565132,11913191,"Japan",13478323,16.2931568315582,14.2634807234475
"3720","Greenland",1985,9716173,26933552,"Japan",36649725,17.1088833536021,16.089302374627
"3721","Greenland",1986,15080941,52884891,"Japan",67965832,17.7836282416662,16.5289423191278
"3722","Greenland",1987,20207705,93186357,"Japan",113394062,18.3501118848204,16.8215745252869
"3723","Greenland",1988,17341832,114648115,"Japan",131989947,18.5573781257898,16.6686321754084
"3724","Greenland",1989,12651803,118864302,"Japan",131516105,18.5934930810893,16.3533102926257
"3725","Greenland",1990,16011984,121073070,"Japan",137085054,18.6119048055938,16.5888479998435
"3726","Greenland",1991,14465091,108815235,"Japan",123280326,18.5051619101567,16.4872487874199
"3727","Greenland",1992,13712570,88646663,"Japan",102359233,18.300168947362,16.433823488384
"3728","Greenland",1993,12378836,111880506,"Japan",124259342,18.5329419489907,16.3314987981832
"3729","Greenland",1994,12937809,89044306,"Japan",101982115,18.3046446240498,16.3756645127626
"3730","Greenland",1995,12620151,92011580,"Japan",104631731,18.3374249966576,16.3508053801405
"3731","Greenland",1996,10945439,105453681,"Japan",116399120,18.4737823718189,16.2084333977738
"3732","Greenland",1997,12622726,66410944,"Japan",79033670,18.0113724201426,16.3510093980905
"3733","Greenland",1998,2161000,74397000,"Japan",76558000,18.1249261764097,14.586081635489
"3734","Greenland",1999,12445548,90208078,"Japan",102653626,18.3176295375639,16.3368735265629
"3735","Greenland",2000,583625,85402839,"Japan",85986464,18.262889901766,13.2770139322732
"3736","Greenland",2001,433937,55680397,"Japan",56114334,17.8351387039938,12.9806546412553
"3737","Greenland",2002,375723,54842995,"Japan",55218718,17.819985024588,12.836607448746
"3738","Greenland",2003,7249552,63159685,"Japan",70409237,17.9611767600055,15.7964502318181
"3739","Greenland",2004,226247,59597647,"Japan",59823894,17.9031266513905,12.3293826018058
"3740","Greenland",2005,489041,62053885,"Japan",62542926,17.9435136784527,13.100201609523
"3741","Greenland",2006,5453677,56758794,"Japan",62212471,17.8543211626731,15.511800618045
"3742","Greenland",2007,6003052,57597251,"Japan",63600303,17.8689853988328,15.607778564532
"3743","Greenland",2008,424366,73769908,"Japan",74194274,18.1164614557403,12.9583515694119
"3744","Greenland",2009,629028,79982371,"Japan",80611399,18.1973168058548,13.3519310497951
"3745","Greenland",2010,133626,69784983,"Japan",69918609,18.0609294013195,11.8028001319289
"3746","Greenland",2011,222366,90057787,"Japan",90280153,18.3159621000286,12.3120799519737
"3747","Greenland",2012,152839,105935650,"Japan",106088489,18.4783423922597,11.9371403587496
"3748","Greenland",2013,3074,90118519,"Japan",90121593,18.3166362397493,8.03073492409854
"3749","Greenland",2014,6610,79562709,"Japan",79569319,18.1920560611441,8.79633893284573
"3750","Greenland",2015,13197,73929538,"Japan",73942735,18.1186230083592,9.48774481001683
"3751","Greenland",2016,77717,52969944,"Japan",53047661,17.785235216318,11.2608293026434
"3752","Greenland",2017,0,0,"0",0,0,0
"3753","Guatemala",1962,6219000,13666000,"Japan",19885000,16.4304215543229,15.643119680086
"3754","Guatemala",1963,8613000,18979000,"Japan",27592000,16.7588436627191,15.9687832477713
"3755","Guatemala",1964,11224000,22141000,"Japan",33365000,16.9129416513431,16.2335649007644
"3756","Guatemala",1965,15280000,24054000,"Japan",39334000,16.9958118608527,16.5420553417026
"3757","Guatemala",1966,15412000,22847000,"Japan",38259000,16.9443303756566,16.5506569847282
"3758","Guatemala",1967,22022000,18798000,"Japan",40820000,16.7492610391624,16.9075525116557
"3759","Guatemala",1968,22510000,27939000,"Japan",50449000,17.1455341201719,16.9294702128829
"3760","Guatemala",1969,25502000,24244000,"Japan",49746000,17.0036797220533,17.0542674384256
"3761","Guatemala",1970,29248000,22400000,"Japan",51648000,16.9245715168253,17.191321753236
"3762","Guatemala",1971,32161000,25668000,"Japan",57829000,17.0607556378525,17.286265096319
"3763","Guatemala",1972,28185000,34379000,"Japan",62564000,17.3529564708176,17.1543004794978
"3764","Guatemala",1973,43091000,35472000,"Japan",78563000,17.3842542108382,17.5788247165634
"3765","Guatemala",1974,63063000,41934000,"Japan",104997000,17.5516075116873,17.9596447846889
"3766","Guatemala",1975,64783000,46325000,"Japan",111108000,17.6511923301357,17.9865537812248
"3767","Guatemala",1976,92924000,85520000,"Japan",178444000,18.2642608246811,18.347292512723
"3768","Guatemala",1977,114399000,119075000,"Japan",233474000,18.5952641046512,18.555202895613
"3769","Guatemala",1978,112301000,85894000,"Japan",198195000,18.2686245358537,18.5366933243885
"3770","Guatemala",1979,124561000,125960000,"Japan",250521000,18.6514749541971,18.6403061137173
"3771","Guatemala",1980,128496000,70517000,"Japan",199013000,18.071364373466,18.6714083334104
"3772","Guatemala",1981,112646000,78352000,"Japan",190998000,18.1767220529242,18.5397607160008
"3773","Guatemala",1982,46867000,78980000,"Japan",125847000,18.1847052138228,17.662824361023
"3774","Guatemala",1983,43970000,55488000,"Japan",99458000,17.8316773391224,17.599018141157
"3775","Guatemala",1984,58709236,60455951,"Japan",119165187,17.9174255751755,17.8881076148404
"3776","Guatemala",1985,51031214,35492381,"Japan",86523595,17.3848286116932,17.7479480426847
"3777","Guatemala",1986,55431403,52044793,"Japan",107476196,17.7676153095965,17.830656832279
"3778","Guatemala",1987,97574828,24477260,"Japan",122052088,17.0132550812394,18.3961301082828
"3779","Guatemala",1988,107065066,30585766,"Japan",137650832,17.2360452953019,18.4889473010702
"3780","Guatemala",1989,102195461,40850998,"Japan",143046459,17.5254418098164,18.4423978218317
"3781","Guatemala",1990,89251215,43715576,"Japan",132966791,17.5932150267656,18.3069655919767
"3782","Guatemala",1991,120318168,42650282,"Japan",162968450,17.5685444438379,18.6056501919861
"3783","Guatemala",1992,154664696,32684295,"Japan",187348991,17.302405245269,18.8567700800619
"3784","Guatemala",1993,127546663,33040239,"Japan",160586902,17.3132367402471,18.6639928399206
"3785","Guatemala",1994,92944541,65632057,"Japan",158576598,17.9995748083327,18.3475135399068
"3786","Guatemala",1995,116788452,78565676,"Japan",195354128,18.1794454699097,18.5758747536074
"3787","Guatemala",1996,95311793,61828353,"Japan",157140146,17.9398726036254,18.3726641070336
"3788","Guatemala",1997,195455454,76576714,"Japan",272032168,18.153803593717,19.0908430546489
"3789","Guatemala",1998,221320000,84264000,"Japan",305584000,18.2494652854985,19.2151201759942
"3790","Guatemala",1999,171222126,78403398,"Japan",249625524,18.1773778262181,18.9584722539753
"3791","Guatemala",2000,141953990,78239379,"Japan",220193369,18.1752836465428,18.7710135489771
"3792","Guatemala",2001,263559128,64789556,"Japan",328348684,17.9866549754933,19.3897882954599
"3793","Guatemala",2002,188428954,65967890,"Japan",254396844,18.0046786664523,19.0542315919502
"3794","Guatemala",2003,227079304,60717493,"Japan",287796797,17.9217424023205,19.240809871263
"3795","Guatemala",2004,257242325,69637920,"Japan",326880245,18.0588198045262,19.3655290974423
"3796","Guatemala",2005,360587813,101581530,"Japan",462169343,18.436372285244,19.703246071712
"3797","Guatemala",2006,276044796,88326276,"Japan",364371072,18.296548197751,19.4360737148593
"3798","Guatemala",2007,357237390,89839494,"Japan",447076884,18.3135352361435,19.6939110767405
"3799","Guatemala",2008,329593392,135990381,"Japan",465583773,18.7280947132578,19.6133703072549
"3800","Guatemala",2009,256284484,125625030,"Japan",381909514,18.6488120755836,19.3617986510702
"3801","Guatemala",2010,250051763,163466227,"Japan",413517990,18.9121169642734,19.3371785063942
"3802","Guatemala",2011,280030739,274656063,"Japan",554686802,19.4310301928779,19.4504099372508
"3803","Guatemala",2012,244541958,224891007,"Japan",469432965,19.2311264294693,19.3148974595183
"3804","Guatemala",2013,235481665,237224853,"Japan",472706518,19.284518996159,19.2771436127635
"3805","Guatemala",2014,216158434,189783162,"Japan",405941596,19.0613927257685,19.1915221875163
"3806","Guatemala",2015,242437840,242373526,"Japan",484811366,19.3059905900233,19.3062559055868
"3807","Guatemala",2016,262082552,217346336,"Japan",479428888,19.197002657654,19.3841700960663
"3808","Guatemala",2017,0,0,"0",0,0,0
"3809","French Guiana",1962,0,0,"0",0,0,0
"3810","French Guiana",1963,0,0,"0",0,0,0
"3811","French Guiana",1964,0,0,"0",0,0,0
"3812","French Guiana",1965,30000,0,"Japan",30000,0,10.3089526606443
"3813","French Guiana",1966,88000,0,"Japan",88000,0,11.3850920934603
"3814","French Guiana",1967,70000,465000,"Japan",535000,13.0497926845695,11.1562505210315
"3815","French Guiana",1968,115000,515000,"Japan",630000,13.1519221796459,11.6526874073454
"3816","French Guiana",1969,113000,359000,"Japan",472000,12.7910776674704,11.6351430976945
"3817","French Guiana",1970,156000,1000,"Japan",157000,6.90775527898214,11.9576112862317
"3818","French Guiana",1971,272000,22000,"Japan",294000,9.99879773234045,12.5135573452781
"3819","French Guiana",1972,651000,289000,"Japan",940000,12.5741819670946,13.3862649211907
"3820","French Guiana",1973,427000,362000,"Japan",789000,12.7993994908079,12.9645392922108
"3821","French Guiana",1974,402000,57000,"Japan",459000,10.9508065468167,12.9042073676012
"3822","French Guiana",1975,1129000,56000,"Japan",1185000,10.9331069697173,13.9368428431318
"3823","French Guiana",1976,1576000,450000,"Japan",2026000,13.0170028617465,14.2704005494
"3824","French Guiana",1977,2772000,173000,"Japan",2945000,12.0610468734799,14.8350796392919
"3825","French Guiana",1978,5141000,832000,"Japan",5973000,13.6315877198033,15.4527581710376
"3826","French Guiana",1979,6971000,4389000,"Japan",11360000,15.2946119686704,15.7572692444685
"3827","French Guiana",1980,11112000,6456000,"Japan",17568000,15.6805204889319,16.2235361634163
"3828","French Guiana",1981,13403000,5389000,"Japan",18792000,15.4998703969156,16.4109891204606
"3829","French Guiana",1982,11676000,8670000,"Japan",20346000,15.9753793487567,16.2730460109561
"3830","French Guiana",1983,14506000,8660000,"Japan",23166000,15.9742252805386,16.4900729149055
"3831","French Guiana",1984,10637588,5105930,"Japan",15743518,15.4459131673281,16.17990432445
"3832","French Guiana",1985,7727343,4971498,"Japan",12698841,15.4192317611091,15.8602756357325
"3833","French Guiana",1986,10528497,4870014,"Japan",15398511,15.398607369798,16.1695961388798
"3834","French Guiana",1987,11830953,6782255,"Japan",18613208,15.729820200489,16.2862297906136
"3835","French Guiana",1988,15270659,5396314,"Japan",20666973,15.5012266858695,16.5414438327796
"3836","French Guiana",1989,14871113,2116590,"Japan",16987703,14.5653168610723,16.514931164324
"3837","French Guiana",1990,15667437,40199,"Japan",15707636,10.6015973986758,16.5670950400102
"3838","French Guiana",1991,19919254,160870,"Japan",20080124,11.9883518643844,16.8071973596203
"3839","French Guiana",1992,16583527,0,"Japan",16583527,0,16.6239204112245
"3840","French Guiana",1993,11391215,6347,"Japan",11397562,8.75573753930647,16.248353002254
"3841","French Guiana",1994,10517528,2126,"Japan",10519654,7.66199755890189,16.1685537566729
"3842","French Guiana",1995,10212118,9298,"Japan",10221416,9.13755460225053,16.13908561231
"3843","French Guiana",1996,0,0,"0",0,0,0
"3844","French Guiana",1997,0,0,"0",0,0,0
"3845","French Guiana",1998,0,0,"0",0,0,0
"3846","French Guiana",1999,0,0,"0",0,0,0
"3847","French Guiana",2000,0,0,"0",0,0,0
"3848","French Guiana",2001,0,0,"0",0,0,0
"3849","French Guiana",2002,0,0,"0",0,0,0
"3850","French Guiana",2003,0,0,"0",0,0,0
"3851","French Guiana",2004,0,0,"0",0,0,0
"3852","French Guiana",2005,0,0,"0",0,0,0
"3853","French Guiana",2006,0,0,"0",0,0,0
"3854","French Guiana",2007,0,0,"0",0,0,0
"3855","French Guiana",2008,0,0,"0",0,0,0
"3856","French Guiana",2009,0,0,"0",0,0,0
"3857","French Guiana",2010,0,0,"0",0,0,0
"3858","French Guiana",2011,0,0,"0",0,0,0
"3859","French Guiana",2012,0,0,"0",0,0,0
"3860","French Guiana",2013,0,0,"0",0,0,0
"3861","French Guiana",2014,0,0,"0",0,0,0
"3862","French Guiana",2015,0,0,"0",0,0,0
"3863","French Guiana",2016,0,0,"0",0,0,0
"3864","French Guiana",2017,0,0,"0",0,0,0
"3865","Guyana",1962,1627000,1903000,"Japan",3530000,14.4589421462783,14.3022483862012
"3866","Guyana",1963,1379000,1206000,"Japan",2585000,14.0028196562693,14.1368691567754
"3867","Guyana",1964,1390000,2660000,"Japan",4050000,14.7938366807579,14.1448143051069
"3868","Guyana",1965,2582000,1129000,"Japan",3711000,13.9368428431318,14.7640748503887
"3869","Guyana",1966,3818000,1524000,"Japan",5342000,14.2368490152287,15.1552372832678
"3870","Guyana",1967,3883000,1986000,"Japan",5869000,14.5016331235873,15.1721186087138
"3871","Guyana",1968,4179000,2398000,"Japan",6577000,14.6901456145696,15.2455825414301
"3872","Guyana",1969,5854000,4878000,"Japan",10732000,15.400245857758,15.582635746234
"3873","Guyana",1970,5513000,4389000,"Japan",9902000,15.2946119686704,15.5226194975718
"3874","Guyana",1971,5331000,6496000,"Japan",11827000,15.6866971608237,15.4890493958049
"3875","Guyana",1972,6055000,10426000,"Japan",16481000,16.1598132443102,15.6163949349693
"3876","Guyana",1973,5836000,14891000,"Japan",20727000,16.5162675615723,15.5795561886248
"3877","Guyana",1974,8315000,13788000,"Japan",22103000,16.4393092066189,15.9335716706092
"3878","Guyana",1975,14295000,17407000,"Japan",31702000,16.6723829821348,16.4754203837385
"3879","Guyana",1976,19129000,17745000,"Japan",36874000,16.6916143440627,16.7667160661348
"3880","Guyana",1977,10256000,21452000,"Japan",31708000,16.881328439085,16.1433734581426
"3881","Guyana",1978,13375000,20834000,"Japan",34209000,16.8520968255265,16.4088978507463
"3882","Guyana",1979,7509000,21747000,"Japan",29256000,16.8949863749511,15.831612859082
"3883","Guyana",1980,6180000,20412000,"Japan",26592000,16.831633521166,15.6368288294339
"3884","Guyana",1981,8815000,13360000,"Japan",22175000,16.4077757260728,15.9919653738141
"3885","Guyana",1982,3190000,18575000,"Japan",21765000,16.7373271485681,14.975531474761
"3886","Guyana",1983,2446000,14760000,"Japan",17206000,16.5074313771366,14.7099645952293
"3887","Guyana",1984,3933597,7238995,"Japan",11172592,15.7949929425719,15.1850648324194
"3888","Guyana",1985,6816474,11726139,"Japan",18542613,16.2773310104357,15.7348528873269
"3889","Guyana",1986,17297242,10252103,"Japan",27549345,16.1429934132358,16.6660576247937
"3890","Guyana",1987,8675593,7727589,"Japan",16403182,15.8603074702304,15.9760242388096
"3891","Guyana",1988,11247182,6403294,"Japan",17650476,15.6723231034237,16.2356281663482
"3892","Guyana",1989,9563256,8916676,"Japan",18479932,16.0034337893666,16.0734388128155
"3893","Guyana",1990,12747403,16020580,"Japan",28767983,16.5893847036932,16.3608381225473
"3894","Guyana",1991,14822567,16340312,"Japan",31162879,16.6091457414611,16.5116613747086
"3895","Guyana",1992,13968194,11397109,"Japan",25365303,16.2488702847125,16.452293445854
"3896","Guyana",1993,17699666,8917058,"Japan",26616724,16.0034766295256,16.6890563273095
"3897","Guyana",1994,16947926,10068029,"Japan",27015955,16.1248755156464,16.6456560244221
"3898","Guyana",1995,18486740,7294563,"Japan",25781303,15.8026398341008,16.7325642762989
"3899","Guyana",1996,20783823,8237718,"Japan",29021541,15.9242339217826,16.84968550169
"3900","Guyana",1997,17858080,6469209,"Japan",24327289,15.6825644024344,16.6979666248342
"3901","Guyana",1998,16878000,7067000,"Japan",23945000,15.770946619673,16.6415215567
"3902","Guyana",1999,13746479,5336054,"Japan",19082533,15.4899969864664,16.4362932765574
"3903","Guyana",2000,11942842,4406144,"Japan",16348986,15.2985104885158,16.2956426610562
"3904","Guyana",2001,12502768,3507874,"Japan",16010642,15.0705207139272,16.3414606177583
"3905","Guyana",2002,12282419,2863489,"Japan",15145908,14.8675513693559,16.3236794482546
"3906","Guyana",2003,14716205,2813861,"Japan",17530066,14.8500681195587,16.5044598255257
"3907","Guyana",2004,16204151,3024728,"Japan",19228879,14.9223317280489,16.600778001948
"3908","Guyana",2005,22116454,4145363,"Japan",26261817,15.2375009181091,16.9118324143537
"3909","Guyana",2006,28203702,4484627,"Japan",32688329,15.3161658839073,17.1549638038881
"3910","Guyana",2007,24718925,5417131,"Japan",30136056,15.5050768974748,17.0230797025532
"3911","Guyana",2008,27372330,7061413,"Japan",34433743,15.7701557310868,17.1250432070976
"3912","Guyana",2009,27921991,6673943,"Japan",34595934,15.7137213976517,17.1449251442042
"3913","Guyana",2010,42511737,7344968,"Japan",49856705,15.8095260108754,17.5652907604741
"3914","Guyana",2011,55152537,6547068,"Japan",61699605,15.6945278738058,17.825613304419
"3915","Guyana",2012,54512160,11846737,"Japan",66358897,16.2875630289775,17.8139343540121
"3916","Guyana",2013,44231544,4187399,"Japan",48418943,15.2475903354216,17.6049487576684
"3917","Guyana",2014,44752881,11075267,"Japan",55828148,16.220224981957,17.6166663805011
"3918","Guyana",2015,45354418,4951698,"Japan",50306116,15.4152411060265,17.6300181498465
"3919","Guyana",2016,42162241,3319609,"Japan",45481850,15.0153575628728,17.5570356154337
"3920","Guyana",2017,45849184,157161,"Japan",46006345,11.9650260365944,17.6408679593437
"3921","Honduras",1962,4189000,562000,"Japan",4751000,13.2392571288758,15.2479725999292
"3922","Honduras",1963,8695000,1708000,"Japan",10403000,14.3508336533307,15.9782587057705
"3923","Honduras",1964,5423000,4147000,"Japan",9570000,15.2378957392285,15.5061597258232
"3924","Honduras",1965,6634000,5546000,"Japan",12180000,15.5285875051579,15.7077184984891
"3925","Honduras",1966,5357000,4430000,"Japan",9787000,15.3039101420213,15.4939146748631
"3926","Honduras",1967,7392000,5140000,"Japan",12532000,15.4525636374313,15.8159088923037
"3927","Honduras",1968,9954000,10560000,"Japan",20514000,16.1725838362424,16.1134850384006
"3928","Honduras",1969,12002000,15865000,"Japan",27867000,16.5796259829994,16.3005838605316
"3929","Honduras",1970,17911000,4438000,"Japan",22349000,15.3057143824747,16.7009256072074
"3930","Honduras",1971,21779000,1133000,"Japan",22912000,13.9403795400101,16.8964567607327
"3931","Honduras",1972,15095000,5453000,"Japan",20548000,15.5116764739082,16.5298741211231
"3932","Honduras",1973,26602000,10445000,"Japan",37047000,16.1616339529728,17.0964969588954
"3933","Honduras",1974,26547000,11239000,"Japan",37786000,16.2349004305004,17.0944273049176
"3934","Honduras",1975,26609000,11082000,"Japan",37691000,16.2208327284094,17.0967600623905
"3935","Honduras",1976,39802000,14030000,"Japan",53832000,16.4567084520786,17.4994277202484
"3936","Honduras",1977,63510000,30100000,"Japan",93610000,17.2200357297191,17.9667079317792
"3937","Honduras",1978,52669000,14960000,"Japan",67629000,16.5208905305106,17.7795376051392
"3938","Honduras",1979,63973000,33376000,"Japan",97349000,17.3233476367826,17.9739716773097
"3939","Honduras",1980,99344000,34769000,"Japan",134113000,17.3642367431448,18.4140991325868
"3940","Honduras",1981,62974000,48002000,"Japan",110976000,17.6867532346708,17.9582325007597
"3941","Honduras",1982,35695000,48272000,"Japan",83967000,17.692362240381,17.3905211809187
"3942","Honduras",1983,36634000,45002000,"Japan",81636000,17.6222174911914,17.4164873289023
"3943","Honduras",1984,36760709,55563069,"Japan",92323778,17.8330293119059,17.4199401425345
"3944","Honduras",1985,46461390,44137905,"Japan",90599295,17.6028294950475,17.6541322030682
"3945","Honduras",1986,70341433,90359365,"Japan",160700798,18.3193052220936,18.0688715572791
"3946","Honduras",1987,64925550,56736428,"Japan",121661978,17.8539270315388,17.9887517867903
"3947","Honduras",1988,87556691,57169372,"Japan",144726063,17.8615288583976,18.287797038676
"3948","Honduras",1989,103222986,93818764,"Japan",197041750,18.3568754366145,18.4524021187687
"3949","Honduras",1990,60723848,76908314,"Japan",137632162,18.1581245430663,17.9218470619027
"3950","Honduras",1991,69770901,92634353,"Japan",162405254,18.3441706135407,18.0607275896919
"3951","Honduras",1992,82439976,74909955,"Japan",157349931,18.131797350203,18.2275810228657
"3952","Honduras",1993,71362481,66982273,"Japan",138344754,18.0199385602577,18.0832828130083
"3953","Honduras",1994,56816112,106714957,"Japan",163531069,18.4856718845173,17.8553305054388
"3954","Honduras",1995,62364437,112788591,"Japan",175153028,18.5410257482959,17.9485057510018
"3955","Honduras",1996,73326536,116586428,"Japan",189912964,18.5741434271642,18.1104331204434
"3956","Honduras",1997,108006141,122830424,"Japan",230836565,18.6263152954347,18.4976986445831
"3957","Honduras",1998,137057000,136103000,"Japan",273160000,18.7289225099945,18.7359074556583
"3958","Honduras",1999,93001725,129736275,"Japan",222738000,18.6810142940683,18.3481285993326
"3959","Honduras",2000,30024504,106446014,"Japan",136470518,18.4831485037929,17.2175244062268
"3960","Honduras",2001,83939532,46297745,"Japan",130237277,17.6506038137667,18.2456072404432
"3961","Honduras",2002,98718763,40820998,"Japan",139539761,17.5247071638467,18.4077855876539
"3962","Honduras",2003,109253365,27424073,"Japan",136677438,17.1269317622781,18.509180192381
"3963","Honduras",2004,76661193,43487214,"Japan",120148407,17.5879775218182,18.1549061800184
"3964","Honduras",2005,86922818,25195626,"Japan",112118444,17.0421809659878,18.2805311334436
"3965","Honduras",2006,130875340,25899389,"Japan",156774729,17.0697299356579,18.6897558250504
"3966","Honduras",2007,151126657,23774320,"Japan",174900977,16.9841165645146,18.8336288312725
"3967","Honduras",2008,129424534,31485170,"Japan",160909704,17.2650271992869,18.6786085202049
"3968","Honduras",2009,84982835,25319958,"Japan",110302793,17.0471034964711,18.2579598528853
"3969","Honduras",2010,87789704,29561237,"Japan",117350941,17.2019745002594,18.2904547852143
"3970","Honduras",2011,123660651,60938586,"Japan",184599237,17.925377128102,18.6330516865156
"3971","Honduras",2012,110916513,54921830,"Japan",165838343,17.8214214595034,18.5242883411459
"3972","Honduras",2013,67384770,40231253,"Japan",107616023,17.510154689352,18.025929585957
"3973","Honduras",2014,66133104,39972487,"Japan",106105591,17.5037019504181,18.007179996399
"3974","Honduras",2015,72067279,37591622,"Japan",109658901,17.4422917643833,18.0931106712274
"3975","Honduras",2016,76858099,23212559,"Japan",100070658,16.9602040263738,18.1574714095138
"3976","Honduras",2017,119644099.5,29449687,"Japan",149093786.5,17.198193839822,18.6000320564349
"3977","Croatia",1962,0,0,"0",0,0,0
"3978","Croatia",1963,0,0,"0",0,0,0
"3979","Croatia",1964,0,0,"0",0,0,0
"3980","Croatia",1965,0,0,"0",0,0,0
"3981","Croatia",1966,0,0,"0",0,0,0
"3982","Croatia",1967,0,0,"0",0,0,0
"3983","Croatia",1968,0,0,"0",0,0,0
"3984","Croatia",1969,0,0,"0",0,0,0
"3985","Croatia",1970,0,0,"0",0,0,0
"3986","Croatia",1971,0,0,"0",0,0,0
"3987","Croatia",1972,0,0,"0",0,0,0
"3988","Croatia",1973,0,0,"0",0,0,0
"3989","Croatia",1974,0,0,"0",0,0,0
"3990","Croatia",1975,0,0,"0",0,0,0
"3991","Croatia",1976,0,0,"0",0,0,0
"3992","Croatia",1977,0,0,"0",0,0,0
"3993","Croatia",1978,0,0,"0",0,0,0
"3994","Croatia",1979,0,0,"0",0,0,0
"3995","Croatia",1980,0,0,"0",0,0,0
"3996","Croatia",1981,0,0,"0",0,0,0
"3997","Croatia",1982,0,0,"0",0,0,0
"3998","Croatia",1983,0,0,"0",0,0,0
"3999","Croatia",1984,0,0,"0",0,0,0
"4000","Croatia",1985,0,0,"0",0,0,0
"4001","Croatia",1986,0,0,"0",0,0,0
"4002","Croatia",1987,0,0,"0",0,0,0
"4003","Croatia",1988,0,0,"0",0,0,0
"4004","Croatia",1989,0,0,"0",0,0,0
"4005","Croatia",1990,0,0,"0",0,0,0
"4006","Croatia",1991,0,0,"0",0,0,0
"4007","Croatia",1992,28518524,4248551,"Japan",32767075,15.2620885415905,17.1660643990154
"4008","Croatia",1993,44369914,1445996,"Japan",45815910,14.1843089154453,17.6080721851066
"4009","Croatia",1994,55135748,2854237,"Japan",57989985,14.8643151149167,17.8253088477828
"4010","Croatia",1995,77301861,2357785,"Japan",79659646,14.6732331769572,18.1632285883002
"4011","Croatia",1996,97979309,2952261,"Japan",100931570,14.8980818754283,18.4002668816901
"4012","Croatia",1997,131186525,11094352,"Japan",142280877,16.2219467079564,18.692130723407
"4013","Croatia",1998,20291000,11525000,"Japan",31816000,16.260029146847,16.8256879959498
"4014","Croatia",1999,123602387,9621775,"Japan",133224162,16.0795393170563,18.6325804150991
"4015","Croatia",2000,121249313,20088139,"Japan",141337452,16.8156400993496,18.6133594217864
"4016","Croatia",2001,128251248,25648728,"Japan",153899976,17.0600045377081,18.669501772962
"4017","Croatia",2002,146751913,52809041,"Japan",199560954,17.7821929650787,18.8042540523626
"4018","Croatia",2003,220430836,58792465,"Japan",279223301,17.8895242583989,19.2110945347125
"4019","Croatia",2004,251642534,59463139,"Japan",311105673,17.9008671659336,19.3435201225566
"4020","Croatia",2005,245783194,52189256,"Japan",297972450,17.7703872079135,19.319960380098
"4021","Croatia",2006,291474925,92744260,"Japan",384219185,18.3453563707443,19.4904645394716
"4022","Croatia",2007,338243871,87262428,"Japan",425506299,18.2844305501638,19.6392777051171
"4023","Croatia",2008,345217419,56530616,"Japan",401748035,17.850292925461,19.659684976503
"4024","Croatia",2009,222047437,102020402,"Japan",324067839,18.4406833708551,19.2184015971904
"4025","Croatia",2010,188438040,52803126,"Japan",241241166,17.7820809514694,19.0542798105533
"4026","Croatia",2011,40621797,98386943,"Japan",139008740,18.4044186601285,17.519815352429
"4027","Croatia",2012,31564981,91973188,"Japan",123538169,18.3370076577553,17.2675588678512
"4028","Croatia",2013,31567470,62211406,"Japan",93778876,17.9460489171038,17.26763771795
"4029","Croatia",2014,34127505,68648256,"Japan",102775761,18.0445062856312,17.3456142153687
"4030","Croatia",2015,32906182,64774411,"Japan",97680593,17.9864211913568,17.3091711008197
"4031","Croatia",2016,38087593,58252761,"Japan",96340354,17.8803020484284,17.4553991440191
"4032","Croatia",2017,35353190,51867258,"Japan",87220448,17.7641982820037,17.380899186688
"4033","Haiti",1962,216000,2666000,"Japan",2882000,14.7960897797208,12.2830336866663
"4034","Haiti",1963,134000,3752000,"Japan",3886000,15.1377995891083,11.805595078933
"4035","Haiti",1964,715000,2247000,"Japan",2962000,14.6251065511675,13.4800378216761
"4036","Haiti",1965,1476000,2474000,"Japan",3950000,14.7213468319346,14.2048462841426
"4037","Haiti",1966,1957000,3402000,"Japan",5359000,15.0398740519379,14.4869232463782
"4038","Haiti",1967,2440000,2497000,"Japan",4937000,14.7306005692619,14.7075085972694
"4039","Haiti",1968,2720000,2058000,"Japan",4778000,14.5372451953761,14.8161424382722
"4040","Haiti",1969,4212000,2481000,"Japan",6693000,14.7241722626739,15.253448152236
"4041","Haiti",1970,5734000,1849000,"Japan",7583000,14.4301555103693,15.5619239254255
"4042","Haiti",1971,5733000,1942000,"Japan",7675000,14.4792289278334,15.5617495118905
"4043","Haiti",1972,7830000,464000,"Japan",8294000,13.0476398312084,15.873473067967
"4044","Haiti",1973,6541000,657000,"Japan",7198000,13.3954392974667,15.6936006169433
"4045","Haiti",1974,6688000,785000,"Japan",7473000,13.5734389967645,15.7158254337467
"4046","Haiti",1975,9680000,305000,"Japan",9985000,12.6280670555895,16.0855724592528
"4047","Haiti",1976,11707000,1053000,"Japan",12760000,13.8671537911161,16.2756975114618
"4048","Haiti",1977,14604000,679000,"Japan",15283000,13.4283764065408,16.4968060217577
"4049","Haiti",1978,21818000,528000,"Japan",22346000,13.1768515626884,16.8982458751398
"4050","Haiti",1979,17094000,1151000,"Japan",18245000,13.956141687704,16.6542380827081
"4051","Haiti",1980,29061000,681000,"Japan",29742000,13.4313175851316,17.1849076270766
"4052","Haiti",1981,19467000,1241000,"Japan",20708000,14.0314280641867,16.7842312822714
"4053","Haiti",1982,25462000,3046000,"Japan",28508000,14.9293398124372,17.0526977026037
"4054","Haiti",1983,24995000,2081000,"Japan",27076000,14.5483591053758,17.0341863628298
"4055","Haiti",1984,29795026,1525381,"Japan",31320407,14.2377547728854,17.2098520247925
"4056","Haiti",1985,37180700,2372695,"Japan",39553395,14.6795369978695,17.4313003674069
"4057","Haiti",1986,27271558,2295350,"Japan",29566908,14.6463958952956,17.1213548855697
"4058","Haiti",1987,38011351,3210659,"Japan",41222010,14.981986769986,17.4533953836119
"4059","Haiti",1988,43127229,2563460,"Japan",45690689,14.7568684664173,17.5796651189366
"4060","Haiti",1989,31012989,4784908,"Japan",35797897,15.3809773559341,17.2499166746934
"4061","Haiti",1990,22410978,2750209,"Japan",25161187,14.8271874667549,16.9250614860565
"4062","Haiti",1991,20691723,1207477,"Japan",21899200,14.0040436167084,16.8452443231998
"4063","Haiti",1992,2376039,971975,"Japan",3348014,13.7870853629472,14.6809453734714
"4064","Haiti",1993,3225575,1881274,"Japan",5106849,14.447459764873,14.9866217868931
"4065","Haiti",1994,2664880,315321,"Japan",2980201,12.6613464465503,14.7956695864257
"4066","Haiti",1995,38057175,1036601,"Japan",39093776,13.8514576494295,17.4546001921694
"4067","Haiti",1996,22011826,739571,"Japan",22751397,13.5138255673424,16.9070904123513
"4068","Haiti",1997,40223241,631264,"Japan",40854505,13.3554794375436,17.5099555208623
"4069","Haiti",1998,38546000,505000,"Japan",39051000,13.1323137082575,17.4673628912411
"4070","Haiti",1999,33797336,230792,"Japan",34028128,12.3492721509703,17.335892540779
"4071","Haiti",2000,25755839,719873,"Japan",26475712,13.486830086545,17.06417191665
"4072","Haiti",2001,19959443,426858,"Japan",20386301,12.9642066842096,16.8092129226466
"4073","Haiti",2002,27723267,417355,"Japan",28140622,12.9416924575593,17.1377825824842
"4074","Haiti",2003,26364914,545289,"Japan",26910203,13.2090712083285,17.0875446690411
"4075","Haiti",2004,36647837,818478,"Japan",37466315,13.6152017969959,17.41686496682
"4076","Haiti",2005,24771094,1073620,"Japan",25844714,13.8865466739381,17.0251879668205
"4077","Haiti",2006,31438511,1340302,"Japan",32778813,14.1084055196687,17.2635441643529
"4078","Haiti",2007,38564138,825532,"Japan",39389670,13.6237833059762,17.467833335227
"4079","Haiti",2008,46997744,1488862,"Japan",48486606,14.2135226277203,17.6656101585223
"4080","Haiti",2009,50523673,958508,"Japan",51482181,13.7731331878075,17.7379525566834
"4081","Haiti",2010,65221896,1147902,"Japan",66369798,13.9534464863641,17.9933057987401
"4082","Haiti",2011,67292756,1890292,"Japan",69183048,14.4522418724568,18.0245631513774
"4083","Haiti",2012,54387813,3007220,"Japan",57395033,14.916526621915,17.8116506609934
"4084","Haiti",2013,43214423,3398727,"Japan",46613150,15.0389115077121,17.5816848632343
"4085","Haiti",2014,46572259,2419816,"Japan",48992075,14.6992020621844,17.656515621405
"4086","Haiti",2015,41473468,2907754,"Japan",44381222,14.8828915198344,17.5405644554442
"4087","Haiti",2016,37794288,4138801,"Japan",41933089,15.2359166903288,17.4476685380603
"4088","Haiti",2017,0,0,"0",0,0,0
"4089","Hungary",1962,1981000,249000,"Japan",2230000,12.4252081754468,14.4991123256807
"4090","Hungary",1963,2549000,405000,"Japan",2954000,12.9116423460887,14.7512116833583
"4091","Hungary",1964,4003000,637000,"Japan",4640000,13.3645249345543,15.2025546379747
"4092","Hungary",1965,2254000,430000,"Japan",2684000,12.9715404876697,14.6282169735819
"4093","Hungary",1966,2808000,677000,"Japan",3485000,13.4254265518944,14.8479830441278
"4094","Hungary",1967,3567000,1353000,"Japan",4920000,14.1178349071529,15.087235464341
"4095","Hungary",1968,3581000,2307000,"Japan",5888000,14.6514585371559,15.0911526489806
"4096","Hungary",1969,5169000,4976000,"Japan",10145000,15.4201369134012,15.4581898041782
"4097","Hungary",1970,11716000,4209000,"Japan",15925000,15.2527356477527,16.2764659869298
"4098","Hungary",1971,11087000,6935000,"Japan",18022000,15.7520916117311,16.2212838087545
"4099","Hungary",1972,11381000,9799000,"Japan",21180000,16.097790897618,16.247455856264
"4100","Hungary",1973,10505000,14744000,"Japan",25249000,16.5063467783318,16.1673618922612
"4101","Hungary",1974,24685000,29181000,"Japan",53866000,17.1890283705197,17.0217063296751
"4102","Hungary",1975,32381000,11052000,"Japan",43433000,16.2181219650254,17.2930823889982
"4103","Hungary",1976,33635000,12132000,"Japan",45767000,16.3113571477906,17.3310777494418
"4104","Hungary",1977,48694000,11681000,"Japan",60375000,16.2734741481378,17.7010663771772
"4105","Hungary",1978,53927000,17111000,"Japan",71038000,16.6552320895141,17.8031418381006
"4106","Hungary",1979,19000,23160000,"Japan",23179000,16.9579372106691,9.85219425814858
"4107","Hungary",1980,107266000,17452000,"Japan",124718000,16.6749648132256,18.4908222887947
"4108","Hungary",1981,96644000,24915000,"Japan",121559000,17.0309805896976,18.3865446820227
"4109","Hungary",1982,13000,21710000,"Japan",21723000,16.8932835418545,9.47270463644367
"4110","Hungary",1983,20000,33898000,"Japan",33918000,17.3388665735601,9.90348755253613
"4111","Hungary",1984,51008667,43216695,"Japan",94225362,17.5817374368919,17.7475061174267
"4112","Hungary",1985,83414802,47079226,"Japan",130494028,17.6673424001193,18.2393363335953
"4113","Hungary",1986,82271123,55305335,"Japan",137576458,17.8283799356187,18.2255307292282
"4114","Hungary",1987,91732501,88939035,"Japan",180671536,18.3034616929767,18.334387301913
"4115","Hungary",1988,101265499,148187257,"Japan",249452756,18.8139872819741,18.4332563287791
"4116","Hungary",1989,108890335,133928951,"Japan",242819286,18.7128200008828,18.5058518328167
"4117","Hungary",1990,142572246,133656505,"Japan",276228751,18.710783671269,18.7753594186709
"4118","Hungary",1991,277695385,137987170,"Japan",415682555,18.7426712677849,19.4420353334857
"4119","Hungary",1992,245238353,115377275,"Japan",360615628,18.5637179689027,19.317741164966
"4120","Hungary",1993,311087814,107755986,"Japan",418843800,18.4953798399294,19.555585790416
"4121","Hungary",1994,353716026,113952459,"Japan",467668485,18.5512918930633,19.6840049627337
"4122","Hungary",1995,305410540,120390787,"Japan",425801327,18.6062535679776,19.5371674622685
"4123","Hungary",1996,328427133,152540362,"Japan",480967495,18.8429397878456,19.6098255539322
"4124","Hungary",1997,893177900,283627328,"Japan",1176805228,19.4631717090517,20.6102963351253
"4125","Hungary",1998,994471000,302959000,"Japan",1297430000,19.5291080407866,20.717721495451
"4126","Hungary",1999,1029788033,277061480,"Japan",1306849513,19.439749988983,20.7526188248057
"4127","Hungary",2000,1541259544,377413632,"Japan",1918673176,19.7488523110731,21.1558658048
"4128","Hungary",2001,1393007255,371650607,"Japan",1764657862,19.7334647423913,21.0547307399143
"4129","Hungary",2002,1404773009,372950442,"Japan",1777723451,19.7369561055102,21.0631415672494
"4130","Hungary",2003,1810194767,409454828,"Japan",2219649595,19.8303371450385,21.3167002825124
"4131","Hungary",2004,1635308428,475391677,"Japan",2110700105,19.9796496053749,21.2150972644837
"4132","Hungary",2005,1994830348,537457850,"Japan",2532288198,20.1023608962865,21.4138248450758
"4133","Hungary",2006,2000038663,527667037,"Japan",2527705700,20.0839760310089,21.4164323488195
"4134","Hungary",2007,2323219022,560508574,"Japan",2883727596,20.1443550974157,21.5662195704056
"4135","Hungary",2008,2383986095,647832708,"Japan",3031818803,20.2891430543191,21.5920397534983
"4136","Hungary",2009,1644726832,584057930,"Japan",2228784762,20.1855107310785,21.2208401477999
"4137","Hungary",2010,1613503306,739925580,"Japan",2353428886,20.4220601715377,21.2016736184161
"4138","Hungary",2011,1674749961,843766226,"Japan",2518516187,20.5533860307809,21.2389297140656
"4139","Hungary",2012,1365046726,897274551,"Japan",2262321277,20.6148724501142,21.0344544964993
"4140","Hungary",2013,1311297005,855719654,"Japan",2167016659,20.5674533734545,20.9942825645061
"4141","Hungary",2014,1252021680,1019664032,"Japan",2271685712,20.7427390295928,20.9480254257683
"4142","Hungary",2015,1431673844,1241030844,"Japan",2672704688,20.9392081970099,21.0821101169732
"4143","Hungary",2016,1441198941,1216698692,"Japan",2657897633,20.9194070377181,21.0887412020336
"4144","Hungary",2017,1463708122.5,947496718,"Japan",2411204840.5,20.6693340310626,21.1042388627317
"4145","Indonesia",1962,117264000,122492000,"Japan",239756000,18.6235562796941,18.5799383611478
"4146","Indonesia",1963,99190000,139241000,"Japan",238431000,18.751716802726,18.4125477607222
"4147","Indonesia",1964,121713000,166153000,"Japan",287866000,18.9284196085754,18.6171763723022
"4148","Indonesia",1965,207545000,149399000,"Japan",356944000,18.8221311372002,19.1508587415926
"4149","Indonesia",1966,120170000,176116000,"Japan",296286000,18.9866534268065,18.6044179648875
"4150","Indonesia",1967,180299000,196911000,"Japan",377210000,19.0982624079707,19.0101271418465
"4151","Indonesia",1968,158576000,254075000,"Japan",412651000,19.3531400569881,18.8817445316286
"4152","Indonesia",1969,223401000,399400000,"Japan",622801000,19.805473978946,19.2244789208651
"4153","Indonesia",1970,316348000,636605000,"Japan",952953000,20.271659927007,19.5723534314256
"4154","Indonesia",1971,363147000,852733000,"Japan",1215880000,20.5639570435615,19.7103182689332
"4155","Indonesia",1972,531846000,1197519000,"Japan",1729365000,20.9035177535118,20.0918645317161
"4156","Indonesia",1973,712180000,2217791000,"Japan",2929971000,21.5197774923996,20.3838412464142
"4157","Indonesia",1974,1133745000,4564824000,"Japan",5698569000,22.2416457960332,20.8487921492406
"4158","Indonesia",1975,1477403000,3432416000,"Japan",4909819000,21.9565302233477,21.1135516536511
"4159","Indonesia",1976,1485419000,4093043000,"Japan",5578462000,22.132554540143,21.118962724285
"4160","Indonesia",1977,1689010000,4999551000,"Japan",6688561000,22.3326139453482,21.2474083954177
"4161","Indonesia",1978,2016390000,5248968000,"Japan",7265358000,22.3812973227987,21.424574620827
"4162","Indonesia",1979,2103369000,8797246000,"Japan",10900615000,22.8977045549046,21.4668061818984
"4163","Indonesia",1980,3413019000,13169700000,"Japan",16582719000,23.3011845733989,21.9508630738054
"4164","Indonesia",1981,3987904000,13308166000,"Japan",17296070000,23.3116436687249,22.1065316165396
"4165","Indonesia",1982,4278499000,12008107000,"Japan",16286606000,23.2088478419641,22.1768680840956
"4166","Indonesia",1983,3793061000,10433197000,"Japan",14226258000,23.0682585786464,22.0564391817806
"4167","Indonesia",1984,3103924683,10118717362,"Japan",13222642045,23.0376527498878,21.8559331744756
"4168","Indonesia",1985,2439440543,9107181614,"Japan",11546622157,22.9323291275755,21.6150345643058
"4169","Indonesia",1986,2915180635,6701592790,"Japan",9616773425,22.6256110649408,21.7931976222389
"4170","Indonesia",1987,3247954863,7670943887,"Japan",10918898750,22.7607055069444,21.9012913622897
"4171","Indonesia",1988,3056517687,8508080935,"Japan",11564598622,22.8642822470506,21.8405420941004
"4172","Indonesia",1989,3403821105,10043682956,"Japan",13447504061,23.0302097122318,21.9481644919287
"4173","Indonesia",1990,4795652212,11475605340,"Japan",16271257552,23.1634893444428,22.2909755552187
"4174","Indonesia",1991,5746984571,11563254135,"Japan",17310238706,23.1710981601445,22.4719411317633
"4175","Indonesia",1992,5414138486,11039816225,"Japan",16453954711,23.1247742313706,22.4122796070504
"4176","Indonesia",1993,5627325568,11237556083,"Japan",16864881651,23.1425272274325,22.4509001339076
"4177","Indonesia",1994,7046914312,11594339625,"Japan",18641253937,23.1737828526038,22.6758556717169
"4178","Indonesia",1995,8285538858,12790608918,"Japan",21076147776,23.2719770603171,22.837777525903
"4179","Indonesia",1996,7789088343,13677987275,"Japan",21467075618,23.3390536092958,22.7759896608407
"4180","Indonesia",1997,4019748472,9767646269,"Japan",13787394741,23.0023413598518,22.1144851684656
"4181","Indonesia",1998,4287076000,10779437000,"Japan",15066513000,23.1009061747183,22.17887075242
"4182","Indonesia",1999,2833788117,11336353796,"Japan",14170141913,23.1512805487984,21.7648802107763
"4183","Indonesia",2000,4947013306,14768987383,"Japan",19716000689,23.4157953721008,22.3220498588993
"4184","Indonesia",2001,4328226337,13325944487,"Japan",17654170824,23.3129786853119,22.1884236731029
"4185","Indonesia",2002,4107471129,12707606621,"Japan",16815077750,23.2654665976495,22.1360733790013
"4186","Indonesia",2003,3803689519,14799843840,"Japan",18603533359,23.4178824663095,22.0592373586876
"4187","Indonesia",2004,5793817463,16862373362,"Japan",22656190825,23.548350548415,22.4800572313099
"4188","Indonesia",2005,6641733427,18677951840,"Japan",25319685267,23.6506096191961,22.6166388246481
"4189","Indonesia",2006,5234204162,21752467722,"Japan",26986671884,23.8029930465279,22.3784806471717
"4190","Indonesia",2007,6170791841,23873636248,"Japan",30044428089,23.8960406011791,22.5430930039063
"4191","Indonesia",2008,13903212235,31002631139,"Japan",44905843374,24.1573379132815,23.3553857464276
"4192","Indonesia",2009,9159705374,20177924559,"Japan",29337629933,23.7278550001507,22.9380798507047
"4193","Indonesia",2010,15100972487,26067300144,"Japan",41168272631,23.9839474977338,23.4380249818061
"4194","Indonesia",2011,17222101338,32461586816,"Japan",49683688154,24.2033232831122,23.5694593574209
"4195","Indonesia",2012,19798496700,30987116097,"Japan",50785612797,24.1568373452677,23.7088718475221
"4196","Indonesia",2013,16465654836,28063513427,"Japan",44529168263,24.0577361150084,23.5245425233777
"4197","Indonesia",2014,14214347369,24887940553,"Japan",39102287922,23.9376492079581,23.3775176695638
"4198","Indonesia",2015,11088278980,19412277570,"Japan",30500556550,23.6891715672744,23.1291544396113
"4199","Indonesia",2016,10942719185,18005285922,"Japan",28948005107,23.6139312140656,23.1159401574433
"4200","Indonesia",2017,14506234580.5,19548633986,"Japan",34054868566.5,23.6961712480977,23.3978443650308
"4201","India",1962,81146000,93107000,"Japan",174253000,18.3492599273907,18.2117605592744
"4202","India",1963,84652000,125584000,"Japan",210236000,18.6484854153487,18.2540592929625
"4203","India",1964,147134000,141992000,"Japan",289126000,18.7712812759503,18.8068542941461
"4204","India",1965,172779000,183817000,"Japan",356596000,19.0294512554477,18.9675238791714
"4205","India",1966,144783000,205948000,"Japan",350731000,19.1431342677043,18.7907466277087
"4206","India",1967,137653000,258824000,"Japan",396477000,19.3716588519946,18.7402465837215
"4207","India",1968,166040000,293044000,"Japan",459084000,19.4958333263553,18.9277392811491
"4208","India",1969,90501000,321196000,"Japan",411697000,19.5875620866592,18.3208714583329
"4209","India",1970,96832000,390092000,"Japan",486924000,19.7818931667044,18.3884880761302
"4210","India",1971,199527000,376448000,"Japan",575975000,19.7462904814557,19.1114601234827
"4211","India",1972,207602000,407574000,"Japan",615176000,19.8257330692508,19.151133343121
"4212","India",1973,288371000,576783000,"Japan",865154000,20.1729766705464,19.4797584035341
"4213","India",1974,481867000,657923000,"Japan",1139790000,20.3045984611655,19.9931787003282
"4214","India",1975,506515000,657659000,"Japan",1164174000,20.3041971178763,20.0430644962194
"4215","India",1976,321495000,801102000,"Japan",1122597000,20.5014988377494,19.5884925494215
"4216","India",1977,472317000,800011000,"Japan",1272328000,20.5001360355377,19.9731609282901
"4217","India",1978,730310000,793144000,"Japan",1523454000,20.4915153520168,20.4089796594995
"4218","India",1979,753444000,1053007000,"Japan",1806451000,20.7749157177495,20.4401652534282
"4219","India",1980,914763000,1014332000,"Japan",1929095000,20.7374961047,20.6341755732958
"4220","India",1981,1197124000,1056721000,"Japan",2253845000,20.7784365544039,20.9031878504711
"4221","India",1982,1408171000,1122104000,"Japan",2530275000,20.8384713313734,21.0655575361716
"4222","India",1983,1430615000,1130806000,"Japan",2561421000,20.8461964897477,21.0813702586947
"4223","India",1984,1167785999,1033505257,"Japan",2201291256,20.7562220236721,20.8783754845314
"4224","India",1985,1597124883,1078159447,"Japan",2675284330,20.7985212085142,21.1914709016191
"4225","India",1986,1858548758,1171069714,"Japan",3029618472,20.8811834535218,21.3430617824933
"4226","India",1987,1535479098,1393016652,"Japan",2928495750,21.0547374857286,21.1521082852484
"4227","India",1988,1722386585,1652996227,"Japan",3375382812,21.2258553732661,21.2669767154332
"4228","India",1989,1661122882,1836186342,"Japan",3497309224,21.3309566174587,21.2307596455756
"4229","India",1990,1711168169,1889376297,"Japan",3600544466,21.3595126099682,21.2604421139933
"4230","India",1991,1524398911,2027054721,"Japan",3551453632,21.4298497001052,21.1448660125843
"4231","India",1992,1486490510,1851850149,"Japan",3338340659,21.3394510568298,21.1196838162583
"4232","India",1993,1366103944,2085644699,"Japan",3451748643,21.4583438525557,21.0352286889043
"4233","India",1994,1845566765,2434066762,"Japan",4279633527,21.6128292600592,21.3360522569677
"4234","India",1995,2219968764,2652583594,"Japan",4872552358,21.6987999431302,21.5207589624613
"4235","India",1996,1970420835,2582338592,"Japan",4552759427,21.6719612563272,21.4015129787098
"4236","India",1997,2235131307,1983006555,"Japan",4218137862,21.4078799920762,21.5275658136218
"4237","India",1998,1997599000,2168787000,"Japan",4166386000,21.4974338620326,21.415211796329
"4238","India",1999,2420350589,2033881944,"Japan",4454232533,21.4332120915904,21.6071782381097
"4239","India",2000,2001944452,2382774311,"Japan",4384718763,21.5915313226468,21.4173847712008
"4240","India",2001,1610341893,2005274146,"Japan",3615616039,21.4190466195302,21.1997123492991
"4241","India",2002,1933314114,1900421173,"Japan",3833735287,21.3653413685536,21.3825015247468
"4242","India",2003,2099063586,1988803380,"Japan",4087866966,21.4107989782366,21.4647571707992
"4243","India",2004,2682167275,2360555757,"Japan",5042723032,21.5821629185147,21.7098909893614
"4244","India",2005,3311177573,2895588946,"Japan",6206766519,21.7864543628597,21.9205697253027
"4245","India",2006,4267162162,3668965664,"Japan",7936127826,22.0231756238675,22.1742148441799
"4246","India",2007,5243737697,3805231724,"Japan",9048969421,22.0596427262743,22.3803003819553
"4247","India",2008,6984982647,4769259606,"Japan",11754242253,22.285456910931,22.6670283453287
"4248","India",2009,5780170555,3439221062,"Japan",9219391617,21.9585108472262,22.4776990269808
"4249","India",2010,7198797581,5132945265,"Japan",12331742846,22.358945457113,22.697179846383
"4250","India",2011,10804315445,4514056567,"Japan",15318372012,22.2304620467209,23.1032114695072
"4251","India",2012,10305832552,4318441169,"Japan",14624273721,22.1861603335746,23.0559758390977
"4252","India",2013,8285904311,4277901099,"Japan",12563805410,22.1767283288261,22.8378216322607
"4253","India",2014,7815011399,4223954989,"Japan",12038966388,22.1640377272803,22.779312259424
"4254","India",2015,7812143371,3570426174,"Japan",11382569545,21.9959508020837,22.778945202455
"4255","India",2016,7944093478,3890614725,"Japan",11834708203,22.0818330090841,22.7956945307399
"4256","India",2017,10059860601,5107203998.5,"Japan",15167064599.5,22.3539179286937,23.0318191447626
"4257","Ireland",1962,9989000,504000,"Japan",10493000,13.1303315470535,16.1169950455143
"4258","Ireland",1963,10138000,564000,"Japan",10702000,13.2428095304802,16.1318012980144
"4259","Ireland",1964,12854000,1501000,"Japan",14355000,14.2216421106156,16.3691656049134
"4260","Ireland",1965,10716000,1531000,"Japan",12247000,14.2414316746398,16.1872485096466
"4261","Ireland",1966,9878000,2420000,"Japan",12298000,14.6992780981329,16.1058206200827
"4262","Ireland",1967,11396000,4428000,"Japan",15824000,15.3034585728107,16.2487729745999
"4263","Ireland",1968,11585000,7131000,"Japan",18716000,15.7799620350104,16.2652217158486
"4264","Ireland",1969,14685000,7835000,"Japan",22520000,15.8741114337723,16.5023371226149
"4265","Ireland",1970,15342000,11044000,"Japan",26386000,16.2173978520322,16.5461047235014
"4266","Ireland",1971,22231000,13913000,"Japan",36144000,16.448334212824,16.9169982691841
"4267","Ireland",1972,26729000,17392000,"Japan",44121000,16.6715208883431,17.1012596762668
"4268","Ireland",1973,38979000,25709000,"Japan",64688000,17.0623516831142,17.478533597533
"4269","Ireland",1974,50840000,26907000,"Japan",77747000,17.1078970337682,17.7441940042855
"4270","Ireland",1975,66231000,34061000,"Japan",100292000,17.3436635927208,18.008659189245
"4271","Ireland",1976,92827000,56919000,"Japan",149746000,17.8571397625144,18.346248103715
"4272","Ireland",1977,122666000,57774000,"Japan",180440000,17.8720494054505,18.6249757726677
"4273","Ireland",1978,224631000,74771000,"Japan",299402000,18.1299406672347,19.2299696138966
"4274","Ireland",1979,261602000,100820000,"Japan",362422000,18.4288473066188,19.382334822778
"4275","Ireland",1980,281972000,78047000,"Japan",360019000,18.1728217672876,19.4573183331926
"4276","Ireland",1981,326157000,105980000,"Japan",432137000,18.4787609550289,19.6028894184933
"4277","Ireland",1982,284980000,184446000,"Japan",469426000,19.032867295678,19.4679295603319
"4278","Ireland",1983,303578000,261617000,"Japan",565195000,19.3823921601454,19.531149137092
"4279","Ireland",1984,297651965,220455212,"Japan",518107177,19.2112051120381,19.5114354592553
"4280","Ireland",1985,320654612,191912301,"Japan",512566913,19.0725490600179,19.5858751267397
"4281","Ireland",1986,399734364,256049016,"Japan",655783380,19.360879452866,19.8063107944668
"4282","Ireland",1987,535224905,347469916,"Japan",882694821,19.6661886465596,20.0981975997016
"4283","Ireland",1988,685989345,471345319,"Japan",1157334664,19.971101544708,20.3463726534996
"4284","Ireland",1989,930688260,604868550,"Japan",1535556810,20.2205217196607,20.651434934915
"4285","Ireland",1990,1064835204,586173703,"Japan",1651008907,20.1891267251188,20.7860858861065
"4286","Ireland",1991,937652700,765396749,"Japan",1703049449,20.4559048834945,20.6588901825453
"4287","Ireland",1992,1032984921,990630744,"Japan",2023615665,20.7138524133727,20.7557184296879
"4288","Ireland",1993,1292082673,1194772502,"Japan",2486855175,20.9012216293109,20.9795212286497
"4289","Ireland",1994,1111109878,1297559668,"Japan",2408669546,20.9837511588448,20.8286252428036
"4290","Ireland",1995,1532747036,1802786442,"Japan",3335533478,21.3125993282289,21.150327410826
"4291","Ireland",1996,1732680742,1917715268,"Japan",3650396010,21.3744003498327,21.2729356079736
"4292","Ireland",1997,2813818893,2024769842,"Japan",4838588735,21.4287218727737,21.7578084342924
"4293","Ireland",1998,3240350000,2173030000,"Japan",5413380000,21.4993883439238,21.8989471856078
"4294","Ireland",1999,2437651649,2683726265,"Japan",5121377914,21.7104720631498,21.6143009738754
"4295","Ireland",2000,2221431179,3347568138,"Japan",5568999317,21.9314999902142,21.521417500342
"4296","Ireland",2001,1617738364,3265750572,"Japan",4883488936,21.9067554574821,21.2042949391699
"4297","Ireland",2002,1695079791,2905558890,"Japan",4600638681,21.7898915977304,21.2509956510071
"4298","Ireland",2003,2331466855,3227038762,"Japan",5558505617,21.8948307617197,21.5697634579418
"4299","Ireland",2004,2487286565,3423412791,"Japan",5910699356,21.9539037825628,21.6344582203007
"4300","Ireland",2005,2329679043,3379589986,"Japan",5709269029,21.941020233166,21.5689963452502
"4301","Ireland",2006,1958452434,3134616745,"Japan",5093069179,21.8657727531594,21.3954204238209
"4302","Ireland",2007,1969429210,3640742570,"Japan",5610171780,22.0154535005366,21.4010095965965
"4303","Ireland",2008,1480885463,3692118047,"Japan",5173003510,22.0294661268028,21.1159060316316
"4304","Ireland",2009,797898366,4157965618,"Japan",4955863984,22.1482917574688,20.4974917864007
"4305","Ireland",2010,930728842,3848727155,"Japan",4779455997,22.071008321492,20.6514785382535
"4306","Ireland",2011,892341208,4144426439,"Japan",5036767647,22.1450302417733,20.6093591375815
"4307","Ireland",2012,879288673,4381864838,"Japan",5261153511,22.2007402328243,20.5946238124284
"4308","Ireland",2013,1042019913,3591311295,"Japan",4633331208,22.0017832359854,20.7644268904597
"4309","Ireland",2014,1659567158,3193961661,"Japan",4853528819,21.8845278832232,21.2298226571214
"4310","Ireland",2015,1103773622,7206788764,"Japan",8310562386,22.6982893026215,20.8220007112389
"4311","Ireland",2016,758957616,6190051746,"Japan",6949009362,22.5462092832203,20.4474564919035
"4312","Ireland",2017,1085131389,3846101039,"Japan",4931232428,22.0703257549588,20.8049669124599
"4313","Iran",1962,25322000,88723000,"Japan",114045000,18.3010297146818,17.0471841410623
"4314","Iran",1963,34597000,137634000,"Japan",172231000,18.7401085459643,17.3592775310665
"4315","Iran",1964,44247000,202382000,"Japan",246629000,19.1256675586165,17.6052981305097
"4316","Iran",1965,67369000,246957000,"Japan",314326000,19.3247247903682,18.0256955294246
"4317","Iran",1966,74357000,362180000,"Japan",436537000,19.7076518837775,18.1243883757326
"4318","Iran",1967,82391000,528836000,"Japan",611227000,20.0861889228532,18.2269867656134
"4319","Iran",1968,132362000,632497000,"Japan",764859000,20.2651860354717,18.7010511512088
"4320","Iran",1969,166603000,817646000,"Japan",984249000,20.521940038062,18.9311242947378
"4321","Iran",1970,203224000,995376000,"Japan",1198600000,20.7186311131879,19.1298193769304
"4322","Iran",1971,278412000,1361879000,"Japan",1640291000,21.032131200786,19.4446125889439
"4323","Iran",1972,363254000,1489668000,"Japan",1852922000,21.121819113284,19.710612872054
"4324","Iran",1973,537436000,1927445000,"Japan",2464881000,21.3794611286237,20.1023202411093
"4325","Iran",1974,993163000,4775795000,"Japan",5768958000,22.2868262891674,20.7164053575818
"4326","Iran",1975,1853290000,4974522000,"Japan",6827812000,22.3275951225389,21.3402282749725
"4327","Iran",1976,2200819000,4448074000,"Japan",6648893000,22.215737030447,21.5120954007617
"4328","Iran",1977,1926415000,4242936000,"Japan",6169351000,22.1685213193856,21.3789265995933
"4329","Iran",1978,2691089000,4243624000,"Japan",6934713000,22.1686834581089,21.7132117813513
"4330","Iran",1979,925386000,4271334000,"Japan",5196720000,22.1751920275744,20.6457215057297
"4331","Iran",1980,1529544000,4100950000,"Japan",5630494000,22.1344844911338,21.1482354887126
"4332","Iran",1981,1485521000,1920063000,"Japan",3405584000,21.3756238349478,21.1190313894213
"4333","Iran",1982,934889000,2566881000,"Japan",3501770000,21.665957380145,20.655938363628
"4334","Iran",1983,2819885000,4231434000,"Japan",7051319000,22.1658067796469,21.7599619409231
"4335","Iran",1984,1692122344,2623278765,"Japan",4315401109,21.6876908093477,21.249249402845
"4336","Iran",1985,1347685640,2297825182,"Japan",3645510822,21.5552289395018,21.0216546174923
"4337","Iran",1986,1144485218,1262229282,"Japan",2406714500,20.9561452660214,20.8582207815898
"4338","Iran",1987,1043201912,1442378355,"Japan",2485580267,21.0895592235012,20.7655605819571
"4339","Iran",1988,808403782,1039273878,"Japan",1847677660,20.7617881120178,20.5105722218598
"4340","Iran",1989,923785841,1654988391,"Japan",2578774232,21.2270598312493,20.6439908289327
"4341","Iran",1990,1603283045,3074332871,"Japan",4677615916,21.846353762147,21.1953192670392
"4342","Iran",1991,2473488597,2538350262,"Japan",5011838859,21.6547802038087,21.6288953785547
"4343","Iran",1992,2658408359,2381250816,"Japan",5039659175,21.5908917395164,21.7009934193723
"4344","Iran",1993,1459678300,2239790660,"Japan",3699468960,21.529648243089,21.1014819059219
"4345","Iran",1994,929144248,2499558825,"Japan",3428703073,21.6393800832479,20.6497745570605
"4346","Iran",1995,660596309,2558744629,"Japan",3219340938,21.6627825958658,20.3086534835605
"4347","Iran",1996,716246436,2969953206,"Japan",3686199642,21.8118120340813,20.3895348500646
"4348","Iran",1997,856223249,2191365293,"Japan",3047588542,21.5077906079896,20.5680417050089
"4349","Iran",1998,1000845000,2436098000,"Japan",3436943000,21.6136634158699,20.7241104801349
"4350","Iran",1999,567143505,2847385251,"Japan",3414528756,21.7696669543173,20.1561229249069
"4351","Iran",2000,573153670,4859043881,"Japan",5432197551,22.3041075231999,20.1666644237151
"4352","Iran",2001,798012162,4514398524,"Japan",5312410686,22.2305377976654,20.4976343958994
"4353","Iran",2002,668742748,4286991062,"Japan",4955733810,22.1788509396522,20.3209100120035
"4354","Iran",2003,871302898,6783291240,"Japan",7654594138,22.6377282547422,20.5855002332605
"4355","Iran",2004,917483934,7516708062,"Japan",8434191996,22.7403941213515,20.637145627113
"4356","Iran",2005,1086540687,9383946633,"Japan",10470487320,22.962266261261,20.8062648047277
"4357","Iran",2006,969185712,10187105522,"Japan",11156291234,23.0443885929968,20.6919668047427
"4358","Iran",2007,1316859749,11372597233,"Japan",12689456982,23.154472547207,20.9985157612502
"4359","Iran",2008,1862568017,16673989980,"Japan",18536557997,23.5371158559991,21.3452220267458
"4360","Iran",2009,1621809485,8374139556,"Japan",9995949041,22.8484141697974,21.2068083288976
"4361","Iran",2010,1407078164,10098833076,"Japan",11505911240,23.035685717089,21.0647811671959
"4362","Iran",2011,1684072090,12873439822,"Japan",14557511912,23.2784320972797,21.2444805606389
"4363","Iran",2012,650193548,7965682613,"Japan",8615876161,22.7984084782056,20.2927806426843
"4364","Iran",2013,167694414,6930959766,"Japan",7098654180,22.6592641349311,18.9376539167574
"4365","Iran",2014,250385916,6177215467,"Japan",6427601383,22.5441334351952,19.338513949602
"4366","Iran",2015,286851381,3251121084,"Japan",3537972465,21.9022657227299,19.4744748033635
"4367","Iran",2016,580603873,3316436124,"Japan",3897039997,21.9221565866811,20.1795792802181
"4368","Iran",2017,755283510.5,2004268325,"Japan",2759551835.5,21.4185449059165,20.4426037473229
"4369","Iraq",1962,14512000,33835000,"Japan",48347000,17.3370063276485,16.4904864513371
"4370","Iraq",1963,6810000,40975000,"Japan",47785000,17.5284726825942,15.7339026781257
"4371","Iraq",1964,17361000,48571000,"Japan",65932000,17.6985372029508,16.6697368692241
"4372","Iraq",1965,24300000,72312000,"Japan",96612000,18.0965006484604,17.0059869083108
"4373","Iraq",1966,28180000,67472000,"Japan",95652000,18.0272232549685,17.1541230644348
"4374","Iraq",1967,19613000,41973000,"Japan",61586000,17.5525371123835,16.7917031696436
"4375","Iraq",1968,41326000,26013000,"Japan",67339000,17.0741069710274,17.5370023998057
"4376","Iraq",1969,25161000,3556000,"Japan",28717000,15.0841468756159,17.0408057346347
"4377","Iraq",1970,15930000,182000,"Japan",16112000,12.1117619660589,16.5837146818862
"4378","Iraq",1971,24672000,2560000,"Japan",27232000,14.7555178164557,17.0211795553452
"4379","Iraq",1972,32167000,5514000,"Japan",37681000,15.5228008705659,17.2864516402817
"4380","Iraq",1973,60463000,3413000,"Japan",63876000,15.0431022278888,17.9175421656678
"4381","Iraq",1974,269820000,201542000,"Japan",471362000,19.1215083543557,19.4132656279749
"4382","Iraq",1975,764461000,396749000,"Japan",1161210000,19.7988143968887,20.4546815682977
"4383","Iraq",1976,518340000,578602000,"Japan",1096942000,20.1761254071198,20.0661419555631
"4384","Iraq",1977,872158000,735211000,"Japan",1607369000,20.4156680908089,20.5864811581204
"4385","Iraq",1978,951451000,776874000,"Japan",1728325000,20.4707887330201,20.6734987457391
"4386","Iraq",1979,1608820000,1815669000,"Japan",3424489000,21.3197198317901,21.1987668279715
"4387","Iraq",1980,2169483000,4339063000,"Japan",6508546000,22.1909242631318,21.4977547272651
"4388","Iraq",1981,3026032000,934066000,"Japan",3960098000,20.6550576575081,21.8305180272732
"4389","Iraq",1982,2755186000,779533000,"Japan",3534719000,20.474205580396,21.736750790884
"4390","Iraq",1983,631637000,141065000,"Japan",772702000,18.7647313350257,20.2638254200106
"4391","Iraq",1984,805996393,156364307,"Japan",962360700,18.8676991439177,20.5075898252748
"4392","Iraq",1985,1305766944,568279402,"Japan",1874046346,20.1581237606694,20.9900564016468
"4393","Iraq",1986,1210170364,873000660,"Japan",2083171024,20.5874468698173,20.9140269833384
"4394","Iraq",1987,390649573,625867285,"Japan",1016516858,20.2546489017958,19.7833214833564
"4395","Iraq",1988,405705571,740521592,"Japan",1146227163,20.4228653499236,19.8211382599039
"4396","Iraq",1989,492301916,1123004046,"Japan",1615305962,20.8392731155457,20.0146027366567
"4397","Iraq",1990,263106416,873666507,"Japan",1136772923,20.5882092898649,19.3880691318781
"4398","Iraq",1991,303878,185488,"Japan",489366,12.1307454689102,12.6243815840502
"4399","Iraq",1992,416017,1142157,"Japan",1558174,13.9484291378574,12.938481403793
"4400","Iraq",1993,622013,0,"Japan",622013,0,13.3407162718245
"4401","Iraq",1994,1153947,0,"Japan",1153947,0,13.9586987977858
"4402","Iraq",1995,303442,944478,"Japan",1247920,13.7583876729049,12.6229457674299
"4403","Iraq",1996,322826,3818,"Japan",326644,8.24748200428569,12.6848687573636
"4404","Iraq",1997,9565952,75040137,"Japan",84606089,18.1335336883535,16.0737206854385
"4405","Iraq",1998,8652000,83473000,"Japan",92125000,18.2400337842377,15.9733010660551
"4406","Iraq",1999,33620459,626638087,"Japan",660258546,20.2558797182291,17.3306453384393
"4407","Iraq",2000,43224665,599218316,"Japan",642442981,20.2111365571233,17.581921839359
"4408","Iraq",2001,191490626,123193293,"Japan",314683919,18.6292651676467,19.0703494149952
"4409","Iraq",2002,284249470,100458917,"Japan",384708387,18.425259415818,19.4653628260373
"4410","Iraq",2003,76544399,94216599,"Japan",170760998,18.3611069342145,18.1533815095269
"4411","Iraq",2004,70530800,1064800358,"Japan",1135331158,20.7860531612585,18.0715600518111
"4412","Iraq",2005,132703851,399008702,"Japan",531712553,19.8044937841401,18.703630519228
"4413","Iraq",2006,199610982,835708488,"Japan",1035319470,20.5437904116749,19.1118809403682
"4414","Iraq",2007,119668317,919177956,"Japan",1038846273,20.638990302488,18.6002344487757
"4415","Iraq",2008,197585126,1382476397,"Japan",1580061523,21.0471422185206,19.1016800671655
"4416","Iraq",2009,317732550,1268745730,"Japan",1586478280,20.9612946352315,19.5767205491379
"4417","Iraq",2010,307960708,3083582993,"Japan",3391543701,21.8493580672274,19.5454827613713
"4418","Iraq",2011,341100411,3728484923,"Japan",4069585334,22.0392678012226,19.6476874523134
"4419","Iraq",2012,354652257,2803686822,"Japan",3158339079,21.754201110152,19.686648309613
"4420","Iraq",2013,735346950,2569798193,"Japan",3305145143,21.6670932086458,20.4158529866172
"4421","Iraq",2014,577759033,1502214375,"Japan",2079973408,21.1302061064688,20.1746674417867
"4422","Iraq",2015,502656294,966526326,"Japan",1469182620,20.6892190947311,20.0354171823726
"4423","Iraq",2016,344210964,1078391174,"Japan",1422602138,20.7987361137416,19.6567652948079
"4424","Iraq",2017,0,0,"0",0,0,0
"4425","Iceland",1962,1876000,3000,"Japan",1879000,8.00636756765025,14.4446524085483
"4426","Iceland",1963,2841000,231000,"Japan",3072000,12.3501729895039,14.8596666608363
"4427","Iceland",1964,3708000,50000,"Japan",3758000,10.8197782844103,15.1260032056679
"4428","Iceland",1965,5014000,15000,"Japan",5029000,9.61580548008435,15.4277445577004
"4429","Iceland",1966,6124000,834000,"Japan",6958000,13.6339886813409,15.6277260357597
"4430","Iceland",1967,6071000,475000,"Japan",6546000,13.0710700830168,15.6190338941126
"4431","Iceland",1968,4646000,531000,"Japan",5177000,13.1825173002241,15.3515171923125
"4432","Iceland",1969,3185000,223000,"Japan",3408000,12.3149270504423,14.9739628469884
"4433","Iceland",1970,4434000,252000,"Japan",4686000,12.4371843664936,15.3048126691584
"4434","Iceland",1971,8162000,1205000,"Japan",9367000,14.0019901249069,15.9149997949479
"4435","Iceland",1972,9084000,2244000,"Japan",11328000,14.6237705456247,16.0220251822076
"4436","Iceland",1973,23011000,11589000,"Japan",34600000,16.2655669303165,16.9514829204327
"4437","Iceland",1974,13931000,19388000,"Japan",33319000,16.7801648759474,16.4496271306884
"4438","Iceland",1975,11275000,4699000,"Japan",15974000,15.362860278085,16.238098443353
"4439","Iceland",1976,19092000,9265000,"Japan",28357000,16.0417544177016,16.7647799571079
"4440","Iceland",1977,19327000,11079000,"Japan",30406000,16.2205619825028,16.7770136399676
"4441","Iceland",1978,22839000,16402000,"Japan",39241000,16.6129138365785,16.9439801589565
"4442","Iceland",1979,25723000,32792000,"Japan",58515000,17.3056951411663,17.0628960912782
"4443","Iceland",1980,40269000,18475000,"Japan",58744000,16.7319290247985,17.5110925001379
"4444","Iceland",1981,45969000,17836000,"Japan",63805000,16.6967294447295,17.6434778142284
"4445","Iceland",1982,44179000,25439000,"Japan",69618000,17.0517939874875,17.6037601210238
"4446","Iceland",1983,31979000,21427000,"Japan",53406000,16.8801623669829,17.2805899953377
"4447","Iceland",1984,35358748,31308925,"Japan",66667673,17.2594137586346,17.381056387867
"4448","Iceland",1985,36805723,42096060,"Japan",78901783,17.5554647075748,17.4211639073521
"4449","Iceland",1986,65701367,54095394,"Japan",119796761,17.80625960156,18.0006302899355
"4450","Iceland",1987,117550227,91836753,"Japan",209386980,18.3355231349454,18.5823762640416
"4451","Iceland",1988,103697017,119752905,"Japan",223449922,18.6009410528337,18.4569839071158
"4452","Iceland",1989,61825981,109035394,"Japan",170861375,18.507183103081,17.9398342386134
"4453","Iceland",1990,84332417,94149097,"Japan",178481514,18.3603902219434,18.250276892352
"4454","Iceland",1991,115420314,124020352,"Japan",239440666,18.6359562391339,18.5640909277424
"4455","Iceland",1992,87352985,128513166,"Japan",215866151,18.6715419161949,18.2854677668282
"4456","Iceland",1993,67323696,143178917,"Japan",210502613,18.7796055739981,18.0250228277406
"4457","Iceland",1994,53740867,192107198,"Japan",245848065,19.0735640971045,17.7996842942556
"4458","Iceland",1995,70751625,206212639,"Japan",276964264,19.144418422528,18.0746860624217
"4459","Iceland",1996,73736001,232493239,"Japan",306229240,19.264371702999,18.1160017182175
"4460","Iceland",1997,113420531,145970748,"Japan",259391279,18.7989168034342,18.5466129822532
"4461","Iceland",1998,91557000,161538000,"Japan",253095000,18.9002509670673,18.3324722871121
"4462","Iceland",1999,118620753,139614309,"Japan",258235062,18.7543942430398,18.5914420123567
"4463","Iceland",2000,117280984,138019919,"Japan",255300903,18.7429085732851,18.5800831862448
"4464","Iceland",2001,29949605,96122119,"Japan",126071724,18.3811300139495,17.215026693791
"4465","Iceland",2002,35282317,89670108,"Japan",124952425,18.3116480273437,17.3788924615496
"4466","Iceland",2003,97269528,104480764,"Japan",201750292,18.4645135358699,18.3929963223614
"4467","Iceland",2004,90704245,111540134,"Japan",202244379,18.5298950302877,18.3231147166362
"4468","Iceland",2005,237107667,124428713,"Japan",361536380,18.6392435235335,19.2840248870797
"4469","Iceland",2006,231211684,115518157,"Japan",346729841,18.5649382790342,19.2588442298178
"4470","Iceland",2007,284964179,114697517,"Japan",399661696,18.5578089340885,19.4678740426143
"4471","Iceland",2008,206940608,127351689,"Japan",334292297,18.6624630219637,19.1479423921864
"4472","Iceland",2009,16243829,113719503,"Japan",129963332,18.5492454743541,16.6032236407691
"4473","Iceland",2010,65838502,134699159,"Japan",200537661,18.718554397857,18.0027153619479
"4474","Iceland",2011,36454646,176368042,"Japan",212822688,18.9880835173236,17.4115794705734
"4475","Iceland",2012,34783703,166801152,"Japan",201584855,18.9323129543399,17.3646595304582
"4476","Iceland",2013,32151347,162269301,"Japan",194420648,18.904767864871,17.2859649051264
"4477","Iceland",2014,39104757,158753315,"Japan",197858072,18.8828620774088,17.4817546799594
"4478","Iceland",2015,52770202,154465109,"Japan",207235311,18.855478797083,17.7814572333071
"4479","Iceland",2016,67386440,160062815,"Japan",227449255,18.8910768899033,18.0259543686981
"4480","Iceland",2017,117693848,135387589,"Japan",253081437,18.7236522524983,18.5835973023853
"4481","Israel",1962,5998000,5188000,"Japan",11186000,15.4618588244185,15.6069366382911
"4482","Israel",1963,9058000,6099000,"Japan",15157000,15.6236353812786,16.0191589030983
"4483","Israel",1964,7161000,15006000,"Japan",22167000,16.5239606790878,15.7841601939891
"4484","Israel",1965,18195000,25014000,"Japan",43209000,17.034946226091,16.7166573890284
"4485","Israel",1966,20705000,12154000,"Japan",32859000,16.3131688916774,16.8458857749618
"4486","Israel",1967,19297000,15635000,"Japan",34932000,16.5650225488741,16.7754602013785
"4487","Israel",1968,12612000,17723000,"Japan",30335000,16.6903737890373,16.3501592996471
"4488","Israel",1969,18956000,19659000,"Japan",38615000,16.7940458066897,16.7576310620696
"4489","Israel",1970,62111000,27826000,"Japan",89937000,17.141481393384,17.9444336648728
"4490","Israel",1971,57881000,40979000,"Japan",98860000,17.5285702983299,17.8738997367034
"4491","Israel",1972,47269000,58642000,"Japan",105911000,17.8869617213731,17.671365247479
"4492","Israel",1973,59280000,79894000,"Japan",139174000,18.1962113140495,17.8977825389521
"4493","Israel",1974,130486000,65490000,"Japan",195976000,17.9974080171942,18.6867764992787
"4494","Israel",1975,88767000,89064000,"Japan",177831000,18.3048657703907,18.3015255172723
"4495","Israel",1976,106859000,79939000,"Japan",186798000,18.1967744017872,18.4870207664116
"4496","Israel",1977,125396000,97258000,"Japan",222654000,18.3928777992903,18.6469872877277
"4497","Israel",1978,123479000,173027000,"Japan",296506000,18.9689582096487,18.631581659088
"4498","Israel",1979,169691000,201564000,"Japan",371255000,19.1216175067871,18.9494896940308
"4499","Israel",1980,120370000,227014000,"Japan",347384000,19.2405222475527,18.6060808903559
"4500","Israel",1981,127560000,203619000,"Japan",331179000,19.1317611585223,18.6640974001061
"4501","Israel",1982,186212000,186292000,"Japan",372504000,19.0428258931576,19.042396367562
"4502","Israel",1983,273612000,188133000,"Japan",461745000,19.0526597174802,19.4272216024
"4503","Israel",1984,181400062,174656244,"Japan",356056306,18.978330280081,19.0162154374314
"4504","Israel",1985,179652970,198398816,"Japan",378051786,19.1057897850553,19.006537603533
"4505","Israel",1986,294573513,295809773,"Japan",590383286,19.5052271469109,19.5010391496005
"4506","Israel",1987,382309771,452776161,"Japan",835085932,19.9309084354991,19.761741756802
"4507","Israel",1988,431148101,638736135,"Japan",1069884236,20.2750019927887,19.8819622108533
"4508","Israel",1989,322317907,718296713,"Japan",1040614620,20.3923932909521,19.5910489052795
"4509","Israel",1990,496731704,810932922,"Japan",1307664626,20.5136958984247,20.0235606073138
"4510","Israel",1991,663659313,678211171,"Japan",1341870484,20.3349692590625,20.3132794929373
"4511","Israel",1992,904815198,640126705,"Japan",1544941903,20.2771766912857,20.6232412797073
"4512","Israel",1993,946565936,744658637,"Japan",1691224573,20.4284364659665,20.6683511891561
"4513","Israel",1994,869090172,902875589,"Japan",1771965761,20.6210953266956,20.5829574430938
"4514","Israel",1995,841584772,1191286945,"Japan",2032871717,20.8983000260929,20.5507973056776
"4515","Israel",1996,992424450,1145658971,"Japan",2138083421,20.8592458289282,20.7156614467215
"4516","Israel",1997,885364265,710854971,"Japan",1596219236,20.381978988058,20.6015097171587
"4517","Israel",1998,970119000,776258000,"Japan",1746377000,20.469995497117,20.6929293023494
"4518","Israel",1999,990869517,818220679,"Japan",1809090196,20.5226426369119,20.7140934156132
"4519","Israel",2000,1068204770,836240257,"Japan",1904445027,20.5444265185167,20.7892452913159
"4520","Israel",2001,910252798,753943171,"Japan",1664195969,20.4408275531052,20.6292329188959
"4521","Israel",2002,701215123,682915245,"Japan",1384130368,20.3418813175949,20.368325278092
"4522","Israel",2003,759369609,634096426,"Japan",1393466035,20.2677115923194,20.4479991852087
"4523","Israel",2004,1074341808,717565315,"Japan",1791907123,20.3913745328138,20.7949740393833
"4524","Israel",2005,1112719678,756376636,"Japan",1869096314,20.4440500058527,20.8300730158821
"4525","Israel",2006,1164150616,752633932,"Japan",1916784548,20.4390895214745,20.8752575730738
"4526","Israel",2007,1679680844,752588032,"Japan",2432268876,20.4390285337915,21.2418696385047
"4527","Israel",2008,2166475238,789090852,"Japan",2955566090,20.4863920204701,21.4963673695843
"4528","Israel",2009,1357098570,702246157,"Japan",2059344727,20.3697945515235,21.0286148533336
"4529","Israel",2010,1588415211,713474145,"Japan",2301889356,20.385656757364,21.1860026334787
"4530","Israel",2011,2170354835,1012620334,"Japan",3182975169,20.7358071982781,21.4981565095643
"4531","Israel",2012,1422255777,1105258276,"Japan",2527514053,20.8233448785413,21.0755100234606
"4532","Israel",2013,1095912963,1468402434,"Japan",2564315397,21.1074408671721,20.8148536089977
"4533","Israel",2014,1096698511,1655445007,"Japan",2752143518,21.2273356960368,20.81557015002
"4534","Israel",2015,1160782564,1467800859,"Japan",2628583423,21.1070311033047,20.872360238746
"4535","Israel",2016,1964195603,1263254239,"Japan",3227449842,20.956956957761,21.398348636115
"4536","Israel",2017,2011093131,982013832.5,"Japan",2993106963.5,20.7051159522684,21.4219442574553
"4537","Italy",1962,47764000,28866000,"Japan",76630000,17.1781749899096,17.6817827756354
"4538","Italy",1963,90608000,47405000,"Japan",138013000,17.6742382663342,18.3220530673357
"4539","Italy",1964,67743000,42098000,"Japan",109841000,17.5555107915859,18.0312316913529
"4540","Italy",1965,48802000,38276000,"Japan",87078000,17.4603336258813,17.7032818535901
"4541","Italy",1966,71485000,46351000,"Japan",117836000,17.6517534247164,18.0849981954454
"4542","Italy",1967,68296000,54781000,"Japan",123077000,17.8188539764701,18.0393617576723
"4543","Italy",1968,84904000,74977000,"Japan",159881000,18.1326919578021,18.2570317644238
"4544","Italy",1969,118242000,85081000,"Japan",203323000,18.2591143018709,18.5882439297708
"4545","Italy",1970,222499000,134435000,"Japan",356934000,18.7165913688175,19.2204331651784
"4546","Italy",1971,199834000,141136000,"Japan",340970000,18.7652345224807,19.1129975798716
"4547","Italy",1972,248113000,156704000,"Japan",404817000,18.8698692334842,19.3293948455158
"4548","Italy",1973,366838000,294476000,"Japan",661314000,19.5007080636774,19.720430891672
"4549","Italy",1974,438931000,460649000,"Japan",899580000,19.9481469226713,19.8998527832875
"4550","Italy",1975,454527000,365441000,"Japan",819968000,19.7166154014154,19.9347678757579
"4551","Italy",1976,586437000,383109000,"Japan",969546000,19.7638301019556,20.1895758034084
"4552","Italy",1977,626139000,466284000,"Japan",1092423000,19.9603054485156,20.2550829491445
"4553","Italy",1978,677752000,655957000,"Japan",1333709000,20.3016057959795,20.3342919972793
"4554","Italy",1979,885159000,992664000,"Japan",1877823000,20.7159027961698,20.601277847852
"4555","Italy",1980,1299245000,938463000,"Japan",2237708000,20.6597539885999,20.9850491634714
"4556","Italy",1981,1261148000,855824000,"Japan",2116972000,20.5675753054893,20.9552882542111
"4557","Italy",1982,1096031000,941947000,"Japan",2037978000,20.6634595676882,20.8149613097438
"4558","Italy",1983,1112207000,980473000,"Japan",2092680000,20.7035456662506,20.82961216653
"4559","Italy",1984,1219078069,947765522,"Japan",2166843591,20.6696176899633,20.9213607288731
"4560","Italy",1985,1345555319,948995374,"Japan",2294550693,20.6709144819575,21.0200726413701
"4561","Italy",1986,1888001878,1356479910,"Japan",3244481788,21.0281588797803,21.3587848993726
"4562","Italy",1987,2418486599,1943689353,"Japan",4362175952,21.3878537323761,21.6064078091741
"4563","Italy",1988,3157460755,2625690753,"Japan",5783151508,21.6886098423737,21.8730339829747
"4564","Italy",1989,3212707830,3462888102,"Japan",6675595932,21.9653687893988,21.8903799792386
"4565","Italy",1990,3823770740,4573043668,"Japan",8396814408,22.2434448306692,22.0645028774094
"4566","Italy",1991,4028312805,4113691302,"Japan",8142004107,22.1375865893871,22.116613466434
"4567","Italy",1992,4026133136,3751573835,"Japan",7777706971,22.0454412782171,22.1160722326684
"4568","Italy",1993,3432098383,3447176624,"Japan",6879275007,21.9608213630872,21.9564376845365
"4569","Italy",1994,3566880338,4443238906,"Japan",8010119244,22.2146494307802,21.9949571958022
"4570","Italy",1995,4036458591,5719591691,"Japan",9756050282,22.4671632570979,22.1186335581068
"4571","Italy",1996,3626485537,6069417257,"Japan",9695902794,22.52652843362,22.011529844617
"4572","Italy",1997,4258537123,4601552963,"Japan",8860090086,22.2496596841194,22.1721915398962
"4573","Italy",1998,4730097000,5091055000,"Japan",9821152000,22.3507509151868,22.2772115466396
"4574","Italy",1999,4932304334,4525172522,"Japan",9457476856,22.2329215397803,22.3190721263464
"4575","Italy",2000,5321168968,4769283004,"Japan",10090451972,22.2854618169216,22.3949588469897
"4576","Italy",2001,5069341971,4840378280,"Japan",9909720251,22.3002587116456,22.3464768573688
"4577","Italy",2002,4505289188,4872461596,"Japan",9377750784,22.3068651075294,22.2285179186213
"4578","Italy",2003,5361429329,5496982442,"Japan",10858411771,22.427465131714,22.4024964423383
"4579","Italy",2004,6167458106,6202860490,"Japan",12370318596,22.5482763919542,22.542552613641
"4580","Italy",2005,5553478276,6161802510,"Japan",11715280786,22.5416351869481,22.4376902847964
"4581","Italy",2006,6141338243,6315554750,"Japan",12456892993,22.5662814352881,22.5383085102427
"4582","Italy",2007,6529392343,6507919894,"Japan",13037312237,22.5962857173768,22.5995797197026
"4583","Italy",2008,6557671667,7127057766,"Japan",13684729433,22.6871643306669,22.6039014480893
"4584","Italy",2009,4843142013,5725714699,"Japan",10568856712,22.4682332168483,22.3008295232909
"4585","Italy",2010,5067213723,6096361235,"Japan",11163574958,22.5309579112851,22.3460569419467
"4586","Italy",2011,5275481918,8618355166,"Japan",13893837084,22.877160087405,22.3863358709981
"4587","Italy",2012,3588739724,9438881965,"Japan",13027621689,22.9681033741787,22.0010669260029
"4588","Italy",2013,3195164049,9485007930,"Japan",12680171979,22.97297827639,21.8849042689977
"4589","Italy",2014,3432397247,8551214473,"Japan",11983611720,22.8693391534336,21.9565247598342
"4590","Italy",2015,3519495016,7491584543,"Japan",11011079559,22.7370461665737,21.9815833549012
"4591","Italy",2016,4624551124,8735328363,"Japan",13359879487,22.8906413714687,22.2546451489305
"4592","Italy",2017,4904958814,9494699228,"Japan",14399658042,22.9739995038264,22.3135125331905
"4593","Jamaica",1962,7690000,456000,"Japan",8146000,13.0302480884965,15.8554313414818
"4594","Jamaica",1963,8217000,471000,"Japan",8688000,13.0626133729986,15.9217157369133
"4595","Jamaica",1964,9312000,664000,"Japan",9976000,13.4060374284586,16.0468144489534
"4596","Jamaica",1965,8098000,422000,"Japan",8520000,12.9527605930181,15.9071276755742
"4597","Jamaica",1966,4684000,506000,"Japan",5190000,13.1342919482696,15.3596630036997
"4598","Jamaica",1967,8419000,1106000,"Japan",9525000,13.9162604610644,15.9460016143198
"4599","Jamaica",1968,9554000,923000,"Japan",10477000,13.735384513485,16.072470472932
"4600","Jamaica",1969,9020000,882000,"Japan",9902000,13.6899473349889,16.0149548920388
"4601","Jamaica",1970,12490000,1148000,"Japan",13638000,13.9535318558616,16.3404388821018
"4602","Jamaica",1971,12115000,1892000,"Japan",14007000,14.453145028594,16.3099549122328
"4603","Jamaica",1972,13061000,2151000,"Japan",15212000,14.5814434082499,16.3851412485597
"4604","Jamaica",1973,17724000,2842000,"Japan",20566000,14.8600185876392,16.6904302113015
"4605","Jamaica",1974,29281000,6967000,"Japan",36248000,15.7566952740123,17.1924493994796
"4606","Jamaica",1975,42426000,3385000,"Japan",45811000,15.0348644643285,17.5632719398144
"4607","Jamaica",1976,28963000,5195000,"Japan",34158000,15.4632071825155,17.1815297112768
"4608","Jamaica",1977,13564000,5163000,"Japan",18727000,15.4570283638618,16.4229297822277
"4609","Jamaica",1978,20064000,6125000,"Japan",26189000,15.6278893143951,16.8144377224148
"4610","Jamaica",1979,29791000,5413000,"Japan",35204000,15.5043140257791,17.2097168924376
"4611","Jamaica",1980,23863000,6639000,"Japan",30502000,15.7084719077013,16.9878397001754
"4612","Jamaica",1981,43053000,6699000,"Japan",49752000,15.7174688194904,17.5779424728212
"4613","Jamaica",1982,52976000,9187000,"Japan",62163000,16.0332999992536,17.7853495387692
"4614","Jamaica",1983,40841000,14557000,"Japan",55398000,16.4935825355468,17.5251970367592
"4615","Jamaica",1984,46748710,8569613,"Japan",55318323,15.9637331320281,17.6602972197354
"4616","Jamaica",1985,59283236,7079038,"Japan",66362274,15.7726485807317,17.8978371258563
"4617","Jamaica",1986,38017685,9364984,"Japan",47382669,16.0524881853698,17.453562004165
"4618","Jamaica",1987,48296613,10513865,"Japan",58810478,16.1682054202563,17.6928719919404
"4619","Jamaica",1988,45340955,14658965,"Japan",59999920,16.5005626516576,17.6297212659008
"4620","Jamaica",1989,67611618,12678496,"Japan",80290114,16.355417887951,18.0292903901516
"4621","Jamaica",1990,88462979,11006722,"Japan",99469701,16.2140167350317,18.2980947060753
"4622","Jamaica",1991,115119257,14926633,"Japan",130045890,16.518657624993,18.5614791663877
"4623","Jamaica",1992,79343993,18029930,"Japan",97373923,16.7075437127538,18.1893032994876
"4624","Jamaica",1993,166990505,23845716,"Japan",190836221,16.987115136523,18.9334475124772
"4625","Jamaica",1994,120904892,21385172,"Japan",142290064,16.8782083426316,18.6105147779591
"4626","Jamaica",1995,168673038,32255829,"Japan",200928867,17.2892093290598,18.9434727125737
"4627","Jamaica",1996,147325910,37025118,"Japan",184351028,17.4271071051488,18.8081577654891
"4628","Jamaica",1997,181468942,25724289,"Japan",207193231,17.0629462008185,19.0165950785694
"4629","Jamaica",1998,143053000,27944000,"Japan",170997000,17.1457130654688,18.7787257489287
"4630","Jamaica",1999,162095995,28593172,"Japan",190689167,17.1686785060281,18.9036992794297
"4631","Jamaica",2000,172097144,30345178,"Japan",202442322,17.2281481831107,18.9635696660412
"4632","Jamaica",2001,169306927,29662700,"Japan",198969627,17.2054009222234,18.9472237618009
"4633","Jamaica",2002,192617544,30629218,"Japan",223246762,17.2374649479574,19.0762171435225
"4634","Jamaica",2003,158511859,29789501,"Japan",188301360,17.2096665739617,18.881339968672
"4635","Jamaica",2004,155386569,32612970,"Japan",187999539,17.3002206199752,18.8614265635912
"4636","Jamaica",2005,191653541,21611782,"Japan",213265323,16.8887491869065,19.0711998260094
"4637","Jamaica",2006,191189452,27659400,"Japan",218848852,17.1354761919916,19.0687753896958
"4638","Jamaica",2007,205033757,25165585,"Japan",230199342,17.040987944495,19.138685191839
"4639","Jamaica",2008,175940479,26047589,"Japan",201988068,17.0754357690973,18.9856563083041
"4640","Jamaica",2009,105765210,30378967,"Japan",136144177,17.2292610519205,18.4767321953354
"4641","Jamaica",2010,108215009,16857072,"Japan",125072081,16.640280829976,18.4996306300985
"4642","Jamaica",2011,141765029,20120406,"Japan",161885435,16.8172450819187,18.7696815196433
"4643","Jamaica",2012,174492422,19078695,"Japan",193571117,16.7640828254189,18.9773918717297
"4644","Jamaica",2013,143119367,18002086,"Japan",161121453,16.7059981980347,18.779189574293
"4645","Jamaica",2014,135478346,14352372,"Japan",149830718,16.4794257826772,18.7243223773953
"4646","Jamaica",2015,164822184,21659035,"Japan",186481219,16.8909332463747,18.9203777780308
"4647","Jamaica",2016,211174807,25341997,"Japan",236516804,17.0479735379604,19.1681968176435
"4648","Jamaica",2017,309853248,13901762,"Japan",323755010,16.4475261526572,19.551609349809
"4649","Jordan",1962,6156000,234000,"Japan",6390000,12.3630763943398,15.6329377739409
"4650","Jordan",1963,5636000,41000,"Japan",5677000,10.6213273456864,15.5446851520007
"4651","Jordan",1964,6426000,536000,"Japan",6962000,13.1918894400529,15.6758628186579
"4652","Jordan",1965,7101000,662000,"Japan",7763000,13.4030208349191,15.7757461771642
"4653","Jordan",1966,8010000,177000,"Japan",8187000,12.083905011556,15.8962013190445
"4654","Jordan",1967,5695000,164000,"Japan",5859000,12.0076217068063,15.5550991548634
"4655","Jordan",1968,8113000,508000,"Japan",8621000,13.1382367265606,15.9089782713772
"4656","Jordan",1969,14017000,167000,"Japan",14184000,12.0257490913989,16.4557814366452
"4657","Jordan",1970,10858000,140000,"Japan",10998000,11.8493977015914,16.2004126934475
"4658","Jordan",1971,11732000,926000,"Japan",12658000,13.7386295136283,16.2778307090795
"4659","Jordan",1972,12892000,2859000,"Japan",15751000,14.8659824713044,16.3721175219175
"4660","Jordan",1973,16214000,4013000,"Japan",20227000,15.2050496492491,16.6013856245298
"4661","Jordan",1974,22958000,14552000,"Japan",37510000,16.4932389991801,16.9491770176076
"4662","Jordan",1975,53437000,11752000,"Japan",65189000,16.2795339968359,17.7940139478923
"4663","Jordan",1976,64771000,6814000,"Japan",71585000,15.734489877203,17.9863685302865
"4664","Jordan",1977,87275000,9406000,"Japan",96681000,16.0568583414871,18.2845746109554
"4665","Jordan",1978,100672000,11505000,"Japan",112177000,16.2582922814516,18.4273782654001
"4666","Jordan",1979,124170000,16530000,"Japan",140700000,16.6206874697972,18.637162152393
"4667","Jordan",1980,171730000,21751000,"Japan",193481000,16.8951702914535,18.96143403396
"4668","Jordan",1981,215048000,17949000,"Japan",232997000,16.7030449610403,19.186371816988
"4669","Jordan",1982,247875000,17734000,"Japan",265609000,16.6909942589221,19.3284351448042
"4670","Jordan",1983,293464000,20276000,"Japan",313740000,16.8249484785744,19.4972655321284
"4671","Jordan",1984,234245837,23427554,"Japan",257673391,16.9694234089609,19.2718817073134
"4672","Jordan",1985,183041311,25276103,"Japan",208317414,17.0453699618791,19.0252224284989
"4673","Jordan",1986,200548075,26203296,"Japan",226751371,17.0813957623457,19.1165645515304
"4674","Jordan",1987,170890204,27053369,"Japan",197943573,17.1133221026363,18.9565318263727
"4675","Jordan",1988,164031450,29971067,"Japan",194002517,17.215743040928,18.915568735696
"4676","Jordan",1989,66681598,20830334,"Japan",87511932,16.8519208476741,18.0154395807667
"4677","Jordan",1990,62524585,24284370,"Japan",86808955,17.005343491486,17.9510703973609
"4678","Jordan",1991,85452517,22291754,"Japan",107744271,16.9197273922617,18.2634714229142
"4679","Jordan",1992,172842430,21571713,"Japan",194414143,16.8868934310674,18.9678909281747
"4680","Jordan",1993,169246918,19582585,"Japan",188829503,16.7901512088243,18.946869259842
"4681","Jordan",1994,122079665,21199525,"Japan",143279190,16.8694893337309,18.6201843813944
"4682","Jordan",1995,123748679,22708525,"Japan",146457204,16.9382509626109,18.6337632846086
"4683","Jordan",1996,140273274,23483484,"Japan",163756758,16.9718079235181,18.7591030351235
"4684","Jordan",1997,191305673,57425737,"Japan",248731410,17.8660031405886,19.0693830889629
"4685","Jordan",1998,186578000,63893000,"Japan",250471000,17.9727203671813,19.0443599401771
"4686","Jordan",1999,162015796,70762980,"Japan",232778776,18.0748465405579,18.9032043946161
"4687","Jordan",2000,131442367,83375163,"Japan",214817530,18.2388610172206,18.6940790397478
"4688","Jordan",2001,154531501,55203706,"Japan",209735207,17.8265406466749,18.855908523487
"4689","Jordan",2002,147070723,72403256,"Japan",219473979,18.0977618287204,18.8064241378908
"4690","Jordan",2003,180554138,65690517,"Japan",246244655,18.0004651351376,19.0115412242841
"4691","Jordan",2004,247017123,84195584,"Japan",331212707,18.2486530312814,19.3249682160761
"4692","Jordan",2005,270884886,98869730,"Japan",369754616,18.4093136830109,19.4172045136938
"4693","Jordan",2006,322475348,104325815,"Japan",426801163,18.4630293965369,19.5915372509683
"4694","Jordan",2007,378569276,108845327,"Japan",487414603,18.5054384140848,19.7519096418353
"4695","Jordan",2008,445494868,191125384,"Japan",636620252,19.0684402313678,19.9146962851679
"4696","Jordan",2009,478375431,205975347,"Japan",684350778,19.143267044835,19.9859064026765
"4697","Jordan",2010,426166134,76686743,"Japan",502852877,18.155239409156,19.8703398141244
"4698","Jordan",2011,242936589,68797073,"Japan",311733662,18.0466717583939,19.308311016634
"4699","Jordan",2012,281186571,59587225,"Japan",340773796,17.9029517634227,19.4545289607149
"4700","Jordan",2013,297632771,72814292,"Japan",370447063,18.1034228125802,19.5113709724682
"4701","Jordan",2014,489326018,53652197,"Japan",542978215,17.7980329768083,20.0085395287676
"4702","Jordan",2015,578089991,30370246,"Japan",608460237,17.2289739370879,20.1752401082893
"4703","Jordan",2016,632386938,36660946,"Japan",669047884,17.4172226047347,20.2650120084373
"4704","Jordan",2017,546662726,40138859,"Japan",586801585,17.5078554754177,20.1193425815518
"4705","Japan",1962,0,0,"0",0,0,0
"4706","Japan",1963,0,0,"0",0,0,0
"4707","Japan",1964,0,0,"0",0,0,0
"4708","Japan",1965,0,0,"0",0,0,0
"4709","Japan",1966,0,0,"0",0,0,0
"4710","Japan",1967,0,0,"0",0,0,0
"4711","Japan",1968,0,0,"0",0,0,0
"4712","Japan",1969,0,0,"0",0,0,0
"4713","Japan",1970,0,0,"0",0,0,0
"4714","Japan",1971,0,0,"0",0,0,0
"4715","Japan",1972,0,0,"0",0,0,0
"4716","Japan",1973,0,0,"0",0,0,0
"4717","Japan",1974,0,0,"0",0,0,0
"4718","Japan",1975,0,0,"0",0,0,0
"4719","Japan",1976,0,0,"0",0,0,0
"4720","Japan",1977,0,0,"0",0,0,0
"4721","Japan",1978,0,0,"0",0,0,0
"4722","Japan",1979,0,0,"0",0,0,0
"4723","Japan",1980,0,0,"0",0,0,0
"4724","Japan",1981,0,0,"0",0,0,0
"4725","Japan",1982,0,0,"0",0,0,0
"4726","Japan",1983,0,0,"0",0,0,0
"4727","Japan",1984,0,0,"0",0,0,0
"4728","Japan",1985,0,0,"0",0,0,0
"4729","Japan",1986,0,0,"0",0,0,0
"4730","Japan",1987,0,0,"0",0,0,0
"4731","Japan",1988,0,0,"0",0,0,0
"4732","Japan",1989,0,0,"0",0,0,0
"4733","Japan",1990,0,0,"0",0,0,0
"4734","Japan",1991,0,0,"0",0,0,0
"4735","Japan",1992,0,0,"0",0,0,0
"4736","Japan",1993,0,0,"0",0,0,0
"4737","Japan",1994,0,0,"0",0,0,0
"4738","Japan",1995,0,0,"0",0,0,0
"4739","Japan",1996,0,0,"0",0,0,0
"4740","Japan",1997,0,0,"0",0,0,0
"4741","Japan",1998,0,0,"0",0,0,0
"4742","Japan",1999,0,0,"0",0,0,0
"4743","Japan",2000,0,0,"0",0,0,0
"4744","Japan",2001,0,0,"0",0,0,0
"4745","Japan",2002,0,0,"0",0,0,0
"4746","Japan",2003,0,0,"0",0,0,0
"4747","Japan",2004,0,0,"0",0,0,0
"4748","Japan",2005,0,0,"0",0,0,0
"4749","Japan",2006,0,0,"0",0,0,0
"4750","Japan",2007,0,0,"0",0,0,0
"4751","Japan",2008,0,0,"0",0,0,0
"4752","Japan",2009,0,0,"0",0,0,0
"4753","Japan",2010,0,0,"0",0,0,0
"4754","Japan",2011,0,0,"0",0,0,0
"4755","Japan",2012,0,0,"0",0,0,0
"4756","Japan",2013,0,0,"0",0,0,0
"4757","Japan",2014,0,0,"0",0,0,0
"4758","Japan",2015,0,0,"0",0,0,0
"4759","Japan",2016,0,0,"0",0,0,0
"4760","Japan",2017,0,0,"0",0,0,0
"4761","Kazakhstan",1962,0,0,"0",0,0,0
"4762","Kazakhstan",1963,0,0,"0",0,0,0
"4763","Kazakhstan",1964,0,0,"0",0,0,0
"4764","Kazakhstan",1965,0,0,"0",0,0,0
"4765","Kazakhstan",1966,0,0,"0",0,0,0
"4766","Kazakhstan",1967,0,0,"0",0,0,0
"4767","Kazakhstan",1968,0,0,"0",0,0,0
"4768","Kazakhstan",1969,0,0,"0",0,0,0
"4769","Kazakhstan",1970,0,0,"0",0,0,0
"4770","Kazakhstan",1971,0,0,"0",0,0,0
"4771","Kazakhstan",1972,0,0,"0",0,0,0
"4772","Kazakhstan",1973,0,0,"0",0,0,0
"4773","Kazakhstan",1974,0,0,"0",0,0,0
"4774","Kazakhstan",1975,0,0,"0",0,0,0
"4775","Kazakhstan",1976,0,0,"0",0,0,0
"4776","Kazakhstan",1977,0,0,"0",0,0,0
"4777","Kazakhstan",1978,0,0,"0",0,0,0
"4778","Kazakhstan",1979,0,0,"0",0,0,0
"4779","Kazakhstan",1980,0,0,"0",0,0,0
"4780","Kazakhstan",1981,0,0,"0",0,0,0
"4781","Kazakhstan",1982,0,0,"0",0,0,0
"4782","Kazakhstan",1983,0,0,"0",0,0,0
"4783","Kazakhstan",1984,0,0,"0",0,0,0
"4784","Kazakhstan",1985,0,0,"0",0,0,0
"4785","Kazakhstan",1986,0,0,"0",0,0,0
"4786","Kazakhstan",1987,0,0,"0",0,0,0
"4787","Kazakhstan",1988,0,0,"0",0,0,0
"4788","Kazakhstan",1989,0,0,"0",0,0,0
"4789","Kazakhstan",1990,0,0,"0",0,0,0
"4790","Kazakhstan",1991,0,0,"0",0,0,0
"4791","Kazakhstan",1992,27312317,12173570,"Japan",39485887,16.3147777662359,17.1228483305688
"4792","Kazakhstan",1993,58302238,33939737,"Japan",92241975,17.3400970687716,17.881151038234
"4793","Kazakhstan",1994,29435808,32559195,"Japan",61995003,17.2985703752058,17.197722450382
"4794","Kazakhstan",1995,15915608,36217346,"Japan",52132954,17.4050487333008,16.5828108209218
"4795","Kazakhstan",1996,36671917,113248125,"Japan",149920042,18.545091765899,17.4175218157468
"4796","Kazakhstan",1997,78550107,108071456,"Japan",186621563,18.4983031959377,18.1792472848547
"4797","Kazakhstan",1998,67465000,119858000,"Japan",187323000,18.6018182667213,18.027119502847
"4798","Kazakhstan",1999,111984121,78122563,"Japan",190106684,18.1737894719343,18.5338676424224
"4799","Kazakhstan",2000,94048560,82997209,"Japan",177045769,18.2343175386895,18.3593218025893
"4800","Kazakhstan",2001,136570408,94299859,"Japan",230870267,18.3619902523746,18.7323508491291
"4801","Kazakhstan",2002,165898988,88782330,"Japan",254681318,18.3016982016755,18.9268896550818
"4802","Kazakhstan",2003,191549996,140263195,"Japan",331813191,18.7590311799381,19.0706594082287
"4803","Kazakhstan",2004,357494772,222317548,"Japan",579812320,19.2196173141905,19.6946312962152
"4804","Kazakhstan",2005,543937815,303215706,"Japan",847153521,19.5299550111824,20.1143454876245
"4805","Kazakhstan",2006,839611818,301279272,"Japan",1140891090,19.5235482065133,20.548450221562
"4806","Kazakhstan",2007,1305639741,363341164,"Japan",1668980905,19.7108527965807,20.9899589805895
"4807","Kazakhstan",2008,878648399,769732997,"Japan",1648381396,20.461554255535,20.59389537449
"4808","Kazakhstan",2009,567803085,297772249,"Japan",865575334,19.5118394871695,20.1572852352395
"4809","Kazakhstan",2010,504025159,548380537,"Japan",1052405696,20.1224800145048,20.0381367434405
"4810","Kazakhstan",2011,339242061,761977327,"Japan",1101219388,20.4514273586151,19.6422244547842
"4811","Kazakhstan",2012,542156359,582508430,"Japan",1124664789,20.1828542154024,20.1110650030399
"4812","Kazakhstan",2013,694897729,643812039,"Japan",1338709768,20.2829173765609,20.3592752401831
"4813","Kazakhstan",2014,659568724,753993911,"Japan",1413562635,20.4408948503428,20.3070967309094
"4814","Kazakhstan",2015,237890983,808641414,"Japan",1046532397,20.5108661307775,19.2873230720748
"4815","Kazakhstan",2016,187262609,591654722,"Japan",778917331,20.1984337828329,19.0480225158782
"4816","Kazakhstan",2017,332802385.5,1057648345.5,"Japan",1390450731,20.7793137384791,19.6230594348544
"4817","Kenya",1962,27831000,5098000,"Japan",32929000,15.4443588639182,17.1416610653035
"4818","Kenya",1963,29269000,4373000,"Japan",33642000,15.2909598303951,17.1920394934107
"4819","Kenya",1964,31549000,9036000,"Japan",40585000,16.01672715657,17.2670524507281
"4820","Kenya",1965,25659000,5551000,"Japan",31210000,15.5294886496723,17.060404945231
"4821","Kenya",1966,7365000,6759000,"Japan",14124000,15.7263855080825,15.8122496078789
"4822","Kenya",1967,17080000,5559000,"Japan",22639000,15.5309287939356,16.6534187463247
"4823","Kenya",1968,21714000,6695000,"Japan",28409000,15.7168715371074,16.8934677717739
"4824","Kenya",1969,25791000,4948000,"Japan",30739000,15.4144940124945,17.0655361518247
"4825","Kenya",1970,42521000,4664000,"Japan",47185000,15.3553840070125,17.5655086295058
"4826","Kenya",1971,53851000,8320000,"Japan",62171000,15.9341728127974,17.8017315314964
"4827","Kenya",1972,48184000,9863000,"Japan",58047000,16.1043009399361,17.6905375737057
"4828","Kenya",1973,72826000,24306000,"Japan",97132000,17.0062337914129,18.1035835922637
"4829","Kenya",1974,116447000,26938000,"Japan",143385000,17.1090484871409,18.5729467918331
"4830","Kenya",1975,81446000,26268000,"Japan",107714000,17.083862026293,18.215450781923
"4831","Kenya",1976,107617000,23754000,"Japan",131371000,16.9832614953163,18.4940891857775
"4832","Kenya",1977,158701000,17887000,"Japan",176588000,16.6995847499754,18.882532486674
"4833","Kenya",1978,168495000,16299000,"Japan",184794000,16.6066143142018,18.9424166337259
"4834","Kenya",1979,133606000,24249000,"Japan",157855000,17.0038859373841,18.710405728238
"4835","Kenya",1980,238757000,16555000,"Japan",255312000,16.6221987289635,19.290956856267
"4836","Kenya",1981,143250000,12913000,"Japan",156163000,16.3737451138288,18.7801019135591
"4837","Kenya",1982,112770000,9345000,"Japan",122115000,16.0503519988718,18.5408609042085
"4838","Kenya",1983,121033000,9165000,"Japan",130198000,16.0309024392559,18.6115737936504
"4839","Kenya",1984,150375768,15297365,"Japan",165673133,16.5431911493085,18.828647839478
"4840","Kenya",1985,132695670,9916311,"Japan",142611981,16.1096915350984,18.7035688687776
"4841","Kenya",1986,164792075,11793590,"Japan",176585665,16.2830667214993,18.9201950856911
"4842","Kenya",1987,172406227,12847260,"Japan",185253487,16.3686411169969,18.9653640350311
"4843","Kenya",1988,223492243,15717671,"Japan",239209914,16.570296178773,19.2248872644805
"4844","Kenya",1989,213506884,18876009,"Japan",232382893,16.7534023086242,19.1791796336729
"4845","Kenya",1990,197231286,18635768,"Japan",215867054,16.7405933028179,19.0998876386647
"4846","Kenya",1991,206030759,15382823,"Japan",221413582,16.5487620552635,19.1435360311414
"4847","Kenya",1992,175466493,19889596,"Japan",195356089,16.8057073389094,18.9829586595651
"4848","Kenya",1993,146813972,17707682,"Japan",164521654,16.6895091146878,18.8046768467274
"4849","Kenya",1994,177299044,22129687,"Japan",199428731,16.9124305682309,18.9933483790389
"4850","Kenya",1995,261198732,27763520,"Japan",288962252,17.139233486717,19.3807921008372
"4851","Kenya",1996,181626626,24394319,"Japan",206020945,17.009860835286,19.0174636323267
"4852","Kenya",1997,198371043,21881586,"Japan",220252629,16.9011560191799,19.105649789542
"4853","Kenya",1998,194627000,23324000,"Japan",217951000,16.9649934313242,19.0865954642378
"4854","Kenya",1999,196753380,23340467,"Japan",220093847,16.9656991931915,19.0974616242756
"4855","Kenya",2000,133528260,19062240,"Japan",152590500,16.7632199728946,18.7098236987956
"4856","Kenya",2001,180170535,21646720,"Japan",201817255,16.8903644997806,19.0094143770052
"4857","Kenya",2002,193049800,24886284,"Japan",217936084,17.0298273662915,19.0784587446729
"4858","Kenya",2003,185937491,21885925,"Japan",207823416,16.9013542941064,19.0409211053009
"4859","Kenya",2004,258788116,32530640,"Japan",291318756,17.2976929724029,19.3715201999076
"4860","Kenya",2005,284721777,28507206,"Japan",313228983,17.165667455385,19.4670230403662
"4861","Kenya",2006,379306415,25910504,"Japan",405216919,17.0701590042982,19.7538549192501
"4862","Kenya",2007,551658875,25846443,"Japan",577505318,17.0676835479034,20.1284404331405
"4863","Kenya",2008,605696321,33657252,"Japan",639353573,17.3317391034655,20.2218892979687
"4864","Kenya",2009,576176558,38784812,"Japan",614961370,17.4735392846606,20.1719246959967
"4865","Kenya",2010,671851163,35760802,"Japan",707611965,17.3923629353112,20.3255473903254
"4866","Kenya",2011,625179559,45137556,"Japan",670317115,17.6252251852206,20.2535494608395
"4867","Kenya",2012,656098380,46735421,"Japan",702833801,17.6600129147962,20.3018213051763
"4868","Kenya",2013,911793682,45979108,"Japan",957772790,17.6436976773721,20.6309242965685
"4869","Kenya",2014,909616295,60750364,"Japan",970366659,17.9222836319365,20.628533414708
"4870","Kenya",2015,924544567,69776071,"Japan",994320638,18.060801686606,20.6448118142277
"4871","Kenya",2016,742334827,58184017,"Japan",800518844,17.879121252993,20.4253109486754
"4872","Kenya",2017,765743153,51120217,"Japan",816863370,17.7496906129385,20.4563573620766
"4873","Kyrgyzstan",1962,0,0,"0",0,0,0
"4874","Kyrgyzstan",1963,0,0,"0",0,0,0
"4875","Kyrgyzstan",1964,0,0,"0",0,0,0
"4876","Kyrgyzstan",1965,0,0,"0",0,0,0
"4877","Kyrgyzstan",1966,0,0,"0",0,0,0
"4878","Kyrgyzstan",1967,0,0,"0",0,0,0
"4879","Kyrgyzstan",1968,0,0,"0",0,0,0
"4880","Kyrgyzstan",1969,0,0,"0",0,0,0
"4881","Kyrgyzstan",1970,0,0,"0",0,0,0
"4882","Kyrgyzstan",1971,0,0,"0",0,0,0
"4883","Kyrgyzstan",1972,0,0,"0",0,0,0
"4884","Kyrgyzstan",1973,0,0,"0",0,0,0
"4885","Kyrgyzstan",1974,0,0,"0",0,0,0
"4886","Kyrgyzstan",1975,0,0,"0",0,0,0
"4887","Kyrgyzstan",1976,0,0,"0",0,0,0
"4888","Kyrgyzstan",1977,0,0,"0",0,0,0
"4889","Kyrgyzstan",1978,0,0,"0",0,0,0
"4890","Kyrgyzstan",1979,0,0,"0",0,0,0
"4891","Kyrgyzstan",1980,0,0,"0",0,0,0
"4892","Kyrgyzstan",1981,0,0,"0",0,0,0
"4893","Kyrgyzstan",1982,0,0,"0",0,0,0
"4894","Kyrgyzstan",1983,0,0,"0",0,0,0
"4895","Kyrgyzstan",1984,0,0,"0",0,0,0
"4896","Kyrgyzstan",1985,0,0,"0",0,0,0
"4897","Kyrgyzstan",1986,0,0,"0",0,0,0
"4898","Kyrgyzstan",1987,0,0,"0",0,0,0
"4899","Kyrgyzstan",1988,0,0,"0",0,0,0
"4900","Kyrgyzstan",1989,0,0,"0",0,0,0
"4901","Kyrgyzstan",1990,0,0,"0",0,0,0
"4902","Kyrgyzstan",1991,0,0,"0",0,0,0
"4903","Kyrgyzstan",1992,141064,10448,"Japan",151512,9.25416585151621,11.8569689670878
"4904","Kyrgyzstan",1993,32658,53587,"Japan",86245,10.8890617803285,10.3938451276623
"4905","Kyrgyzstan",1994,2305575,167723,"Japan",2473298,12.0300690880792,14.6508406610041
"4906","Kyrgyzstan",1995,5729749,741700,"Japan",6471449,13.5167001277246,15.561182283194
"4907","Kyrgyzstan",1996,5136703,1075088,"Japan",6211791,13.8879130766586,15.4519219919322
"4908","Kyrgyzstan",1997,1086800,488755,"Japan",1575555,13.0996166204084,13.8987481565343
"4909","Kyrgyzstan",1998,725000,519000,"Japan",1244000,13.159659162148,13.4939269338368
"4910","Kyrgyzstan",1999,6132025,556964,"Japan",6688989,13.2302558848638,15.6290355959388
"4911","Kyrgyzstan",2000,4452070,1234829,"Japan",5686899,14.0264430569191,15.3088797145244
"4912","Kyrgyzstan",2001,979849,624544,"Japan",1604393,13.3447770624309,13.7951537571423
"4913","Kyrgyzstan",2002,1304788,9038404,"Japan",10343192,16.0169931681092,14.0815511334349
"4914","Kyrgyzstan",2003,11339018,15969995,"Japan",27309013,16.5862222071041,16.2437602563943
"4915","Kyrgyzstan",2004,10563488,452811,"Japan",11016299,13.0232300988623,16.1729140847347
"4916","Kyrgyzstan",2005,10668858,330497,"Japan",10999355,12.7083528610769,16.1828395884965
"4917","Kyrgyzstan",2006,13372156,273263,"Japan",13645419,12.5181899803874,16.4086851926222
"4918","Kyrgyzstan",2007,26878201,318545,"Japan",27196746,12.6715190312984,17.1068261442962
"4919","Kyrgyzstan",2008,116614059,981373,"Japan",117595432,13.7967078905415,18.5743803992262
"4920","Kyrgyzstan",2009,58912362,194284,"Japan",59106646,12.1770762850886,17.8915615077543
"4921","Kyrgyzstan",2010,77823756,166585,"Japan",77990341,12.023260968647,18.1699572895834
"4922","Kyrgyzstan",2011,79762159,2073474,"Japan",81835633,14.544736019405,18.1945597519576
"4923","Kyrgyzstan",2012,72022057,1043532,"Japan",73065589,13.858121671057,18.0924829772878
"4924","Kyrgyzstan",2013,100860497,789562,"Japan",101650059,13.5792336403101,18.4292489022232
"4925","Kyrgyzstan",2014,126147151,1189975,"Japan",127337126,13.9894428564637,18.6529596485712
"4926","Kyrgyzstan",2015,22600983,2687115,"Japan",25288098,14.803978685342,16.9335039588718
"4927","Kyrgyzstan",2016,8361660,352631,"Japan",8714291,12.7731774634024,15.9391675299428
"4928","Kyrgyzstan",2017,26429908.5,375063.5,"Japan",26804972,12.8348506239506,17.0900068245995
"4929","Cambodia",1962,20060000,3103000,"Japan",23163000,14.9478799434305,16.8142383404981
"4930","Cambodia",1963,18094000,3941000,"Japan",22035000,15.1869450561771,16.7110909495678
"4931","Cambodia",1964,16927000,5441000,"Japan",22368000,15.5094734254681,16.6444205381712
"4932","Cambodia",1965,17459000,7881000,"Japan",25340000,15.8799653573358,16.6753658329669
"4933","Cambodia",1966,14978000,7500000,"Japan",22478000,15.8304135785065,16.5220930157914
"4934","Cambodia",1967,15528000,7077000,"Japan",22605000,15.7723606470579,16.558155403831
"4935","Cambodia",1968,26881000,6555000,"Japan",33436000,15.6957386751799,17.1069302753082
"4936","Cambodia",1969,26619000,7335000,"Japan",33954000,15.8081679695592,17.0971358044856
"4937","Cambodia",1970,13600000,5992000,"Japan",19592000,15.6059358041792,16.4255803507063
"4938","Cambodia",1971,14634000,2235000,"Japan",16869000,14.6197517860298,16.4988581464261
"4939","Cambodia",1972,15266000,1881000,"Japan",17147000,14.4473141082832,16.5411386913406
"4940","Cambodia",1973,10277000,2276000,"Japan",12553000,14.6379300742284,16.1454189466072
"4941","Cambodia",1974,3403000,2434000,"Japan",5837000,14.7050465525296,15.040167953483
"4942","Cambodia",1975,135000,588000,"Japan",723000,13.2844822268808,11.8130300574206
"4943","Cambodia",1976,0,348000,"Japan",348000,12.7599577587566,0
"4944","Cambodia",1977,3909000,457000,"Japan",4366000,13.0324386698763,15.1787921447751
"4945","Cambodia",1978,39000,477000,"Japan",516000,13.0752717698705,10.5713169251118
"4946","Cambodia",1979,744000,315000,"Japan",1059000,12.6603279178078,13.5197963138152
"4947","Cambodia",1980,25456000,568000,"Japan",26024000,13.2498766977033,17.0524620295597
"4948","Cambodia",1981,10416000,670000,"Japan",11086000,13.4150329913671,16.1588536434305
"4949","Cambodia",1982,5316000,573000,"Japan",5889000,13.2586409956969,15.4862316988153
"4950","Cambodia",1983,3475000,423000,"Japan",3898000,12.9551274580284,15.061105036981
"4951","Cambodia",1984,5206846,243046,"Japan",5449892,12.4010060048191,15.4654848561363
"4952","Cambodia",1985,1750948,325012,"Japan",2075960,12.6916173837072,14.3756679135112
"4953","Cambodia",1986,1748926,179042,"Japan",1927968,12.0953756941715,14.3745124432143
"4954","Cambodia",1987,1100563,590140,"Japan",1690703,13.2881150758691,13.9113324250162
"4955","Cambodia",1988,4820008,1256438,"Japan",6076446,14.0437912913341,15.3882861457764
"4956","Cambodia",1989,3708348,2101239,"Japan",5809587,14.5580377287121,15.1260970523968
"4957","Cambodia",1990,4486205,3048847,"Japan",7535052,14.9302740443243,15.3165176907444
"4958","Cambodia",1991,6616863,4877020,"Japan",11493883,15.4000449355655,15.7051319485332
"4959","Cambodia",1992,224298676,8436849,"Japan",232735525,15.9481194556307,19.2284890966643
"4960","Cambodia",1993,49416751,73055657,"Japan",122472408,18.1067321332722,17.7158000137493
"4961","Cambodia",1994,63280752,7818847,"Japan",71099599,15.8720476591955,17.9630917650446
"4962","Cambodia",1995,77214127,6509056,"Japan",83723183,15.6887049959896,18.1620929904819
"4963","Cambodia",1996,56418397,5857685,"Japan",62276082,15.5832650323054,17.8483058512238
"4964","Cambodia",1997,44781225,14483333,"Japan",59264558,16.4885090979926,17.6172995247232
"4965","Cambodia",1998,42444000,15648000,"Japan",58092000,16.5658536712567,17.5636961179756
"4966","Cambodia",1999,50241855,31044026,"Japan",81285881,17.2509169484768,17.7323590022133
"4967","Cambodia",2000,56119059,46875470,"Japan",102994529,17.6630050688713,17.8429860454172
"4968","Cambodia",2001,55944998,59308122,"Japan",115253120,17.898256819176,17.8398795874746
"4969","Cambodia",2002,60228542,67338055,"Japan",127566597,18.0252360880012,17.9136569175212
"4970","Cambodia",2003,72036813,80809978,"Japan",152846791,18.2076110059661,18.0926878379819
"4971","Cambodia",2004,85540908,89742926,"Japan",175283834,18.3124597632848,18.2645052756237
"4972","Cambodia",2005,93161500,94591917,"Japan",187753417,18.3650825863969,18.3498451041818
"4973","Cambodia",2006,119210921,108288703,"Japan",227499624,18.5003113944343,18.5964049275263
"4974","Cambodia",2007,130176654,125492518,"Japan",255669172,18.647756697229,18.6844029629052
"4975","Cambodia",2008,110436852,108418100,"Japan",218854952,18.5015056072009,18.5199544404548
"4976","Cambodia",2009,116869899,128117590,"Japan",244987489,18.6684590720381,18.5765718997009
"4977","Cambodia",2010,150880761,187191081,"Japan",338071842,19.047640476642,18.8320004205801
"4978","Cambodia",2011,205018893,307974903,"Japan",512993796,19.5455288538516,19.1386126938317
"4979","Cambodia",2012,233303010,404188129,"Japan",637491139,19.8173909933783,19.2678486387516
"4980","Cambodia",2013,209289535,583025114,"Japan",792314649,20.1837408205739,19.1592291861662
"4981","Cambodia",2014,255128702,772003469,"Japan",1027132171,20.4644996015023,19.3572786895231
"4982","Cambodia",2015,301910701,968542132,"Japan",1270452833,20.6913025421883,19.5256418395606
"4983","Cambodia",2016,306009529,1204230886,"Japan",1510240415,20.9091069312291,19.5391267999547
"4984","Cambodia",2017,0,0,"0",0,0,0
"4985","South Korea",1962,66494000,28502000,"Japan",94996000,17.1654848182153,18.0126222759916
"4986","South Korea",1963,159238000,26977000,"Japan",186215000,17.1104952090848,18.8859104963591
"4987","South Korea",1964,110118000,41672000,"Japan",151790000,17.5453399984072,18.5170630760687
"4988","South Korea",1965,166632000,41316000,"Japan",207948000,17.5367603921087,18.9312983460834
"4989","South Korea",1966,293366000,71694000,"Japan",365060000,18.0879176200599,19.4969315342043
"4990","South Korea",1967,443098000,92399000,"Japan",535497000,18.3416267140425,19.9093015225057
"4991","South Korea",1968,624283000,101639000,"Japan",725922000,18.4369378777216,20.2521143491631
"4992","South Korea",1969,753918000,133935000,"Japan",887853000,18.7128651656016,20.4407941667425
"4993","South Korea",1970,813001000,228991000,"Japan",1041992000,19.2491932594362,20.5162428975236
"4994","South Korea",1971,961903000,272111000,"Japan",1234014000,19.4217206292502,20.6844241719453
"4995","South Korea",1972,1031235000,426001000,"Japan",1457236000,19.8699522516487,20.7540229500528
"4996","South Korea",1973,1726895000,1204680000,"Japan",2931575000,20.9094798084557,21.2695908351891
"4997","South Korea",1974,2620563000,1565138000,"Japan",4185701000,21.1712398359647,21.686655017131
"4998","South Korea",1975,2431998000,1309839000,"Japan",3741837000,20.9931700658432,21.6119789786816
"4999","South Korea",1976,3094202000,1916778000,"Japan",5010980000,21.3739114883571,21.8527958746197
"5000","South Korea",1977,3923212000,2113833000,"Japan",6037045000,21.4717687241122,22.090176542989
"5001","South Korea",1978,5979588000,2591030000,"Japan",8570618000,21.6753213170005,22.5116175062144
"5002","South Korea",1979,6637860000,3359409000,"Japan",9997269000,21.9350309025934,22.6160554593318
"5003","South Korea",1980,5834120000,2994844000,"Japan",8828964000,21.8201579803459,22.4869892772582
"5004","South Korea",1981,6341175000,3388912000,"Japan",9730087000,21.9437747628724,22.5703299194541
"5005","South Korea",1982,4878304000,3253507000,"Japan",8131811000,21.9029993284261,22.3080634554215
"5006","South Korea",1983,5996986000,3364795000,"Japan",9361781000,21.9366328769392,22.5145228466295
"5007","South Korea",1984,7083732135,4051620701,"Japan",11135352836,22.1223828111034,22.6810667434756
"5008","South Korea",1985,6987795512,3972938011,"Japan",10960733523,22.1027717110898,22.6674309660539
"5009","South Korea",1986,10018952040,4851451184,"Japan",14870403224,22.3025437103363,23.0277443403072
"5010","South Korea",1987,12457340338,7445850611,"Japan",19903190949,22.7309227492088,23.2455758715015
"5011","South Korea",1988,14500662404,10831544998,"Japan",25332207402,23.1057285468796,23.397460168364
"5012","South Korea",1989,15892765838,11962851553,"Japan",27855617391,23.2050719812143,23.4891298638962
"5013","South Korea",1990,16907628795,10692423201,"Japan",27600051996,23.0928012155284,23.5510307650097
"5014","South Korea",1991,19209037696,11237082145,"Japan",30446119841,23.1424850520706,23.6786467185627
"5015","South Korea",1992,17657308591,10511915307,"Japan",28169223898,23.075775241864,23.5944156190923
"5016","South Korea",1993,18116396955,10570256223,"Japan",28686653178,23.0813098771213,23.6200832742462
"5017","South Korea",1994,23013350437,12255259490,"Japan",35268609927,23.2292210279169,23.85934033826
"5018","South Korea",1995,29477954162,15658404353,"Japan",45136358515,23.4742736291503,24.1069085043696
"5019","South Korea",1996,28389556658,14392237555,"Japan",42781794213,23.3899548395034,24.0692871911769
"5020","South Korea",1997,14918911242,11107624217,"Japan",26026535459,23.1308975758763,23.4258954560031
"5021","South Korea",1998,16785310000,11813466000,"Japan",28598776000,23.1925059042004,23.5437699360789
"5022","South Korea",1999,21797224358,14496251519,"Japan",36293475877,23.3971559370209,23.8050484756077
"5023","South Korea",2000,28778160001,18647989069,"Japan",47426149070,23.6490041525042,24.0828826031096
"5024","South Korea",2001,24052708787,15495366936,"Japan",39548075723,23.4638069088351,23.9035134586318
"5025","South Korea",2002,26973843470,13932596892,"Japan",40906440362,23.357497031771,24.0181334730288
"5026","South Korea",2003,32766776076,16077582601,"Japan",48844358677,23.500691753637,24.2126809144696
"5027","South Korea",2004,41662026235,19845492541,"Japan",61507518776,23.7112427422738,24.4528559090185
"5028","South Korea",2005,43666524770,21959550339,"Japan",65626075109,23.812467977012,24.4998476219322
"5029","South Korea",2006,46859104221,24628401330,"Japan",71487505551,23.9271661395423,24.5704111537742
"5030","South Korea",2007,49916634792,24299443375,"Japan",74216078167,23.913719280652,24.6336201467161
"5031","South Korea",2008,54253820339,26269357560,"Japan",80523177899,23.9916689850726,24.7169392478829
"5032","South Korea",2009,44120431289,19455793614,"Japan",63576224903,23.6914107348408,24.5101888066466
"5033","South Korea",2010,57619040700,25342397559,"Japan",82961438259,23.9557446229516,24.7771189177311
"5034","South Korea",2011,63410080992,30883863128,"Japan",94293944120,24.1534996555738,24.8728886919324
"5035","South Korea",2012,58887606239,30176551025,"Japan",89064157264,24.1303310036032,24.798896485072
"5036","South Korea",2013,53510379195,27064331822,"Japan",80574711017,24.0214825289911,24.703141475677
"5037","South Korea",2014,48875780817,26751144667,"Japan",75626925484,24.0098431006626,24.6125478309197
"5038","South Korea",2015,42356044348,23008893505,"Japan",65364937853,23.8591466522668,24.469376971544
"5039","South Korea",2016,44439847342,22637745722,"Japan",67077593064,23.8428845147409,24.5174023665634
"5040","South Korea",2017,55207020630,28073153354,"Japan",83280173984,24.058079559949,24.7343559674682
"5041","Kosovo",1962,0,0,"0",0,0,0
"5042","Kosovo",1963,0,0,"0",0,0,0
"5043","Kosovo",1964,0,0,"0",0,0,0
"5044","Kosovo",1965,0,0,"0",0,0,0
"5045","Kosovo",1966,0,0,"0",0,0,0
"5046","Kosovo",1967,0,0,"0",0,0,0
"5047","Kosovo",1968,0,0,"0",0,0,0
"5048","Kosovo",1969,0,0,"0",0,0,0
"5049","Kosovo",1970,0,0,"0",0,0,0
"5050","Kosovo",1971,0,0,"0",0,0,0
"5051","Kosovo",1972,0,0,"0",0,0,0
"5052","Kosovo",1973,0,0,"0",0,0,0
"5053","Kosovo",1974,0,0,"0",0,0,0
"5054","Kosovo",1975,0,0,"0",0,0,0
"5055","Kosovo",1976,0,0,"0",0,0,0
"5056","Kosovo",1977,0,0,"0",0,0,0
"5057","Kosovo",1978,0,0,"0",0,0,0
"5058","Kosovo",1979,0,0,"0",0,0,0
"5059","Kosovo",1980,0,0,"0",0,0,0
"5060","Kosovo",1981,0,0,"0",0,0,0
"5061","Kosovo",1982,0,0,"0",0,0,0
"5062","Kosovo",1983,0,0,"0",0,0,0
"5063","Kosovo",1984,0,0,"0",0,0,0
"5064","Kosovo",1985,0,0,"0",0,0,0
"5065","Kosovo",1986,0,0,"0",0,0,0
"5066","Kosovo",1987,0,0,"0",0,0,0
"5067","Kosovo",1988,0,0,"0",0,0,0
"5068","Kosovo",1989,0,0,"0",0,0,0
"5069","Kosovo",1990,0,0,"0",0,0,0
"5070","Kosovo",1991,0,0,"0",0,0,0
"5071","Kosovo",1992,0,0,"0",0,0,0
"5072","Kosovo",1993,0,0,"0",0,0,0
"5073","Kosovo",1994,0,0,"0",0,0,0
"5074","Kosovo",1995,0,0,"0",0,0,0
"5075","Kosovo",1996,0,0,"0",0,0,0
"5076","Kosovo",1997,0,0,"0",0,0,0
"5077","Kosovo",1998,0,0,"0",0,0,0
"5078","Kosovo",1999,0,0,"0",0,0,0
"5079","Kosovo",2000,0,0,"0",0,0,0
"5080","Kosovo",2001,0,0,"0",0,0,0
"5081","Kosovo",2002,0,0,"0",0,0,0
"5082","Kosovo",2003,0,0,"0",0,0,0
"5083","Kosovo",2004,0,0,"0",0,0,0
"5084","Kosovo",2005,0,0,"0",0,0,0
"5085","Kosovo",2006,0,0,"0",0,0,0
"5086","Kosovo",2007,0,0,"0",0,0,0
"5087","Kosovo",2008,0,0,"0",0,0,0
"5088","Kosovo",2009,0,0,"0",0,0,0
"5089","Kosovo",2010,0,0,"0",0,0,0
"5090","Kosovo",2011,0,0,"0",0,0,0
"5091","Kosovo",2012,0,0,"0",0,0,0
"5092","Kosovo",2013,0,0,"0",0,0,0
"5093","Kosovo",2014,0,0,"0",0,0,0
"5094","Kosovo",2015,0,0,"0",0,0,0
"5095","Kosovo",2016,0,0,"0",0,0,0
"5096","Kosovo",2017,0,0,"0",0,0,0
"5097","Kuwait",1962,26047000,262465000,"Japan",288512000,19.3856282977729,17.0754131563841
"5098","Kuwait",1963,27466000,352831000,"Japan",380297000,19.6814997467174,17.1284594340724
"5099","Kuwait",1964,35750000,413328000,"Japan",449078000,19.8397520245862,17.3920608271043
"5100","Kuwait",1965,44473000,450379000,"Japan",494852000,19.9256000084807,17.6103928214213
"5101","Kuwait",1966,69877000,476282000,"Japan",546159000,19.981520673749,18.0622471115702
"5102","Kuwait",1967,74623000,506064000,"Japan",580687000,20.042173701467,18.1279593286479
"5103","Kuwait",1968,77065000,531205000,"Japan",608270000,20.0906585687328,18.160159779563
"5104","Kuwait",1969,123317000,488418000,"Japan",611735000,20.0066821545585,18.6302688337321
"5105","Kuwait",1970,95042000,308327000,"Japan",403369000,19.5466714660571,18.3698294571282
"5106","Kuwait",1971,91805000,415977000,"Japan",507782000,19.8461405282355,18.3351773203384
"5107","Kuwait",1972,127566000,548273000,"Japan",675839000,20.1222838960467,18.6641444356886
"5108","Kuwait",1973,186369000,588671000,"Japan",775040000,20.1933780117014,19.043239137372
"5109","Kuwait",1974,265203000,2125585000,"Japan",2390788000,21.477312895554,19.3960061284292
"5110","Kuwait",1975,387121000,2011532000,"Japan",2398653000,21.4221624577536,19.7742478636243
"5111","Kuwait",1976,689960000,2013210000,"Japan",2703170000,21.4229963000705,20.3521441828607
"5112","Kuwait",1977,961558000,2487555000,"Japan",3449113000,21.6345661373054,20.6840654435867
"5113","Kuwait",1978,774095000,2481848000,"Japan",3255943000,21.6322692809188,20.4672051630403
"5114","Kuwait",1979,950122000,4313766000,"Japan",5263888000,22.1850771414394,20.6721009553662
"5115","Kuwait",1980,1376110000,3457572000,"Japan",4833682000,21.9638324455814,21.0425265151228
"5116","Kuwait",1981,1583563000,3608615000,"Japan",5192178000,22.0065898791665,21.1829432084373
"5117","Kuwait",1982,1789938000,1626570000,"Japan",3416508000,21.209739340148,21.3054468193277
"5118","Kuwait",1983,1762554000,1387414000,"Japan",3149968000,21.0507074196819,21.2900297304792
"5119","Kuwait",1984,1431935408,1441154555,"Japan",2873089963,21.0887104035906,21.0822927983223
"5120","Kuwait",1985,1536417472,1049917527,"Japan",2586334999,20.7719774523167,21.1527192264099
"5121","Kuwait",1986,1219603674,1050546111,"Japan",2270149785,20.772575971622,20.9217917855369
"5122","Kuwait",1987,857009167,1645087533,"Japan",2502096700,21.2210594312982,20.5689591731209
"5123","Kuwait",1988,728680454,1416617776,"Japan",2145298230,21.0715380195603,20.4067458591711
"5124","Kuwait",1989,666590113,2146684021,"Japan",2813274134,21.4871901726787,20.3176858917447
"5125","Kuwait",1990,416124327,1629396062,"Japan",2045520389,21.2114752689973,19.8464946365557
"5126","Kuwait",1991,430706881,50421292,"Japan",481128173,17.7359241041478,19.8809383262143
"5127","Kuwait",1992,765669676,1083522149,"Japan",1849191825,20.8034828208176,20.4562614023215
"5128","Kuwait",1993,880401377,1525294843,"Japan",2405696220,21.1454535679902,20.5958884716771
"5129","Kuwait",1994,789811713,1886138528,"Japan",2675950241,21.3577974691496,20.4873051370436
"5130","Kuwait",1995,765134843,2494325682,"Japan",3259460525,21.6372842618855,20.4555626416174
"5131","Kuwait",1996,1150388151,2857213088,"Japan",4007601239,21.773112541943,20.8633652449823
"5132","Kuwait",1997,1231536265,2095123278,"Japan",3326659543,21.4628782325034,20.9315282229191
"5133","Kuwait",1998,1166984000,2336601000,"Japan",3503585000,21.5719631462195,20.8776884797884
"5134","Kuwait",1999,931196951,2723746201,"Japan",3654943152,21.7252740494539,20.6519813606663
"5135","Kuwait",2000,756961814,4505693388,"Japan",5262655202,22.2286076313683,20.4448233662721
"5136","Kuwait",2001,1081429578,3967308206,"Japan",5048737784,22.1013536679235,20.8015496861194
"5137","Kuwait",2002,1453339913,3783895970,"Japan",5237235883,22.0540199956862,21.0971301329226
"5138","Kuwait",2003,1139589471,4139352789,"Japan",5278942260,22.1438052814032,20.8539339213386
"5139","Kuwait",2004,1389848555,5210002788,"Japan",6599851343,22.3738462278363,21.0524606249158
"5140","Kuwait",2005,1183905156,6913287106,"Japan",8097192262,22.6567110643649,20.8920842654699
"5141","Kuwait",2006,1240726431,8285828396,"Japan",9526554827,22.8378124702737,20.9389628764827
"5142","Kuwait",2007,1640038865,8888038405,"Japan",10528077270,22.907972210269,21.2179857766725
"5143","Kuwait",2008,2151276905,13863686585,"Japan",16014963490,23.3525387827135,21.489327412094
"5144","Kuwait",2009,1229058055,8056242984,"Japan",9285301039,22.8097131537747,20.9295139040062
"5145","Kuwait",2010,1421186435,9264809530,"Japan",10685995965,22.9494891384584,21.0747578773147
"5146","Kuwait",2011,1344810525,10746165535,"Japan",12090976060,23.0978148334709,21.0195189664706
"5147","Kuwait",2012,1878370506,13197464653,"Japan",15075835159,23.3032905763482,21.3536704858138
"5148","Kuwait",2013,1876708979,11775590833,"Japan",13652299812,23.1892946524903,21.3527855367121
"5149","Kuwait",2014,1890913033,10667308681,"Japan",12558221714,23.0904496381105,21.3603256356128
"5150","Kuwait",2015,1862735927,5613221627,"Japan",7475957554,22.4483906567163,21.3453121724105
"5151","Kuwait",2016,1694768282,3609939137,"Japan",5304707419,22.0069567495923,21.2508118616489
"5152","Kuwait",2017,1579524258,508338912.5,"Japan",2087863170.5,20.0466589336873,21.1803895361132
"5153","Laos",1962,2384000,12000,"Japan",2396000,9.39266192877014,14.6842903071674
"5154","Laos",1963,3097000,6000,"Japan",3103000,8.69951474821019,14.9459444589553
"5155","Laos",1964,1345000,0,"Japan",1345000,0,14.1119045710181
"5156","Laos",1965,2654000,6000,"Japan",2660000,8.69951474821019,14.7915784938743
"5157","Laos",1966,5312000,3000,"Japan",5315000,8.00636756765025,15.4854789701384
"5158","Laos",1967,7880000,3000,"Japan",7883000,8.00636756765025,15.8798384618341
"5159","Laos",1968,11456000,6000,"Japan",11462000,8.69951474821019,16.2540241681826
"5160","Laos",1969,17027000,7000,"Japan",17034000,8.85366542803745,16.6503108774028
"5161","Laos",1970,16348000,47000,"Japan",16395000,10.7579028806922,16.6096161236663
"5162","Laos",1971,16008000,26000,"Japan",16034000,10.1658518170036,16.5885991552457
"5163","Laos",1972,3509000,294000,"Japan",3803000,12.5913350463208,15.0708416545654
"5164","Laos",1973,6422000,330000,"Japan",6752000,12.7068479334427,15.6752401536316
"5165","Laos",1974,12154000,2626000,"Japan",14780000,14.7809723338449,16.3131688916774
"5166","Laos",1975,4107000,1501000,"Japan",5608000,14.2216421106156,15.2282033929387
"5167","Laos",1976,7322000,2898000,"Japan",10220000,14.8795314018628,15.8063940726623
"5168","Laos",1977,14476000,2533000,"Japan",17009000,14.7449149289838,16.4880026636658
"5169","Laos",1978,4680000,4431000,"Japan",9111000,15.3041358501816,15.3588086678938
"5170","Laos",1979,9210000,9219000,"Japan",18429000,16.0367771297807,16.0358004082315
"5171","Laos",1980,12466000,5884000,"Japan",18350000,15.5877473607035,16.3385154963509
"5172","Laos",1981,8952000,3788000,"Japan",12740000,15.1473487332881,16.0073875289739
"5173","Laos",1982,9786000,1157000,"Japan",10943000,13.9613410061758,16.0964633508312
"5174","Laos",1983,15231000,2361000,"Japan",17592000,14.6745958160677,16.5388433825976
"5175","Laos",1984,5170720,570830,"Japan",5741550,13.2548467210173,15.4585225017785
"5176","Laos",1985,11738387,1163622,"Japan",12902009,13.9670481122653,16.2783749693985
"5177","Laos",1986,12918148,1282558,"Japan",14200706,14.064367079176,16.3741437023908
"5178","Laos",1987,15424925,1340460,"Japan",16765385,14.1085233966009,16.5514952655073
"5179","Laos",1988,19616822,6133444,"Japan",25750266,15.6292669772266,16.7918980214078
"5180","Laos",1989,24100386,6973292,"Japan",31073678,15.7575979811331,16.9977384149301
"5181","Laos",1990,19355286,4141736,"Japan",23497022,15.2366255815814,16.7784761184282
"5182","Laos",1991,21448167,3988831,"Japan",25436998,15.1990087634822,16.8811497451414
"5183","Laos",1992,28045901,10919212,"Japan",38965113,16.2060343645051,17.1493530473474
"5184","Laos",1993,37027849,10380016,"Japan",47407865,16.1553929771266,17.4271808631659
"5185","Laos",1994,33758049,28107298,"Japan",61865347,17.1515398158863,17.3347294357377
"5186","Laos",1995,28094269,26455101,"Japan",54549370,17.0909595521169,17.1510761633254
"5187","Laos",1996,39689885,20831992,"Japan",60521877,16.8520004399658,17.4966069272998
"5188","Laos",1997,18781535,17888229,"Japan",36669764,16.6996534567334,16.7483847642934
"5189","Laos",1998,16546000,18918000,"Japan",35464000,16.7556244077553,16.6216549387323
"5190","Laos",1999,22625204,12227646,"Japan",34852850,16.3192100116229,16.9345750640842
"5191","Laos",2000,21337996,10742605,"Japan",32080601,16.1897281688446,16.8759998912745
"5192","Laos",2001,11757419,6239324,"Japan",17996743,15.6463824011438,16.279995003558
"5193","Laos",2002,18008171,6029642,"Japan",24037813,15.6121981971233,16.7063361573033
"5194","Laos",2003,13621133,6679102,"Japan",20300235,15.7144941053384,16.4271330417163
"5195","Laos",2004,14062737,7200443,"Japan",21263180,15.7896531098713,16.4590390911202
"5196","Laos",2005,19495817,7234088,"Japan",26729905,15.7943148561976,16.7857104877023
"5197","Laos",2006,20517669,11100532,"Japan",31618201,16.222503593062,16.836796975323
"5198","Laos",2007,37608867,10809667,"Japan",48418534,16.1959513843306,17.442750405026
"5199","Laos",2008,62064920,16265734,"Japan",78330654,16.6045712444459,17.9436914919601
"5200","Laos",2009,75945282,24380607,"Japan",100325889,17.0092985791644,18.1455236652609
"5201","Laos",2010,62268938,34203987,"Japan",96472925,17.3478527741854,17.9469732719417
"5202","Laos",2011,77634927,97325356,"Japan",174960283,18.3935701093015,18.1675279740994
"5203","Laos",2012,137459322,123982019,"Japan",261441341,18.6356471049901,18.7388385913016
"5204","Laos",2013,121144757,107216650,"Japan",228361407,18.4903621117047,18.6124967273609
"5205","Laos",2014,138371357,115087346,"Japan",253458703,18.561201928465,18.7454516216366
"5206","Laos",2015,104522875,97403299,"Japan",201926174,18.3943706386757,18.4649165049357
"5207","Laos",2016,116158178,115185968,"Japan",231344146,18.5620584932516,18.570463423656
"5208","Laos",2017,0,0,"0",0,0,0
"5209","Lebanon",1962,9885000,534000,"Japan",10419000,13.1881511179423,16.1065290145869
"5210","Lebanon",1963,14694000,469000,"Japan",15163000,13.0583580474284,16.5029498051624
"5211","Lebanon",1964,16300000,194000,"Japan",16494000,12.1756134380455,16.606675665777
"5212","Lebanon",1965,16593000,433000,"Japan",17026000,12.9784930069846,16.6244914776449
"5213","Lebanon",1966,19475000,2009000,"Japan",21484000,14.5131476437971,16.7846421497211
"5214","Lebanon",1967,13895000,1072000,"Japan",14967000,13.8850366206129,16.4470396211587
"5215","Lebanon",1968,16069000,1384000,"Japan",17453000,14.1404884151598,16.5924025080239
"5216","Lebanon",1969,22720000,1646000,"Japan",24366000,14.3138586602192,16.9387561518172
"5217","Lebanon",1970,26459000,1725000,"Japan",28184000,14.3607376084476,17.091106923042
"5218","Lebanon",1971,31688000,1557000,"Japan",33245000,14.2582714508161,17.2714486182839
"5219","Lebanon",1972,38563000,1894000,"Japan",40457000,14.4542015527282,17.4678038255102
"5220","Lebanon",1973,48172000,3808000,"Japan",51980000,15.1526146748934,17.6902884973625
"5221","Lebanon",1974,93862000,3147000,"Japan",97009000,14.9619601760465,18.3573361764351
"5222","Lebanon",1975,83493000,1779000,"Japan",85272000,14.391561966648,18.2402733539716
"5223","Lebanon",1976,2909000,332000,"Japan",3241000,12.7128902478986,14.8833199374773
"5224","Lebanon",1977,56475000,181000,"Japan",56656000,12.106252310248,17.8493086203183
"5225","Lebanon",1978,66131000,5324000,"Japan",71455000,15.4877354584971,18.0071481812664
"5226","Lebanon",1979,92853000,670000,"Japan",93523000,13.4150329913671,18.3465281554187
"5227","Lebanon",1980,191620000,437000,"Japan",192057000,12.9876884740777,19.071024802187
"5228","Lebanon",1981,158280000,161000,"Japan",158441000,11.9891596439666,18.8798761744815
"5229","Lebanon",1982,159681000,115000,"Japan",159796000,11.6526874073454,18.8886886330329
"5230","Lebanon",1983,232548000,1587000,"Japan",234135000,14.2773559995085,19.2646072132964
"5231","Lebanon",1984,143841018,1462435,"Japan",145303453,14.195613412656,18.7842192059707
"5232","Lebanon",1985,97317136,1204646,"Japan",98521782,14.0016963058127,18.3934856467577
"5233","Lebanon",1986,70937441,834477,"Japan",71771918,13.6345604602902,18.0773089339216
"5234","Lebanon",1987,53279348,1671047,"Japan",54950395,14.3289609340521,17.7910593468843
"5235","Lebanon",1988,77586040,2917558,"Japan",80503598,14.8862575229795,18.1668980720628
"5236","Lebanon",1989,70501794,5677139,"Japan",76178933,15.5519579666162,18.0711487142672
"5237","Lebanon",1990,88064797,4117999,"Japan",92182796,15.2308779237335,18.2935834310303
"5238","Lebanon",1991,107447320,1412829,"Japan",108860149,14.161104635235,18.4925112389083
"5239","Lebanon",1992,137376203,1965751,"Japan",139341954,14.4913849185653,18.7382337277016
"5240","Lebanon",1993,128016697,27698510,"Japan",155715207,17.1368891790971,18.6676712586891
"5241","Lebanon",1994,125515988,3001760,"Japan",128517748,14.9147093412774,18.6479437028444
"5242","Lebanon",1995,141758280,5485327,"Japan",147243607,15.5175872670521,18.7696339115646
"5243","Lebanon",1996,139827018,2890474,"Japan",142717492,14.8769310604806,18.7559166308939
"5244","Lebanon",1997,267646911,3274258,"Japan",270921169,15.0016018364963,19.4051791735452
"5245","Lebanon",1998,189032000,3337000,"Japan",192369000,15.0205827577335,19.0574268708615
"5246","Lebanon",1999,235281820,4625759,"Japan",239907579,15.3471510235725,19.2762945876442
"5247","Lebanon",2000,193090030,5607040,"Japan",198697070,15.5395335090201,19.0786671147867
"5248","Lebanon",2001,213222373,4091962,"Japan",217314335,15.224535119598,19.1778461837746
"5249","Lebanon",2002,197589712,4453617,"Japan",202043329,15.3092271329808,19.1017032771453
"5250","Lebanon",2003,243522491,4113817,"Japan",247636308,15.22986186595,19.3107198617246
"5251","Lebanon",2004,313360696,5661736,"Japan",319022432,15.5492411169332,19.562865468407
"5252","Lebanon",2005,276855623,2827634,"Japan",279683257,14.8549508775382,19.4390067116645
"5253","Lebanon",2006,260005006,6505130,"Japan",266510136,15.6881016543563,19.3762114426406
"5254","Lebanon",2007,357014303,4656655,"Japan",361670958,15.3538079371932,19.6932864033671
"5255","Lebanon",2008,560208478,4151038,"Japan",564359516,15.2388689814139,20.1438195545565
"5256","Lebanon",2009,603284731,2273696,"Japan",605558427,14.6369172592196,20.2178998339576
"5257","Lebanon",2010,555053880,9026679,"Japan",564080559,16.0156950836613,20.1345757480797
"5258","Lebanon",2011,180694613,26867610,"Japan",207562223,17.1064320298549,19.0123189432752
"5259","Lebanon",2012,226717216,22386922,"Japan",249104138,16.923987507039,19.2392140543676
"5260","Lebanon",2013,253241243,36912308,"Japan",290153551,17.4240556035308,19.3498531220155
"5261","Lebanon",2014,364115670,31304501,"Japan",395420171,17.2592724470888,19.7129821498466
"5262","Lebanon",2015,470085391,15884625,"Japan",485970016,16.5808622182305,19.9684249191447
"5263","Lebanon",2016,560555393,26733633,"Japan",587289026,17.1014329935821,20.1444386234256
"5264","Lebanon",2017,504092731.5,14051264,"Japan",518143995.5,16.4582229141103,20.0382708001828
"5265","Liberia",1962,50805000,2615000,"Japan",53420000,14.7767746554812,17.7435053329021
"5266","Liberia",1963,3325000,6248000,"Japan",9573000,15.6477719705017,15.0169802320721
"5267","Liberia",1964,193790000,21619000,"Japan",215409000,16.8890831156366,19.0822856565024
"5268","Liberia",1965,371441000,17342000,"Japan",388783000,16.6686418629192,19.7329005938972
"5269","Liberia",1966,322919000,16967000,"Japan",339886000,16.6467808390251,19.5929120757441
"5270","Liberia",1967,393337000,12262000,"Japan",405599000,16.3220156073048,19.7901773087463
"5271","Liberia",1968,439058000,17281000,"Japan",456339000,16.6651181900361,19.9001420807636
"5272","Liberia",1969,481597000,39228000,"Japan",520825000,17.4849013354943,19.9926182227036
"5273","Liberia",1970,12212000,31918000,"Japan",44130000,17.2786806719413,16.3179296328369
"5274","Liberia",1971,994115000,73878000,"Japan",1067993000,18.1179256420031,20.7173634520938
"5275","Liberia",1972,13885000,72072000,"Japan",85957000,18.0931761773134,16.446319678723
"5276","Liberia",1973,12436000,46858000,"Japan",59294000,17.6626323098087,16.3361060501608
"5277","Liberia",1974,15558000,36115000,"Japan",51673000,17.4022188494671,16.5600855337489
"5278","Liberia",1975,19366000,16368000,"Japan",35734000,16.6108387671735,16.7790295091536
"5279","Liberia",1976,2809453000,66993000,"Japan",2876446000,18.0200986942851,21.7562556394213
"5280","Liberia",1977,40654000,11998000,"Japan",52652000,16.3002505271952,17.520607790101
"5281","Liberia",1978,1645658000,191208000,"Japan",1836866000,19.0688723987105,21.2214061411851
"5282","Liberia",1979,34617000,424913000,"Japan",459530000,19.8673950000512,17.3598554488449
"5283","Liberia",1980,38028000,338390000,"Japan",376418000,19.6397096344323,17.4538332884611
"5284","Liberia",1981,22589000,312321000,"Japan",334910000,19.5595420630281,16.9329736200894
"5285","Liberia",1982,1008535000,165867000,"Japan",1174402000,18.9266968203654,20.7317646197638
"5286","Liberia",1983,624358000,37693000,"Japan",662051000,17.4449849587857,20.2522344797692
"5287","Liberia",1984,854878647,90133425,"Japan",945012072,18.3168016304763,20.5664700834942
"5288","Liberia",1985,647140903,51401490,"Japan",698542393,17.7551777183321,20.2880746077347
"5289","Liberia",1986,461403325,87757952,"Japan",549161277,18.290093037287,19.9497831100065
"5290","Liberia",1987,882598681,16609530,"Japan",899208211,16.625487184982,20.5983811603504
"5291","Liberia",1988,562171284,32809905,"Japan",594981189,17.3062410094744,20.147317137224
"5292","Liberia",1989,665523584,6490487,"Japan",672014071,15.6858481243858,20.3160846331881
"5293","Liberia",1990,1095540254,166175,"Japan",1095706429,12.0207967289098,20.8145134611901
"5294","Liberia",1991,803894992,5005829,"Japan",808900821,15.4261135913812,20.5049792116482
"5295","Liberia",1992,1490645796,37804806,"Japan",1528450602,17.447946795365,21.1224752831386
"5296","Liberia",1993,2157109914,160881,"Japan",2157270795,11.9884202402402,21.4920351599397
"5297","Liberia",1994,2046239954,92115,"Japan",2046332069,11.4307930754316,21.439269777169
"5298","Liberia",1995,1806416100,86167,"Japan",1806502267,11.364042552727,21.3146106640746
"5299","Liberia",1996,808994602,45898838,"Japan",854893440,17.6419503588062,20.5113028025654
"5300","Liberia",1997,907006893,25747,"Japan",907032640,10.1560733944503,20.62566060783
"5301","Liberia",1998,904363000,0,"Japan",904363000,0,20.6227413864299
"5302","Liberia",1999,801961685,210226,"Japan",802171911,12.255938421498,20.5025713903753
"5303","Liberia",2000,730027320,77165,"Japan",730104485,11.2537012653349,20.408592516064
"5304","Liberia",2001,606109570,110276,"Japan",606219846,11.6107415931705,20.2225713362705
"5305","Liberia",2002,897666714,52293,"Japan",897719007,10.864617797883,20.6153094148371
"5306","Liberia",2003,633226199,19340,"Japan",633245539,9.86993076900728,20.2663382606679
"5307","Liberia",2004,925287387,73391,"Japan",925360778,11.2035565912809,20.6456149358716
"5308","Liberia",2005,1087833499,231237,"Japan",1088064736,12.3511984375783,20.8074539396619
"5309","Liberia",2006,871612334,7368263,"Japan",878980597,15.8126925511771,20.5858553119213
"5310","Liberia",2007,1190053820,124608,"Japan",1190178428,11.7329280887319,20.8972643699379
"5311","Liberia",2008,1222958680,41504722,"Japan",1264463402,17.5413177618606,20.924538907308
"5312","Liberia",2009,1486507337,817576,"Japan",1487324913,13.6140991437933,21.1196951361454
"5313","Liberia",2010,1955674631,432609,"Japan",1956107240,12.977589596723,21.3940010506528
"5314","Liberia",2011,3300224160,42745460,"Japan",3342969620,17.5707735488771,21.9172562303846
"5315","Liberia",2012,2298333331,5929,"Japan",2298339260,8.68761084370737,21.5554500585083
"5316","Liberia",2013,1751085852,786661,"Japan",1751872513,13.5755526849179,21.2835019193166
"5317","Liberia",2014,1046270128,540448,"Japan",1046810576,13.2001537042176,20.7684974178147
"5318","Liberia",2015,863900400,10925,"Japan",863911325,9.29880901996379,20.5769680423456
"5319","Liberia",2016,1097302465,182439,"Japan",1097484904,12.1141711495565,20.8161207003815
"5320","Liberia",2017,0,0,"0",0,0,0
"5321","Libya",1962,4306000,14000,"Japan",4320000,9.5468126085974,15.2755199569064
"5322","Libya",1963,7138000,8000,"Japan",7146000,8.98719682066197,15.7809431830322
"5323","Libya",1964,8420000,85000,"Japan",8505000,11.3504065354725,15.9461203862185
"5324","Libya",1965,12040000,188000,"Japan",12228000,12.1441972418121,16.3037449978449
"5325","Libya",1966,12641000,273000,"Japan",12914000,12.5172270741671,16.3524560574777
"5326","Libya",1967,18912000,82000,"Japan",18994000,11.3144745262464,16.755307199188
"5327","Libya",1968,23751000,501000,"Japan",24252000,13.124361380067,16.9831351928217
"5328","Libya",1969,32885000,2000,"Japan",32887000,7.60090245954208,17.3085271847176
"5329","Libya",1970,31129000,5289000,"Japan",36418000,15.4811397500481,17.2536504185481
"5330","Libya",1971,42536000,8716000,"Japan",51252000,15.9806709750466,17.5658613341663
"5331","Libya",1972,60585000,4793000,"Japan",65378000,15.3826670781418,17.9195578956478
"5332","Libya",1973,114813000,35052000,"Japan",149865000,17.3723432311579,18.5588152758566
"5333","Libya",1974,193089000,361749000,"Japan",554838000,19.706461159132,19.0786617804732
"5334","Libya",1975,293260000,281324000,"Japan",574584000,19.4550175879864,19.4965701455132
"5335","Libya",1976,266113000,206324000,"Japan",472437000,19.1449583067089,19.399431588569
"5336","Libya",1977,279858000,112044000,"Japan",391902000,18.5344022092541,19.4497928896359
"5337","Libya",1978,353718000,16228000,"Japan",369946000,16.6022487033085,19.6840105434661
"5338","Libya",1979,474487000,100833000,"Japan",575320000,18.4289762409765,19.9777447783787
"5339","Libya",1980,511202000,357897000,"Japan",869099000,19.6957557934714,20.052275373383
"5340","Libya",1981,640471000,350621000,"Japan",991092000,19.6752164259765,20.2777144011488
"5341","Libya",1982,284962000,46119000,"Japan",331081000,17.6467355705628,19.4678663960099
"5342","Libya",1983,363049000,4869000,"Japan",367918000,15.3983991351648,19.7100483693452
"5343","Libya",1984,579461738,437190,"Japan",579898928,12.9881231621959,20.1776101926799
"5344","Libya",1985,289620958,6485493,"Japan",296106451,15.6850783944315,19.4840835846419
"5345","Libya",1986,216938549,7028569,"Japan",223967118,15.7654936868787,19.1951246870687
"5346","Libya",1987,281421492,387262,"Japan",281808754,12.866856745533,19.4553640749946
"5347","Libya",1988,644238147,4982117,"Japan",649220264,15.4213654590729,20.2835790091901
"5348","Libya",1989,223838871,515482,"Japan",224354353,13.1528576642737,19.2264370250875
"5349","Libya",1990,230181124,129067,"Japan",230310191,11.7680869283577,19.2543770526276
"5350","Libya",1991,170261395,1043168,"Japan",171304563,13.8577727948374,18.952845431738
"5351","Libya",1992,140152500,631108,"Japan",140783608,13.3552322837715,18.7582416734467
"5352","Libya",1993,152063807,16660,"Japan",152080467,9.72076591572083,18.8398107736211
"5353","Libya",1994,165938835,546548,"Japan",166485383,13.2113774143977,18.9271298145659
"5354","Libya",1995,190409807,64044,"Japan",190473851,11.0673256261219,19.064689186348
"5355","Libya",1996,137863868,51389,"Japan",137915257,10.8471794207582,18.7417772924778
"5356","Libya",1997,108365931,2180063,"Japan",110545994,14.5948643334303,18.5010243079026
"5357","Libya",1998,106168000,2442000,"Japan",108610000,14.7083279336528,18.4805333030992
"5358","Libya",1999,43469641,1597216,"Japan",45066857,14.2837726716517,17.5875733443617
"5359","Libya",2000,93909290,8237119,"Japan",102146409,15.9241612048264,18.357839874322
"5360","Libya",2001,63942414,4218436,"Japan",68160850,15.2549750012033,17.9734934550278
"5361","Libya",2002,306336950,5565196,"Japan",311902146,15.5320427621974,19.5401961978934
"5362","Libya",2003,354298309,4530827,"Japan",358829136,15.3264150415034,19.6856497970329
"5363","Libya",2004,179604019,6673149,"Japan",186277168,15.7136024204241,19.0062650910876
"5364","Libya",2005,139578354,8471667,"Japan",148050021,15.9522378595419,18.7541366789633
"5365","Libya",2006,189413026,36953028,"Japan",226366054,17.42515815058,19.0594405114306
"5366","Libya",2007,250470154,3661957,"Japan",254132111,15.1135082619303,19.3388503256822
"5367","Libya",2008,361038863,7294419,"Japan",368333282,15.8026200931758,19.7044961642425
"5368","Libya",2009,240628397,1580266,"Japan",242208663,14.2731037452635,19.2987643803093
"5369","Libya",2010,348341484,1250374,"Japan",349591858,14.0389532645271,19.6686938324644
"5370","Libya",2011,17039714,422347,"Japan",17462061,12.9535825300169,16.651057295187
"5371","Libya",2012,115591879,220826554,"Japan",336418433,19.2128881278174,18.5655762608698
"5372","Libya",2013,341604467,308583408,"Japan",650187875,19.5475027310558,19.6491640964911
"5373","Libya",2014,180343380,36372233,"Japan",216715613,17.409316211834,19.0103732582359
"5374","Libya",2015,60526867,4644905,"Japan",65171772,15.3512814779219,17.9185979070702
"5375","Libya",2016,20729056,12995803,"Japan",33724859,16.3801370171459,16.8470469455073
"5376","Libya",2017,0,0,"0",0,0,0
"5377","Sri Lanka",1962,37488000,7258000,"Japan",44746000,15.7976148667552,17.4395314397297
"5378","Sri Lanka",1963,20621000,9619000,"Japan",30240000,16.0792508671348,16.8418205319824
"5379","Sri Lanka",1964,28170000,9619000,"Japan",37789000,16.0792508671348,17.1537681398526
"5380","Sri Lanka",1965,23355000,10122000,"Japan",33477000,16.1302218307562,16.9663216519183
"5381","Sri Lanka",1966,26416000,11070000,"Japan",37486000,16.2197493046848,17.089480445142
"5382","Sri Lanka",1967,20220000,12667000,"Japan",32887000,16.3545107444658,16.8221827715566
"5383","Sri Lanka",1968,19374000,12318000,"Japan",31692000,16.3265721652291,16.7794425189685
"5384","Sri Lanka",1969,31435000,12600000,"Japan",44035000,16.3492073719217,17.2634324797993
"5385","Sri Lanka",1970,33879000,17373000,"Japan",51252000,16.670427834876,17.3383059113739
"5386","Sri Lanka",1971,28496000,19002000,"Japan",47498000,16.7600547947488,17.1652742845116
"5387","Sri Lanka",1972,30129000,22795000,"Japan",52924000,16.9420517716297,17.2209987210436
"5388","Sri Lanka",1973,26033000,36526000,"Japan",62559000,17.4135348937341,17.0748755219625
"5389","Sri Lanka",1974,53451000,30727000,"Japan",84178000,17.2406523048699,17.7942759043342
"5390","Sri Lanka",1975,63615000,30763000,"Japan",94378000,17.2418232271048,17.9683598495589
"5391","Sri Lanka",1976,44913000,36718000,"Japan",81631000,17.4187776560023,17.6202378431001
"5392","Sri Lanka",1977,49411000,47105000,"Japan",96516000,17.6678897104649,17.7156836294352
"5393","Sri Lanka",1978,103674000,81931000,"Japan",185605000,18.2213879875848,18.4567619185233
"5394","Sri Lanka",1979,193863000,84359000,"Japan",278222000,18.2505920595454,19.0826622819941
"5395","Sri Lanka",1980,260373000,54923000,"Japan",315296000,17.8214427622811,19.3776257762869
"5396","Sri Lanka",1981,259209000,68072000,"Japan",327281000,18.0360765265115,19.3731452440618
"5397","Sri Lanka",1982,268844000,70885000,"Japan",339729000,18.0765694035339,19.4096418436936
"5398","Sri Lanka",1983,317237000,68983000,"Japan",386220000,18.0493706553942,19.5751596865718
"5399","Sri Lanka",1984,278157008,72273017,"Japan",350430025,18.0959614086172,19.4436962892068
"5400","Sri Lanka",1985,250822739,70021177,"Japan",320843916,18.0643082828325,19.3402570284824
"5401","Sri Lanka",1986,288677860,80522600,"Japan",369200460,18.2040484483288,19.4808219530884
"5402","Sri Lanka",1987,275118053,81762309,"Japan",356880362,18.2193269252146,19.4327108471514
"5403","Sri Lanka",1988,277976811,101690674,"Japan",379667485,18.4374461557324,19.4430482545067
"5404","Sri Lanka",1989,237499911,105749478,"Japan",343249389,18.4765834397083,19.2856778067021
"5405","Sri Lanka",1990,309924765,120692773,"Japan",430617538,18.6087588085502,19.5518401324402
"5406","Sri Lanka",1991,324778622,118416888,"Japan",443195510,18.5897219053779,19.5986543451201
"5407","Sri Lanka",1992,376910041,135736406,"Japan",512646447,18.7262253718008,19.7475170989013
"5408","Sri Lanka",1993,410294034,150736281,"Japan",561030315,18.8310423844552,19.8323846167266
"5409","Sri Lanka",1994,477090802,169894497,"Japan",646985299,18.9506881964766,19.9832173913233
"5410","Sri Lanka",1995,429648489,209325081,"Japan",638973570,19.1593990130128,19.8784779649013
"5411","Sri Lanka",1996,400654668,245506933,"Japan",646161601,19.318835745126,19.8086104371875
"5412","Sri Lanka",1997,482213749,203676907,"Japan",685890656,19.1320455070728,19.99389803637
"5413","Sri Lanka",1998,477093000,223526000,"Japan",700619000,19.2250382963482,19.9832219984022
"5414","Sri Lanka",1999,508967025,151597642,"Japan",660564667,18.8367404769619,20.0478937885262
"5415","Sri Lanka",2000,517996906,201960204,"Japan",719957110,19.1235812260555,20.0654798272329
"5416","Sri Lanka",2001,306644544,183193096,"Japan",489837640,19.0260513239047,19.5411997976067
"5417","Sri Lanka",2002,323834777,149734301,"Japan",473569078,18.8243729547397,19.5957439961583
"5418","Sri Lanka",2003,406430925,174495796,"Japan",580926721,18.977411207626,19.8229245463138
"5419","Sri Lanka",2004,375809738,176625700,"Japan",552435438,18.98954336216,19.7445935573274
"5420","Sri Lanka",2005,347466750,160568034,"Japan",508034784,18.8942282985697,19.6661795349379
"5421","Sri Lanka",2006,406504300,185174904,"Japan",591679204,19.036811363435,19.823105065002
"5422","Sri Lanka",2007,372616454,178396520,"Japan",551012974,18.9995192711935,19.7360601751138
"5423","Sri Lanka",2008,380046847,182960053,"Japan",563006900,19.0247783973596,19.7558050846651
"5424","Sri Lanka",2009,199281429,163019041,"Japan",362300470,18.9093775678995,19.1102285997074
"5425","Sri Lanka",2010,529963612,196029731,"Japan",725993343,19.0937768944667,20.0883189055497
"5426","Sri Lanka",2011,939988306,270360857,"Japan",1210349163,19.415268132039,20.6613779927254
"5427","Sri Lanka",2012,450091761,276938194,"Japan",727029955,19.4393049129014,19.9249620332745
"5428","Sri Lanka",2013,579531211,274598932,"Japan",854130143,19.4308221619971,20.1777300777925
"5429","Sri Lanka",2014,868654728,286136688,"Japan",1154791416,19.4719801846819,20.5824562832181
"5430","Sri Lanka",2015,1164535211,262903686,"Japan",1427438897,19.387298310142,20.8755878838431
"5431","Sri Lanka",2016,696981432,240319832,"Japan",937301264,19.2974812274719,20.3622693284847
"5432","Sri Lanka",2017,968377033,251339544,"Japan",1219716577,19.3423153478741,20.6911320663074
"5433","Lesotho",1962,0,0,"0",0,0,0
"5434","Lesotho",1963,0,0,"0",0,0,0
"5435","Lesotho",1964,0,0,"0",0,0,0
"5436","Lesotho",1965,0,0,"0",0,0,0
"5437","Lesotho",1966,0,0,"0",0,0,0
"5438","Lesotho",1967,0,0,"0",0,0,0
"5439","Lesotho",1968,0,0,"0",0,0,0
"5440","Lesotho",1969,0,0,"0",0,0,0
"5441","Lesotho",1970,0,0,"0",0,0,0
"5442","Lesotho",1971,0,0,"0",0,0,0
"5443","Lesotho",1972,0,0,"0",0,0,0
"5444","Lesotho",1973,0,0,"0",0,0,0
"5445","Lesotho",1974,0,0,"0",0,0,0
"5446","Lesotho",1975,0,0,"0",0,0,0
"5447","Lesotho",1976,0,0,"0",0,0,0
"5448","Lesotho",1977,0,0,"0",0,0,0
"5449","Lesotho",1978,0,0,"0",0,0,0
"5450","Lesotho",1979,0,0,"0",0,0,0
"5451","Lesotho",1980,0,0,"0",0,0,0
"5452","Lesotho",1981,0,0,"0",0,0,0
"5453","Lesotho",1982,0,0,"0",0,0,0
"5454","Lesotho",1983,0,0,"0",0,0,0
"5455","Lesotho",1984,0,0,"0",0,0,0
"5456","Lesotho",1985,0,0,"0",0,0,0
"5457","Lesotho",1986,0,0,"0",0,0,0
"5458","Lesotho",1987,0,0,"0",0,0,0
"5459","Lesotho",1988,0,0,"0",0,0,0
"5460","Lesotho",1989,0,0,"0",0,0,0
"5461","Lesotho",1990,0,0,"0",0,0,0
"5462","Lesotho",1991,0,0,"0",0,0,0
"5463","Lesotho",1992,0,0,"0",0,0,0
"5464","Lesotho",1993,0,0,"0",0,0,0
"5465","Lesotho",1994,0,0,"0",0,0,0
"5466","Lesotho",1995,0,0,"0",0,0,0
"5467","Lesotho",1996,0,0,"0",0,0,0
"5468","Lesotho",1997,0,0,"0",0,0,0
"5469","Lesotho",1998,0,0,"0",0,0,0
"5470","Lesotho",1999,0,0,"0",0,0,0
"5471","Lesotho",2000,2870056,14642,"Japan",2884698,9.59164939020659,14.8698420997406
"5472","Lesotho",2001,639418,94407,"Japan",733825,11.4553705019268,13.3683136666036
"5473","Lesotho",2002,432200,234697,"Japan",666897,12.3660505994822,12.9766437230549
"5474","Lesotho",2003,966941,665226,"Japan",1632167,13.4078821115262,13.7818927591304
"5475","Lesotho",2004,3370637,341382,"Japan",3712019,12.7407573638752,15.0306123052379
"5476","Lesotho",2005,1110630,306822,"Japan",1417452,12.6340230538574,13.9204379798505
"5477","Lesotho",2006,1968524,265307,"Japan",2233831,12.488642925002,14.492794581316
"5478","Lesotho",2007,1381284,951692,"Japan",2332976,13.7659967320148,14.1385240593299
"5479","Lesotho",2008,378409,1029461,"Japan",1407870,13.8445459222652,12.8437309002322
"5480","Lesotho",2009,467681,1134796,"Japan",1602477,13.9419634570604,13.055541718557
"5481","Lesotho",2010,796252,1381061,"Japan",2177313,14.1383626023066,13.5876709976393
"5482","Lesotho",2011,3580923,1214504,"Japan",4795427,14.0098463209554,15.0911311463758
"5483","Lesotho",2012,6206604,1355858,"Japan",7562462,14.119945022235,15.6411244444239
"5484","Lesotho",2013,10924372,583494,"Japan",11507866,13.2767894478795,16.2065068144562
"5485","Lesotho",2014,7672939,774831,"Japan",8447770,13.5604002200398,15.8532102811738
"5486","Lesotho",2015,5330142,1957106,"Japan",7287248,14.4869774094489,15.4888884374382
"5487","Lesotho",2016,5774142,363082,"Japan",6137224,12.8023839830533,15.5689002319057
"5488","Lesotho",2017,20915440.5,77959.5,"Japan",20993400,11.2639447400555,16.8559982240758
"5489","Lithuania",1962,0,0,"0",0,0,0
"5490","Lithuania",1963,0,0,"0",0,0,0
"5491","Lithuania",1964,0,0,"0",0,0,0
"5492","Lithuania",1965,0,0,"0",0,0,0
"5493","Lithuania",1966,0,0,"0",0,0,0
"5494","Lithuania",1967,0,0,"0",0,0,0
"5495","Lithuania",1968,0,0,"0",0,0,0
"5496","Lithuania",1969,0,0,"0",0,0,0
"5497","Lithuania",1970,0,0,"0",0,0,0
"5498","Lithuania",1971,0,0,"0",0,0,0
"5499","Lithuania",1972,0,0,"0",0,0,0
"5500","Lithuania",1973,0,0,"0",0,0,0
"5501","Lithuania",1974,0,0,"0",0,0,0
"5502","Lithuania",1975,0,0,"0",0,0,0
"5503","Lithuania",1976,0,0,"0",0,0,0
"5504","Lithuania",1977,0,0,"0",0,0,0
"5505","Lithuania",1978,0,0,"0",0,0,0
"5506","Lithuania",1979,0,0,"0",0,0,0
"5507","Lithuania",1980,0,0,"0",0,0,0
"5508","Lithuania",1981,0,0,"0",0,0,0
"5509","Lithuania",1982,0,0,"0",0,0,0
"5510","Lithuania",1983,0,0,"0",0,0,0
"5511","Lithuania",1984,0,0,"0",0,0,0
"5512","Lithuania",1985,0,0,"0",0,0,0
"5513","Lithuania",1986,0,0,"0",0,0,0
"5514","Lithuania",1987,0,0,"0",0,0,0
"5515","Lithuania",1988,0,0,"0",0,0,0
"5516","Lithuania",1989,0,0,"0",0,0,0
"5517","Lithuania",1990,0,0,"0",0,0,0
"5518","Lithuania",1991,0,0,"0",0,0,0
"5519","Lithuania",1992,3581800,10437853,"Japan",14019653,16.1609494679286,15.0913760253148
"5520","Lithuania",1993,8646164,33061061,"Japan",41707225,17.3138667430061,15.9726263123389
"5521","Lithuania",1994,5449635,32707394,"Japan",38157029,17.303111726515,15.5110591919196
"5522","Lithuania",1995,9060842,37357974,"Japan",46418816,17.4360569407324,16.0194726096832
"5523","Lithuania",1996,13695067,22720801,"Japan",36415868,16.9387914064775,16.4325462529638
"5524","Lithuania",1997,9918643,14110357,"Japan",24029000,16.4624196247137,16.109926675549
"5525","Lithuania",1998,5770000,14690000,"Japan",20460000,16.5026775481501,15.5681826384843
"5526","Lithuania",1999,8129985,13132884,"Japan",21262869,16.3906298718168,15.9110696365038
"5527","Lithuania",2000,91093062,11554099,"Japan",102647161,16.2625508237478,18.327392201262
"5528","Lithuania",2001,108534166,20822802,"Japan",129356968,16.8515591942283,18.5025755753853
"5529","Lithuania",2002,148216072,16553774,"Japan",164769846,16.6221246700448,18.8141817129894
"5530","Lithuania",2003,197850051,44433946,"Japan",242283997,17.6095142848329,19.1030199835667
"5531","Lithuania",2004,41719873,17733227,"Japan",59453100,16.6909506693852,17.5464881439887
"5532","Lithuania",2005,59108523,21308833,"Japan",80417356,16.8746322395532,17.8948856851766
"5533","Lithuania",2006,57968960,18372649,"Japan",76341609,16.7263736492992,17.875418252841
"5534","Lithuania",2007,78691193,20863168,"Japan",99554361,16.8534958656128,18.1810418011536
"5535","Lithuania",2008,69614740,27292329,"Japan",96907069,17.1221162316594,18.0584868844913
"5536","Lithuania",2009,24668360,26788881,"Japan",51457241,17.1034974713315,17.0210320087928
"5537","Lithuania",2010,31357801,27252624,"Japan",58610425,17.1206603680156,17.2609736298144
"5538","Lithuania",2011,43563383,51813148,"Japan",95376531,17.7631544974161,17.589727516007
"5539","Lithuania",2012,46729356,190804913,"Japan",237534269,19.0667620661228,17.6598831332848
"5540","Lithuania",2013,63312278,116883335,"Japan",180195613,18.5766868585383,17.9635898335504
"5541","Lithuania",2014,67530407,105635409,"Japan",173165816,18.4755041855318,18.0280885284838
"5542","Lithuania",2015,52084477,360313447,"Japan",412397924,19.7024848966983,17.7683775160716
"5543","Lithuania",2016,54106202,535720009,"Japan",589826211,20.099122211283,17.8064593768025
"5544","Lithuania",2017,43994314.5,348948771.5,"Japan",392943086,19.6704356828596,17.5995709676243
"5545","Luxembourg",1962,0,0,"0",0,0,0
"5546","Luxembourg",1963,0,0,"0",0,0,0
"5547","Luxembourg",1964,0,0,"0",0,0,0
"5548","Luxembourg",1965,0,0,"0",0,0,0
"5549","Luxembourg",1966,0,0,"0",0,0,0
"5550","Luxembourg",1967,0,0,"0",0,0,0
"5551","Luxembourg",1968,0,0,"0",0,0,0
"5552","Luxembourg",1969,0,0,"0",0,0,0
"5553","Luxembourg",1970,0,0,"0",0,0,0
"5554","Luxembourg",1971,0,0,"0",0,0,0
"5555","Luxembourg",1972,0,0,"0",0,0,0
"5556","Luxembourg",1973,0,0,"0",0,0,0
"5557","Luxembourg",1974,0,0,"0",0,0,0
"5558","Luxembourg",1975,0,0,"0",0,0,0
"5559","Luxembourg",1976,0,0,"0",0,0,0
"5560","Luxembourg",1977,0,0,"0",0,0,0
"5561","Luxembourg",1978,0,0,"0",0,0,0
"5562","Luxembourg",1979,0,0,"0",0,0,0
"5563","Luxembourg",1980,0,0,"0",0,0,0
"5564","Luxembourg",1981,0,0,"0",0,0,0
"5565","Luxembourg",1982,0,0,"0",0,0,0
"5566","Luxembourg",1983,0,0,"0",0,0,0
"5567","Luxembourg",1984,0,0,"0",0,0,0
"5568","Luxembourg",1985,0,0,"0",0,0,0
"5569","Luxembourg",1986,0,0,"0",0,0,0
"5570","Luxembourg",1987,0,0,"0",0,0,0
"5571","Luxembourg",1988,0,0,"0",0,0,0
"5572","Luxembourg",1989,0,0,"0",0,0,0
"5573","Luxembourg",1990,0,0,"0",0,0,0
"5574","Luxembourg",1991,0,0,"0",0,0,0
"5575","Luxembourg",1992,0,0,"0",0,0,0
"5576","Luxembourg",1993,0,0,"0",0,0,0
"5577","Luxembourg",1994,0,0,"0",0,0,0
"5578","Luxembourg",1995,0,0,"0",0,0,0
"5579","Luxembourg",1996,0,0,"0",0,0,0
"5580","Luxembourg",1997,0,0,"0",0,0,0
"5581","Luxembourg",1998,0,0,"0",0,0,0
"5582","Luxembourg",1999,223980706,40206949,"Japan",264187655,17.5095503993471,19.227070472181
"5583","Luxembourg",2000,109263484,50847592,"Japan",160111076,17.744343324372,18.5092728076649
"5584","Luxembourg",2001,174817643,48455027,"Japan",223272670,17.6961466473687,18.9792539485866
"5585","Luxembourg",2002,103182671,45207169,"Japan",148389840,17.6267662384205,18.4520114802455
"5586","Luxembourg",2003,136287633,52110742,"Japan",188398375,17.7688816658936,18.7302781588745
"5587","Luxembourg",2004,190594063,51226724,"Japan",241820787,17.7517719069646,19.0656563996961
"5588","Luxembourg",2005,185833228,45118977,"Japan",230952205,17.6248134920247,19.0403602058141
"5589","Luxembourg",2006,133353982,34805638,"Japan",168159620,17.3652899431165,18.7085176694138
"5590","Luxembourg",2007,56192714,48888718,"Japan",105081432,17.7050572120797,17.8442976623313
"5591","Luxembourg",2008,290906997,51494998,"Japan",342401995,17.7569952347033,19.4885141761153
"5592","Luxembourg",2009,219631038,44283182,"Japan",263914220,17.6061155241081,19.2074595964101
"5593","Luxembourg",2010,295902381,54260851,"Japan",350163232,17.809313548817,19.5055401639754
"5594","Luxembourg",2011,216119792,60459573,"Japan",276579365,17.91748548477,19.1913434045114
"5595","Luxembourg",2012,254807012,66711013,"Japan",321518025,18.0158806097001,19.3560170009069
"5596","Luxembourg",2013,144598086,67550209,"Japan",212148295,18.0283817163701,18.7894686310868
"5597","Luxembourg",2014,201020512,80499015,"Japan",281519527,18.2037555062891,19.1189175105679
"5598","Luxembourg",2015,446147404,71869869,"Japan",518017273,18.0903676667075,19.9161599576227
"5599","Luxembourg",2016,360209419,72973401,"Japan",433182820,18.1056055628508,19.7021961397257
"5600","Luxembourg",2017,612914399.5,82326129.5,"Japan",695240529,18.2261991061447,20.2337358422247
"5601","Latvia",1962,0,0,"0",0,0,0
"5602","Latvia",1963,0,0,"0",0,0,0
"5603","Latvia",1964,0,0,"0",0,0,0
"5604","Latvia",1965,0,0,"0",0,0,0
"5605","Latvia",1966,0,0,"0",0,0,0
"5606","Latvia",1967,0,0,"0",0,0,0
"5607","Latvia",1968,0,0,"0",0,0,0
"5608","Latvia",1969,0,0,"0",0,0,0
"5609","Latvia",1970,0,0,"0",0,0,0
"5610","Latvia",1971,0,0,"0",0,0,0
"5611","Latvia",1972,0,0,"0",0,0,0
"5612","Latvia",1973,0,0,"0",0,0,0
"5613","Latvia",1974,0,0,"0",0,0,0
"5614","Latvia",1975,0,0,"0",0,0,0
"5615","Latvia",1976,0,0,"0",0,0,0
"5616","Latvia",1977,0,0,"0",0,0,0
"5617","Latvia",1978,0,0,"0",0,0,0
"5618","Latvia",1979,0,0,"0",0,0,0
"5619","Latvia",1980,0,0,"0",0,0,0
"5620","Latvia",1981,0,0,"0",0,0,0
"5621","Latvia",1982,0,0,"0",0,0,0
"5622","Latvia",1983,0,0,"0",0,0,0
"5623","Latvia",1984,0,0,"0",0,0,0
"5624","Latvia",1985,0,0,"0",0,0,0
"5625","Latvia",1986,0,0,"0",0,0,0
"5626","Latvia",1987,0,0,"0",0,0,0
"5627","Latvia",1988,0,0,"0",0,0,0
"5628","Latvia",1989,0,0,"0",0,0,0
"5629","Latvia",1990,0,0,"0",0,0,0
"5630","Latvia",1991,0,0,"0",0,0,0
"5631","Latvia",1992,1738313,14343280,"Japan",16081593,16.4787920978037,14.3684256606527
"5632","Latvia",1993,1700622,16607638,"Japan",18308260,16.6253732679857,14.3465046244608
"5633","Latvia",1994,14112614,17971961,"Japan",32084575,16.7043233791275,16.4625795653525
"5634","Latvia",1995,9830103,7644665,"Japan",17474768,15.8495185768953,16.1009599701966
"5635","Latvia",1996,5334056,6663804,"Japan",11997860,15.7122010506316,15.4896224823566
"5636","Latvia",1997,8626065,7105222,"Japan",15731287,15.7763405646269,15.9702989915198
"5637","Latvia",1998,8665000,7548000,"Japan",16213000,15.8367931854706,15.9748024811318
"5638","Latvia",1999,6824798,4558555,"Japan",11383353,15.3325162453067,15.7360733015277
"5639","Latvia",2000,4678696,8273862,"Japan",12952558,15.9286119471117,15.35852999659
"5640","Latvia",2001,4775394,12081045,"Japan",16856439,16.307148253352,15.378987041582
"5641","Latvia",2002,9446265,15606651,"Japan",25052916,16.5632077275139,16.0611299832475
"5642","Latvia",2003,11525291,24625155,"Japan",36150446,17.0192790394189,16.2600543959859
"5643","Latvia",2004,12748850,32632345,"Japan",45381195,17.3008145323679,16.3609516294224
"5644","Latvia",2005,27320513,36654367,"Japan",63974880,17.4170431333596,17.123148369943
"5645","Latvia",2006,34307590,43090188,"Japan",77397778,17.5788058725437,17.3508771704556
"5646","Latvia",2007,58613482,40357990,"Japan",98971472,17.5132999504256,17.886475296345
"5647","Latvia",2008,47621035,31252657,"Japan",78873692,17.2576149545324,17.6787851333521
"5648","Latvia",2009,18674466,35997627,"Japan",54672093,17.3989635775811,16.7426676941968
"5649","Latvia",2010,22019805,47794739,"Japan",69814544,17.6824261286428,16.9074528336338
"5650","Latvia",2011,49976933,57588722,"Japan",107565655,17.868837307884,17.7270721169424
"5651","Latvia",2012,59306817,53838801,"Japan",113145618,17.8015049733648,17.8982348152023
"5652","Latvia",2013,49728779,68196927,"Japan",117925706,18.0379100631475,17.7220943778055
"5653","Latvia",2014,47009363,58845751,"Japan",105855114,17.8904301885542,17.6658573526001
"5654","Latvia",2015,50648783,59584264,"Japan",110233047,17.9029020703287,17.7404257607296
"5655","Latvia",2016,49178517,85360183,"Japan",134538700,18.2623903088168,17.7109674397633
"5656","Latvia",2017,44677426.5,93005262.5,"Japan",137682689,18.3481666355381,17.6149789320284
"5657","Morocco",1962,3131000,5117000,"Japan",8248000,15.4480788877872,14.9568630003085
"5658","Morocco",1963,2062000,3489000,"Japan",5551000,15.0651257201689,14.539186943559
"5659","Morocco",1964,2873000,5090000,"Japan",7963000,15.4427883885267,14.8708673379614
"5660","Morocco",1965,2495000,6804000,"Japan",9299000,15.7330212324979,14.7297992871678
"5661","Morocco",1966,3066000,8265000,"Japan",11331000,15.9275402892373,14.9358843384139
"5662","Morocco",1967,5265000,11045000,"Japan",16310000,16.2174883948364,15.4765917035502
"5663","Morocco",1968,6100000,13441000,"Japan",19541000,16.4138202950533,15.6237993291435
"5664","Morocco",1969,10714000,12011000,"Japan",22725000,16.3013334545366,16.187061855423
"5665","Morocco",1970,13356000,18054000,"Japan",31410000,16.7088778248402,16.4074762800457
"5666","Morocco",1971,13359000,14007000,"Japan",27366000,16.4550677626212,16.4077008729719
"5667","Morocco",1972,18303000,12707000,"Japan",31010000,16.3576635806867,16.7225755388021
"5668","Morocco",1973,24549000,27193000,"Japan",51742000,17.1184701452041,17.0161816781776
"5669","Morocco",1974,23953000,80692000,"Japan",104645000,18.2061499957364,16.991604134937
"5670","Morocco",1975,30091000,73270000,"Japan",103361000,18.1096618061361,17.2197366816864
"5671","Morocco",1976,47097000,46990000,"Japan",94087000,17.665445371079,17.6677198626906
"5672","Morocco",1977,91314000,39241000,"Japan",130555000,17.4852326765365,18.329814674445
"5673","Morocco",1978,66598000,50490000,"Japan",117088000,17.7372858548351,18.0141851050297
"5674","Morocco",1979,61245000,70177000,"Japan",131422000,18.0665311799842,17.9303927714039
"5675","Morocco",1980,54981000,85072000,"Japan",140053000,18.2590085147263,17.8224982289681
"5676","Morocco",1981,79773000,103361000,"Japan",183134000,18.4537382728744,18.1946956593035
"5677","Morocco",1982,102519000,107048000,"Japan",209567000,18.488787889967,18.4455587052183
"5678","Morocco",1983,84566000,110069000,"Japan",194635000,18.5166179998307,18.2530428525436
"5679","Morocco",1984,128382276,110764505,"Japan",239146781,18.5229169289682,18.6705229023089
"5680","Morocco",1985,50486759,124509081,"Japan",174995840,18.6398892109681,17.7372216618459
"5681","Morocco",1986,59777322,159447540,"Japan",219224862,18.8872255232675,17.9061369162255
"5682","Morocco",1987,48172310,135865720,"Japan",184038030,18.7271776030052,17.6902949326154
"5683","Morocco",1988,71664459,189566073,"Japan",261230532,19.0602481919001,18.0875054922982
"5684","Morocco",1989,76834650,191411701,"Japan",268246351,19.0699371688658,18.1571662682455
"5685","Morocco",1990,116800555,210833668,"Japan",327634223,19.1665800772484,18.5759783800594
"5686","Morocco",1991,135131413,270647827,"Japan",405779240,19.4163290023555,18.7217582925569
"5687","Morocco",1992,140935096,225118364,"Japan",366053460,19.2321368840687,18.7638100303096
"5688","Morocco",1993,105097843,239331389,"Japan",344429232,19.293359714356,18.4704023123254
"5689","Morocco",1994,112231279,257500282,"Japan",369731561,19.3665313732131,18.5360722911674
"5690","Morocco",1995,114688484,335447828,"Japan",450136312,19.6309769970677,18.5577301760129
"5691","Morocco",1996,140881784,368370870,"Japan",509252654,19.7246007875579,18.7634316853316
"5692","Morocco",1997,188189624,235520952,"Japan",423710576,19.2773104356162,19.0529606507583
"5693","Morocco",1998,201143000,262927000,"Japan",464070000,19.3873869850734,19.119526655854
"5694","Morocco",1999,224172410,285108543,"Japan",509280953,19.4683805183586,19.2279260012618
"5695","Morocco",2000,128790074,302765472,"Japan",431555546,19.5284690439637,18.6736943034475
"5696","Morocco",2001,119449157,259433526,"Japan",378882683,19.3740110659055,18.598401374365
"5697","Morocco",2002,196567359,292146339,"Japan",488713698,19.4927653956522,19.0965157244263
"5698","Morocco",2003,271940776,200297885,"Japan",472238661,19.115316241419,19.4210948652584
"5699","Morocco",2004,328274766,126341900,"Japan",454616666,18.654502282106,19.6093615168921
"5700","Morocco",2005,328716543,147776802,"Japan",476493345,18.8112135988145,19.6107063659351
"5701","Morocco",2006,371599854,177436709,"Japan",549036563,18.9941245342798,19.7333281720083
"5702","Morocco",2007,476587757,305168579,"Japan",781756336,19.5363748999121,19.9821624340908
"5703","Morocco",2008,673559590,322971218,"Japan",996530808,19.5930737688574,20.3280870280002
"5704","Morocco",2009,456579912,241441123,"Japan",698021035,19.3021362042321,19.9392742963484
"5705","Morocco",2010,406420340,226528165,"Japan",632948505,19.2383798439426,19.8228985021887
"5706","Morocco",2011,303676124,227976482,"Japan",531652606,19.2447530324757,19.5314723098692
"5707","Morocco",2012,402785503,224791835,"Japan",627577338,19.2306853541498,19.813914727595
"5708","Morocco",2013,181620620,258305735,"Japan",439926355,19.3696544606845,19.0174305639411
"5709","Morocco",2014,233382978,243337577,"Japan",476720555,19.3099602430126,19.2681913445659
"5710","Morocco",2015,257811250,261746472,"Japan",519557722,19.3828869291141,19.3677382859967
"5711","Morocco",2016,334813717,270666318,"Japan",605480035,19.4163973212797,19.6290848664691
"5712","Morocco",2017,351264555.5,247924947,"Japan",599189502.5,19.3286366252621,19.6770502168996
"5713","Moldova",1962,0,0,"0",0,0,0
"5714","Moldova",1963,0,0,"0",0,0,0
"5715","Moldova",1964,0,0,"0",0,0,0
"5716","Moldova",1965,0,0,"0",0,0,0
"5717","Moldova",1966,0,0,"0",0,0,0
"5718","Moldova",1967,0,0,"0",0,0,0
"5719","Moldova",1968,0,0,"0",0,0,0
"5720","Moldova",1969,0,0,"0",0,0,0
"5721","Moldova",1970,0,0,"0",0,0,0
"5722","Moldova",1971,0,0,"0",0,0,0
"5723","Moldova",1972,0,0,"0",0,0,0
"5724","Moldova",1973,0,0,"0",0,0,0
"5725","Moldova",1974,0,0,"0",0,0,0
"5726","Moldova",1975,0,0,"0",0,0,0
"5727","Moldova",1976,0,0,"0",0,0,0
"5728","Moldova",1977,0,0,"0",0,0,0
"5729","Moldova",1978,0,0,"0",0,0,0
"5730","Moldova",1979,0,0,"0",0,0,0
"5731","Moldova",1980,0,0,"0",0,0,0
"5732","Moldova",1981,0,0,"0",0,0,0
"5733","Moldova",1982,0,0,"0",0,0,0
"5734","Moldova",1983,0,0,"0",0,0,0
"5735","Moldova",1984,0,0,"0",0,0,0
"5736","Moldova",1985,0,0,"0",0,0,0
"5737","Moldova",1986,0,0,"0",0,0,0
"5738","Moldova",1987,0,0,"0",0,0,0
"5739","Moldova",1988,0,0,"0",0,0,0
"5740","Moldova",1989,0,0,"0",0,0,0
"5741","Moldova",1990,0,0,"0",0,0,0
"5742","Moldova",1991,0,0,"0",0,0,0
"5743","Moldova",1992,86168,84478,"Japan",170646,11.3442464244174,11.3640541580306
"5744","Moldova",1993,206554,597130,"Japan",803684,13.2998901241134,12.2383171584084
"5745","Moldova",1994,1020267,136966,"Japan",1157233,11.8274879988272,13.8355749157119
"5746","Moldova",1995,96667,169653,"Japan",266320,12.041510453522,11.4790273615645
"5747","Moldova",1996,3072369,115434,"Japan",3187803,11.656454217045,14.9379594832237
"5748","Moldova",1997,3196736,0,"Japan",3196736,0,14.9776408472159
"5749","Moldova",1998,704000,0,"Japan",704000,0,13.4645336351402
"5750","Moldova",1999,5910940,0,"Japan",5910940,0,15.5923154291882
"5751","Moldova",2000,2444258,3329,"Japan",2447587,8.11042723757502,14.7092521583502
"5752","Moldova",2001,7156236,94765,"Japan",7251001,11.4591554217604,15.783494702385
"5753","Moldova",2002,4968117,179166,"Japan",5147283,12.0960680293787,15.4185514530428
"5754","Moldova",2003,10676860,618643,"Japan",11295503,13.3352836486181,16.183589340777
"5755","Moldova",2004,14401658,285127,"Japan",14686785,12.5606899740294,16.4828538968071
"5756","Moldova",2005,19227820,1030267,"Japan",20258087,13.8453285499142,16.7718687466041
"5757","Moldova",2006,20358671,2178540,"Japan",22537211,14.5941654856288,16.829017472467
"5758","Moldova",2007,39607774,3188356,"Japan",42796130,14.9750159814156,17.4945359700891
"5759","Moldova",2008,75051912,4336761,"Japan",79388673,15.2826383140821,18.1336905920683
"5760","Moldova",2009,30538706,4449344,"Japan",34988050,15.3082672275453,17.2345054861957
"5761","Moldova",2010,30427506,8450956,"Japan",38878462,15.9497901290286,17.2308575599209
"5762","Moldova",2011,3411557,13386376,"Japan",16797933,16.4097480312965,15.0426793432909
"5763","Moldova",2012,2376074,13024736,"Japan",15400810,16.3823608766843,14.6809601037608
"5764","Moldova",2013,8858362,7595609,"Japan",16453971,15.8430808751292,15.9968724296431
"5765","Moldova",2014,24696751,13826286,"Japan",38523037,16.4420821209381,17.0221822544847
"5766","Moldova",2015,13189179,14581141,"Japan",27770320,16.4952395393703,16.3949072786319
"5767","Moldova",2016,3891509,14793869,"Japan",18685378,16.5097233961496,15.1743075581118
"5768","Moldova",2017,4549295.5,23613219.5,"Japan",28162515,16.9773172614764,15.3304829437741
"5769","Madagascar",1962,1870000,762000,"Japan",2632000,13.5437018346688,14.4414489888308
"5770","Madagascar",1963,1756000,614000,"Japan",2370000,13.3277502071293,14.3785490531772
"5771","Madagascar",1964,1664000,621000,"Japan",2285000,13.3390863609156,14.3247349003633
"5772","Madagascar",1965,2046000,1113000,"Japan",3159000,13.9225696302577,14.5313972254937
"5773","Madagascar",1966,3517000,1396000,"Japan",4913000,14.1491215623045,15.0731189114561
"5774","Madagascar",1967,3883000,1849000,"Japan",5732000,14.4301555103693,15.1721186087138
"5775","Madagascar",1968,4144000,2394000,"Japan",6538000,14.6884761651001,15.2371720629215
"5776","Madagascar",1969,4461000,3940000,"Japan",8401000,15.1866912812741,15.3108835141104
"5777","Madagascar",1970,4661000,6700000,"Japan",11361000,15.7176180843612,15.3547405753549
"5778","Madagascar",1971,4761000,9298000,"Japan",14059000,16.0453098812327,15.3759682881767
"5779","Madagascar",1972,8995000,11643000,"Japan",20638000,16.2702156990192,16.0121794253668
"5780","Madagascar",1973,9154000,13823000,"Japan",22977000,16.4418444294465,16.0297015001957
"5781","Madagascar",1974,13898000,20486000,"Japan",34384000,16.8352522839786,16.4472555028564
"5782","Madagascar",1975,14221000,18147000,"Japan",32368000,16.7140158157572,16.4702303033548
"5783","Madagascar",1976,10533000,34063000,"Japan",44596000,17.3437223091791,16.1700237438187
"5784","Madagascar",1977,13929000,36702000,"Japan",50631000,17.4183418074528,16.4494835556702
"5785","Madagascar",1978,28774000,23928000,"Japan",52702000,16.9905598792919,17.1749827595791
"5786","Madagascar",1979,38033000,36864000,"Japan",74897000,17.4227460230377,17.4539647618839
"5787","Madagascar",1980,27064000,57638000,"Japan",84702000,17.8696926303673,17.1137149894427
"5788","Madagascar",1981,14861000,47095000,"Japan",61956000,17.6676773962391,16.5142508897407
"5789","Madagascar",1982,22888000,40546000,"Japan",63434000,17.5179476900103,16.9461233137121
"5790","Madagascar",1983,29889000,44022000,"Japan",73911000,17.6002000669242,17.2130010776951
"5791","Madagascar",1984,9253421,36719238,"Japan",45972659,17.4188113718673,16.0405038789533
"5792","Madagascar",1985,10761678,27534289,"Japan",38295967,17.1309426586638,16.1915020484947
"5793","Madagascar",1986,22209381,40024798,"Japan",62234179,17.5050097699886,16.9160253251535
"5794","Madagascar",1987,14355700,45391350,"Japan",59747050,17.6308321162243,16.4796576338454
"5795","Madagascar",1988,22874350,38327592,"Japan",61201942,17.4616806125291,16.9455267534216
"5796","Madagascar",1989,22724291,38645475,"Japan",61369766,17.4699402498177,16.9389449984212
"5797","Madagascar",1990,35372727,28462010,"Japan",63834737,17.1640807735713,17.3814516574463
"5798","Madagascar",1991,24205076,33539877,"Japan",57744953,17.3282456470896,17.0020729211981
"5799","Madagascar",1992,24014297,28612313,"Japan",52626610,17.1693477076165,16.9941599192818
"5800","Madagascar",1993,44612460,24244345,"Japan",68856805,17.0036939522771,17.6135237501705
"5801","Madagascar",1994,34200161,33679090,"Japan",67879251,17.332387727971,17.3477409096241
"5802","Madagascar",1995,30695515,30223350,"Japan",60918865,17.2241253624043,17.2396271106799
"5803","Madagascar",1996,28438966,35046760,"Japan",63485726,17.3721937277998,17.1632708049951
"5804","Madagascar",1997,33288446,27781675,"Japan",61070121,17.1398871886492,17.3207209277767
"5805","Madagascar",1998,29778000,29989000,"Japan",59767000,17.2163412057211,17.2092804237976
"5806","Madagascar",1999,29485794,24645395,"Japan",54131189,17.020100625585,17.1994191460011
"5807","Madagascar",2000,19734245,30821976,"Japan",50556221,17.2437385000126,16.7978660094433
"5808","Madagascar",2001,20680498,31234303,"Japan",51914801,17.2570275039498,16.8447016885525
"5809","Madagascar",2002,9881352,31641095,"Japan",41522447,17.2699673083559,16.1061599024673
"5810","Madagascar",2003,19545231,28852407,"Japan",48397638,17.1777039789806,16.7882418760189
"5811","Madagascar",2004,25994336,30901383,"Japan",56895719,17.2463114981479,17.0733892261
"5812","Madagascar",2005,17617393,25647971,"Japan",43265364,17.0599750231384,16.6843972106584
"5813","Madagascar",2006,20816429,25962032,"Japan",46778461,17.072145721005,16.8512530886689
"5814","Madagascar",2007,50269115,21119600,"Japan",71388715,16.865712077229,17.7329014305804
"5815","Madagascar",2008,60623036,21793732,"Japan",82416768,16.8971329634809,17.9201855108209
"5816","Madagascar",2009,15084737,31441190,"Japan",46525927,17.2636293746818,16.5291939958857
"5817","Madagascar",2010,10556683,12612714,"Japan",23169397,16.3502159107944,16.1722696770511
"5818","Madagascar",2011,10031695,22279415,"Japan",32311110,16.9191737159461,16.1212601386813
"5819","Madagascar",2012,9587584,20604544,"Japan",30192128,16.8410221919593,16.0759794860274
"5820","Madagascar",2013,11996875,93966099,"Japan",105962974,18.3584446262486,16.3001567571713
"5821","Madagascar",2014,15284182,133291971,"Japan",148576153,18.7080525507767,16.5423289953555
"5822","Madagascar",2015,14196526,137237235,"Japan",151433761,18.7372216285642,16.468507844753
"5823","Madagascar",2016,12168797,100710304,"Japan",112879101,18.4277586761879,16.3143856104475
"5824","Madagascar",2017,33652716.5,129205722.5,"Japan",162858439,18.6769164401276,17.3316043388799
"5825","Mexico",1962,19601000,127782000,"Japan",147383000,18.6658362449177,16.7910911433074
"5826","Mexico",1963,25763000,134161000,"Japan",159924000,18.714551129238,17.0644499120469
"5827","Mexico",1964,28067000,144239000,"Japan",172306000,18.7869822039457,17.1501050669585
"5828","Mexico",1965,39104000,144794000,"Japan",183898000,18.7908226005933,17.4817353215134
"5829","Mexico",1966,45674000,177738000,"Japan",223412000,18.9958211138202,17.6370397661737
"5830","Mexico",1967,75323000,171808000,"Japan",247131000,18.9618881322044,18.1372960910184
"5831","Mexico",1968,106270000,172912000,"Japan",279182000,18.9682933525251,18.4814935833489
"5832","Mexico",1969,94231000,215567000,"Japan",309798000,19.1887823240596,18.3612597724582
"5833","Mexico",1970,86003000,151222000,"Japan",237225000,18.8342595137707,18.2698927373303
"5834","Mexico",1971,89878000,167485000,"Japan",257363000,18.9364043529805,18.3139637531424
"5835","Mexico",1972,115417000,201823000,"Japan",317240000,19.1229016336211,18.5640622148802
"5836","Mexico",1973,177759000,275538000,"Japan",453297000,19.4342361080801,18.9959392582772
"5837","Mexico",1974,223528000,309242000,"Japan",532770000,19.5496346998643,19.2250472438131
"5838","Mexico",1975,291579000,212219000,"Japan",503798000,19.1731293183074,19.4908215390446
"5839","Mexico",1976,294860000,248246000,"Japan",543106000,19.3299307479702,19.5020112253859
"5840","Mexico",1977,304547000,300967000,"Japan",605514000,19.5225111821513,19.534335984599
"5841","Mexico",1978,638755000,356039000,"Japan",994794000,19.6905508333779,20.2750315272402
"5842","Mexico",1979,841005000,483143000,"Japan",1324148000,19.9958232340505,20.5501081632228
"5843","Mexico",1980,1223439000,934212000,"Japan",2157651000,20.6552139511649,20.9249315826364
"5844","Mexico",1981,1705004000,1437417000,"Japan",3142421000,21.0861135898384,21.2568332937202
"5845","Mexico",1982,975948000,1522146000,"Japan",2498094000,21.1433870181979,20.6989198642695
"5846","Mexico",1983,578914000,1888968000,"Japan",2467882000,21.3592964851423,20.1766644925537
"5847","Mexico",1984,887932321,2059276276,"Japan",2947208597,21.4456204356897,20.6044060829618
"5848","Mexico",1985,994264108,1706105867,"Japan",2700369975,21.2574793397763,20.7175134315415
"5849","Mexico",1986,760678284,1320121055,"Japan",2080799339,21.0009892776731,20.4497210721695
"5850","Mexico",1987,790895334,1526588748,"Japan",2317484082,21.1463015066739,20.4886761958642
"5851","Mexico",1988,1057108287,1436735803,"Japan",2493844090,21.0856395739739,20.77880298608
"5852","Mexico",1989,744646660,1616297801,"Japan",2360944461,21.2034040628644,20.4284203819574
"5853","Mexico",1990,1145641101,1764205304,"Japan",2909846405,21.2909661732463,20.8592302307966
"5854","Mexico",1991,1874491533,1587748564,"Japan",3462240097,21.1855828522224,21.3516032771922
"5855","Mexico",1992,2530973879,1159281240,"Japan",3690255119,20.8710660293308,21.6518699980294
"5856","Mexico",1993,2741913750,984535297,"Japan",3726449047,20.7076803081179,21.7319219624496
"5857","Mexico",1994,4304263854,1236485360,"Japan",5540749214,20.9355388049851,22.1828719622949
"5858","Mexico",1995,3535708208,1483145136,"Japan",5018853344,21.1174307618004,21.9861794579548
"5859","Mexico",1996,3434027294,1709089072,"Japan",5143116366,21.2592263590897,21.9569995475555
"5860","Mexico",1997,4058150950,1108201165,"Japan",5166352115,20.8260039656513,22.1239932757854
"5861","Mexico",1998,4017105000,1212384000,"Japan",5229489000,20.9158545060961,22.1138273308916
"5862","Mexico",1999,4553467874,1571848893,"Japan",6125316767,21.1755184022874,22.239154949715
"5863","Mexico",2000,5795937056,2156534148,"Japan",7952471204,21.4917682088445,22.4804230014425
"5864","Mexico",2001,7234068135,1803961141,"Japan",9038029276,21.3132507178892,22.7020673891491
"5865","Mexico",2002,8368460846,1617977629,"Japan",9986438475,21.2044428291583,22.8477358151713
"5866","Mexico",2003,6802998696,1615902187,"Japan",8418900883,21.2031592673669,22.6406293366292
"5867","Mexico",2004,9498321246,1980352245,"Japan",11478673491,21.4065405673454,22.9743809089903
"5868","Mexico",2005,11702216993,2287689637,"Japan",13989906630,21.5508082530986,23.183044147381
"5869","Mexico",2006,13693275555,2549761265,"Japan",16243036820,21.6592655701653,23.3401707138799
"5870","Mexico",2007,14615217011,2746814330,"Japan",17362031341,21.7337076516769,23.4053290839112
"5871","Mexico",2008,13698539858,3270349163,"Japan",16968889021,21.9081625938311,23.3405550843924
"5872","Mexico",2009,9519749117,2422385562,"Japan",11942134679,21.6080186609849,22.9766343321461
"5873","Mexico",2010,12768071364,3048619818,"Japan",15816691182,21.8379548064597,23.270213466924
"5874","Mexico",2011,9832279618,3807379072,"Japan",13639658690,22.0602068817565,23.0089366483908
"5875","Mexico",2012,10072376631,4121964945,"Japan",14194341576,22.1395958150117,23.0330625268535
"5876","Mexico",2013,9404556183,3908119143,"Japan",13312675326,22.0863220576121,22.9644601091123
"5877","Mexico",2014,10172426619,4000420179,"Japan",14172846798,22.1096652372995,23.0429466241498
"5878","Mexico",2015,9959801433,4421173288,"Japan",14380974721,22.2096709475842,23.0218229718984
"5879","Mexico",2016,10113094829,5442270359,"Japan",15555365188,22.4174621561543,23.0370969387631
"5880","Mexico",2017,14564757173,4961015356.5,"Japan",19525772529.5,22.324876265705,23.4018705552655
"5881","Macedonia",1962,0,0,"0",0,0,0
"5882","Macedonia",1963,0,0,"0",0,0,0
"5883","Macedonia",1964,0,0,"0",0,0,0
"5884","Macedonia",1965,0,0,"0",0,0,0
"5885","Macedonia",1966,0,0,"0",0,0,0
"5886","Macedonia",1967,0,0,"0",0,0,0
"5887","Macedonia",1968,0,0,"0",0,0,0
"5888","Macedonia",1969,0,0,"0",0,0,0
"5889","Macedonia",1970,0,0,"0",0,0,0
"5890","Macedonia",1971,0,0,"0",0,0,0
"5891","Macedonia",1972,0,0,"0",0,0,0
"5892","Macedonia",1973,0,0,"0",0,0,0
"5893","Macedonia",1974,0,0,"0",0,0,0
"5894","Macedonia",1975,0,0,"0",0,0,0
"5895","Macedonia",1976,0,0,"0",0,0,0
"5896","Macedonia",1977,0,0,"0",0,0,0
"5897","Macedonia",1978,0,0,"0",0,0,0
"5898","Macedonia",1979,0,0,"0",0,0,0
"5899","Macedonia",1980,0,0,"0",0,0,0
"5900","Macedonia",1981,0,0,"0",0,0,0
"5901","Macedonia",1982,0,0,"0",0,0,0
"5902","Macedonia",1983,0,0,"0",0,0,0
"5903","Macedonia",1984,0,0,"0",0,0,0
"5904","Macedonia",1985,0,0,"0",0,0,0
"5905","Macedonia",1986,0,0,"0",0,0,0
"5906","Macedonia",1987,0,0,"0",0,0,0
"5907","Macedonia",1988,0,0,"0",0,0,0
"5908","Macedonia",1989,0,0,"0",0,0,0
"5909","Macedonia",1990,0,0,"0",0,0,0
"5910","Macedonia",1991,0,0,"0",0,0,0
"5911","Macedonia",1992,0,0,"0",0,0,0
"5912","Macedonia",1993,3072084,12827142,"Japan",15899226,16.3670739526191,14.9378667166259
"5913","Macedonia",1994,11556221,9446316,"Japan",21002537,16.0611353821922,16.2627344646498
"5914","Macedonia",1995,13140481,5041895,"Japan",18182376,15.4332925614437,16.3912081761346
"5915","Macedonia",1996,14176029,7115739,"Japan",21291768,15.7778196491863,16.467062997536
"5916","Macedonia",1997,10470693,8686174,"Japan",19156867,15.977243124112,16.1640907697681
"5917","Macedonia",1998,9643000,9419000,"Japan",19062000,16.058239483805,16.0817428214925
"5918","Macedonia",1999,18212204,3056637,"Japan",21268841,14.9328258499558,16.7176024767797
"5919","Macedonia",2000,19727411,5255159,"Japan",24982570,15.4747208187336,16.7975196478984
"5920","Macedonia",2001,18051827,3394917,"Japan",21446744,15.0377898709589,16.7087574564574
"5921","Macedonia",2002,20205932,6199534,"Japan",26405466,15.6399846859002,16.8214867826271
"5922","Macedonia",2003,17225259,3354689,"Japan",20579948,15.0258696266248,16.6618874110354
"5923","Macedonia",2004,21806120,6307647,"Japan",28113767,15.6572732648144,16.8977012223059
"5924","Macedonia",2005,20613894,10401529,"Japan",31015423,16.1574633725361,16.8414758724292
"5925","Macedonia",2006,24264335,5105041,"Japan",29369376,15.4457390408905,17.0045181347175
"5926","Macedonia",2007,34977985,5832706,"Japan",40810691,15.5789916015853,17.3702294215502
"5927","Macedonia",2008,49425297,11374706,"Japan",60800003,16.2469026763134,17.7159729361076
"5928","Macedonia",2009,46872301,13846817,"Japan",60719118,16.4435659446905,17.6629374619305
"5929","Macedonia",2010,7054469,9567966,"Japan",16622435,16.0739312016545,15.7691718746675
"5930","Macedonia",2011,6582763,11316657,"Japan",17899420,16.2417862691032,15.6999651239791
"5931","Macedonia",2012,5187241,12773085,"Japan",17960326,16.3628507806649,15.4617125145638
"5932","Macedonia",2013,4276466,14087826,"Japan",18364292,16.4608215781449,15.2686375255446
"5933","Macedonia",2014,8891375,14407226,"Japan",23298601,16.4832404442395,16.0005922636967
"5934","Macedonia",2015,8647702,10531808,"Japan",19179510,16.1699105692764,15.972804178873
"5935","Macedonia",2016,10087255,6665535,"Japan",16752790,15.712460778441,16.1267833037809
"5936","Macedonia",2017,48219601.5,4022576.5,"Japan",52242178,15.2074331756915,17.6912761664774
"5937","Mali",1962,62000,2000,"Japan",64000,7.60090245954208,11.0348896640272
"5938","Mali",1963,55000,0,"Japan",55000,0,10.9150884642146
"5939","Mali",1964,88000,149000,"Japan",237000,11.9117015849276,11.3850920934603
"5940","Mali",1965,13000,38000,"Japan",51000,10.5453414387085,9.47270463644367
"5941","Mali",1966,158000,180000,"Japan",338000,12.1007121298723,11.9703503120091
"5942","Mali",1967,864000,570000,"Japan",1434000,13.2533916398107,13.6693280477862
"5943","Mali",1968,168000,1713000,"Japan",1881000,14.3537567773063,12.0317192583854
"5944","Mali",1969,250000,2505000,"Japan",2755000,14.7337992925011,12.4292161968444
"5945","Mali",1970,602000,3758000,"Japan",4360000,15.1393974589555,13.308012724291
"5946","Mali",1971,927000,1680000,"Japan",2607000,14.3343043513794,13.739708844548
"5947","Mali",1972,753000,794000,"Japan",1547000,13.5848387402293,13.531820506782
"5948","Mali",1973,250000,2425000,"Japan",2675000,14.7013420823537,12.4292161968444
"5949","Mali",1974,2386000,568000,"Japan",2954000,13.2498766977033,14.68512888164
"5950","Mali",1975,2487000,850000,"Japan",3337000,13.6529916284665,14.7265877227855
"5951","Mali",1976,2658000,4876000,"Japan",7534000,15.3998357695833,14.7930845182553
"5952","Mali",1977,2550000,9229000,"Japan",11779000,16.0378612582477,14.7516039171346
"5953","Mali",1978,7274000,3711000,"Japan",10985000,15.1268119400427,15.7998169045291
"5954","Mali",1979,4841000,7311000,"Japan",12152000,15.8048906212755,15.3926318689218
"5955","Mali",1980,6711000,9264000,"Japan",15975000,16.0416464787949,15.7192585291404
"5956","Mali",1981,6632000,10025000,"Japan",16657000,16.1205925311569,15.7074169757973
"5957","Mali",1982,5323000,4133000,"Japan",9456000,15.2345140934939,15.4875476121549
"5958","Mali",1983,9746000,7520000,"Japan",17266000,15.833076695926,16.0923675023856
"5959","Mali",1984,3233274,2789813,"Japan",6023087,14.8414851264617,14.9890058041217
"5960","Mali",1985,5027584,10421,"Japan",5038005,9.25157827999243,15.4304501085948
"5961","Mali",1986,8522741,2382796,"Japan",10905537,14.6837851460379,15.9582485606818
"5962","Mali",1987,7968353,1852292,"Japan",9820645,14.4319343491467,15.8909883794741
"5963","Mali",1988,9404258,700880,"Japan",10105138,13.4600919673402,16.0566731233997
"5964","Mali",1989,7594131,1408979,"Japan",9003110,14.1583758865824,15.842886270086
"5965","Mali",1990,8688031,3090902,"Japan",11778933,14.9439735156618,15.9774568892895
"5966","Mali",1991,9132861,5129054,"Japan",14261915,15.4504317946841,16.0273895660244
"5967","Mali",1992,11401885,4061763,"Japan",15463648,15.2171276737778,16.249289250573
"5968","Mali",1993,11571100,2835172,"Japan",14406272,14.8576131634976,16.2640211681165
"5969","Mali",1994,13189424,3473600,"Japan",16663024,15.0607020781062,16.3949258542934
"5970","Mali",1995,13560666,1981117,"Japan",15541783,14.4991713850169,16.4226839543147
"5971","Mali",1996,14789220,1708954,"Japan",16498174,14.3513920454101,16.5094090949596
"5972","Mali",1997,10438739,661639,"Japan",11100378,13.4024753689591,16.161034347683
"5973","Mali",1998,9829000,528000,"Japan",10357000,13.1768515626884,16.1008477575488
"5974","Mali",1999,7592150,819217,"Japan",8411367,13.6161042850052,15.8426253767163
"5975","Mali",2000,5692663,1137894,"Japan",6830557,13.9446897434601,15.5546887106778
"5976","Mali",2001,6073894,245324,"Japan",6319218,12.410335064841,15.6195104730032
"5977","Mali",2002,5683180,476036,"Japan",6159216,13.0732487606058,15.5530214931896
"5978","Mali",2003,5259911,274828,"Japan",5534739,12.523900726425,15.4756246644187
"5979","Mali",2004,4780070,177202,"Japan",4957272,12.0850456037711,15.3799657487119
"5980","Mali",2005,5268618,130749,"Japan",5399367,11.7810347337144,15.4772786470377
"5981","Mali",2006,5251028,311648,"Japan",5562676,12.6496296247609,15.4739344249234
"5982","Mali",2007,4697167,104487,"Japan",4801654,11.5568179407346,15.3624701189864
"5983","Mali",2008,7553946,185678,"Japan",7739624,12.131769269671,15.8375806336984
"5984","Mali",2009,12133626,975165,"Japan",13108791,13.7903619664313,16.3114911645271
"5985","Mali",2010,17877868,101767,"Japan",17979635,11.5304411655162,16.6990740812265
"5986","Mali",2011,7784998,118277,"Japan",7903275,11.6807846101006,15.8677091063459
"5987","Mali",2012,6642647,62471,"Japan",6705118,11.0424577280432,15.7090210865933
"5988","Mali",2013,7887606,108508,"Japan",7996114,11.5945791819634,15.880803224727
"5989","Mali",2014,6533419,130503,"Japan",6663922,11.7791514939864,15.6924409476916
"5990","Mali",2015,5832340,175667,"Japan",6008007,12.0763454363868,15.5789288500111
"5991","Mali",2016,7792128,169336,"Japan",7961464,12.0396401858,15.8686245512743
"5992","Mali",2017,46212716.5,1754781,"Japan",47967497.5,14.3778546207709,17.6487655670957
"5993","Malta",1962,3007000,70000,"Japan",3077000,11.1562505210315,14.9164534619707
"5994","Malta",1963,3467000,494000,"Japan",3961000,13.1102907961701,15.0588002246672
"5995","Malta",1964,3637000,273000,"Japan",3910000,12.5172270741671,15.1066697239691
"5996","Malta",1965,2975000,124000,"Japan",3099000,11.7280368445872,14.9057545969619
"5997","Malta",1966,3747000,230000,"Japan",3977000,12.3458345879053,15.1364660777758
"5998","Malta",1967,3915000,169000,"Japan",4084000,12.0376539939052,15.180325887407
"5999","Malta",1968,3366000,87000,"Japan",3453000,11.3736633976367,15.0292356537329
"6000","Malta",1969,3540000,24000,"Japan",3564000,10.0858091093301,15.07963728511
"6001","Malta",1970,4476000,103000,"Japan",4579000,11.5424842672118,15.314240348414
"6002","Malta",1971,4220000,34000,"Japan",4254000,10.4341158035983,15.2553456860122
"6003","Malta",1972,4371000,36000,"Japan",4407000,10.4912742174382,15.2905023738455
"6004","Malta",1973,5699000,104000,"Japan",5803000,11.5521461781235,15.5558012788171
"6005","Malta",1974,7755000,122000,"Japan",7877000,11.7117763237154,15.8638483545928
"6006","Malta",1975,10290000,792000,"Japan",11082000,13.5823166707966,16.1466831078102
"6007","Malta",1976,15872000,957000,"Japan",16829000,13.7715586704351,16.5800671085068
"6008","Malta",1977,16399000,1450000,"Japan",17849000,14.1870741143968,16.6127309153256
"6009","Malta",1978,17301000,350000,"Japan",17651000,12.7656884334656,16.6662748612657
"6010","Malta",1979,22144000,603000,"Japan",22747000,13.3096724757093,16.9130771373995
"6011","Malta",1980,33385000,1245000,"Japan",34630000,14.0346460878809,17.3236172552741
"6012","Malta",1981,45341000,520000,"Japan",45861000,13.1615840905576,17.6297222583805
"6013","Malta",1982,23831000,970000,"Japan",24801000,13.7850513504796,16.9864978121055
"6014","Malta",1983,10507000,585000,"Japan",11092000,13.279367126214,16.1675522596709
"6015","Malta",1984,4508534,1887645,"Japan",6396179,14.4508405783468,15.3214826032045
"6016","Malta",1985,6589939,866731,"Japan",7456670,13.6724839423379,15.7010546499867
"6017","Malta",1986,18842711,1039425,"Japan",19882136,13.8541782336051,16.7516367127265
"6018","Malta",1987,22378411,1198279,"Japan",23576690,13.9963969186902,16.9236072574337
"6019","Malta",1988,32173487,471370,"Japan",32644857,13.0633986272384,17.2866532862538
"6020","Malta",1989,31521749,4961254,"Japan",36483003,15.4171690893275,17.2661883099932
"6021","Malta",1990,67435580,7325434,"Japan",74761014,15.806862960259,18.026683329771
"6022","Malta",1991,75627578,4707323,"Japan",80334901,15.3646299392314,18.1413315629905
"6023","Malta",1992,88777584,4225283,"Japan",93002867,15.2565967987787,18.3016447436635
"6024","Malta",1993,53891838,7589978,"Japan",61481816,15.8423392508169,17.8024895958413
"6025","Malta",1994,50644024,5133617,"Japan",55777641,15.4513210369292,17.7403317955184
"6026","Malta",1995,67429428,9347343,"Japan",76776771,16.0506026897576,18.0265920978037
"6027","Malta",1996,80841518,15288580,"Japan",96130098,16.5426167024348,18.2080012281561
"6028","Malta",1997,83044872,7355729,"Japan",90400601,15.8109900233534,18.234891646181
"6029","Malta",1998,101097000,6432000,"Japan",107529000,15.6767960898409,18.4315910099599
"6030","Malta",1999,70301231,5163941,"Japan",75465172,15.4572106056317,18.0682998672961
"6031","Malta",2000,94497784,8740782,"Japan",103238566,15.9835102173134,18.3640869424536
"6032","Malta",2001,53270206,26992581,"Japan",80262787,17.1110726084325,17.7908877459779
"6033","Malta",2002,58289254,42579205,"Japan",100868459,17.5668765465179,17.8809283118613
"6034","Malta",2003,70158842,38500260,"Japan",108659102,17.466175552482,18.0662724007609
"6035","Malta",2004,71595432,54897707,"Japan",126493139,17.8209821387587,18.086541831013
"6036","Malta",2005,64750520,61178119,"Japan",125928639,17.9293001508728,17.9860522893997
"6037","Malta",2006,84635477,111789969,"Japan",196425446,18.5321323919408,18.2538640865557
"6038","Malta",2007,199826777,82960011,"Japan",282786788,18.2338692544796,19.112961434218
"6039","Malta",2008,222501193,169596245,"Japan",392097438,18.9489311407468,19.2204430213539
"6040","Malta",2009,203201715,117612344,"Japan",320814059,18.5829045539067,19.1297097135936
"6041","Malta",2010,168820945,82271047,"Japan",251091992,18.2255298054529,18.9443492141822
"6042","Malta",2011,437876870,122851204,"Japan",560728074,18.6264844574532,19.897448310098
"6043","Malta",2012,528052100,99643853,"Japan",627695953,18.4171129168198,20.084705511045
"6044","Malta",2013,173594944,167617526,"Japan",341212470,18.9371953109509,18.9722352353424
"6045","Malta",2014,59475430,96653294,"Japan",156128724,18.3866408447761,17.9010738440557
"6046","Malta",2015,362675393,143434555,"Japan",506109948,18.7813894264179,19.7090187580035
"6047","Malta",2016,486886194,140222112,"Japan",627108306,18.758738237675,20.0035409658526
"6048","Malta",2017,0,0,"0",0,0,0
"6049","Myanmar",1962,0,0,"0",0,0,0
"6050","Myanmar",1963,0,0,"0",0,0,0
"6051","Myanmar",1964,0,0,"0",0,0,0
"6052","Myanmar",1965,0,0,"0",0,0,0
"6053","Myanmar",1966,0,0,"0",0,0,0
"6054","Myanmar",1967,0,0,"0",0,0,0
"6055","Myanmar",1968,0,0,"0",0,0,0
"6056","Myanmar",1969,0,0,"0",0,0,0
"6057","Myanmar",1970,0,0,"0",0,0,0
"6058","Myanmar",1971,0,0,"0",0,0,0
"6059","Myanmar",1972,0,0,"0",0,0,0
"6060","Myanmar",1973,0,0,"0",0,0,0
"6061","Myanmar",1974,0,0,"0",0,0,0
"6062","Myanmar",1975,0,0,"0",0,0,0
"6063","Myanmar",1976,0,0,"0",0,0,0
"6064","Myanmar",1977,0,0,"0",0,0,0
"6065","Myanmar",1978,0,0,"0",0,0,0
"6066","Myanmar",1979,0,0,"0",0,0,0
"6067","Myanmar",1980,0,0,"0",0,0,0
"6068","Myanmar",1981,0,0,"0",0,0,0
"6069","Myanmar",1982,0,0,"0",0,0,0
"6070","Myanmar",1983,0,0,"0",0,0,0
"6071","Myanmar",1984,0,0,"0",0,0,0
"6072","Myanmar",1985,0,0,"0",0,0,0
"6073","Myanmar",1986,0,0,"0",0,0,0
"6074","Myanmar",1987,0,0,"0",0,0,0
"6075","Myanmar",1988,0,0,"0",0,0,0
"6076","Myanmar",1989,0,0,"0",0,0,0
"6077","Myanmar",1990,0,0,"0",0,0,0
"6078","Myanmar",1991,0,0,"0",0,0,0
"6079","Myanmar",1992,0,0,"0",0,0,0
"6080","Myanmar",1993,0,0,"0",0,0,0
"6081","Myanmar",1994,0,0,"0",0,0,0
"6082","Myanmar",1995,0,0,"0",0,0,0
"6083","Myanmar",1996,0,0,"0",0,0,0
"6084","Myanmar",1997,0,0,"0",0,0,0
"6085","Myanmar",1998,0,0,"0",0,0,0
"6086","Myanmar",1999,0,0,"0",0,0,0
"6087","Myanmar",2000,0,0,"0",0,0,0
"6088","Myanmar",2001,0,0,"0",0,0,0
"6089","Myanmar",2002,0,0,"0",0,0,0
"6090","Myanmar",2003,0,0,"0",0,0,0
"6091","Myanmar",2004,0,0,"0",0,0,0
"6092","Myanmar",2005,0,0,"0",0,0,0
"6093","Myanmar",2006,0,0,"0",0,0,0
"6094","Myanmar",2007,0,0,"0",0,0,0
"6095","Myanmar",2008,0,0,"0",0,0,0
"6096","Myanmar",2009,0,0,"0",0,0,0
"6097","Myanmar",2010,0,0,"0",0,0,0
"6098","Myanmar",2011,0,0,"0",0,0,0
"6099","Myanmar",2012,0,0,"0",0,0,0
"6100","Myanmar",2013,0,0,"0",0,0,0
"6101","Myanmar",2014,0,0,"0",0,0,0
"6102","Myanmar",2015,0,0,"0",0,0,0
"6103","Myanmar",2016,0,0,"0",0,0,0
"6104","Myanmar",2017,0,0,"0",0,0,0
"6105","Montenegro",1962,0,0,"0",0,0,0
"6106","Montenegro",1963,0,0,"0",0,0,0
"6107","Montenegro",1964,0,0,"0",0,0,0
"6108","Montenegro",1965,0,0,"0",0,0,0
"6109","Montenegro",1966,0,0,"0",0,0,0
"6110","Montenegro",1967,0,0,"0",0,0,0
"6111","Montenegro",1968,0,0,"0",0,0,0
"6112","Montenegro",1969,0,0,"0",0,0,0
"6113","Montenegro",1970,0,0,"0",0,0,0
"6114","Montenegro",1971,0,0,"0",0,0,0
"6115","Montenegro",1972,0,0,"0",0,0,0
"6116","Montenegro",1973,0,0,"0",0,0,0
"6117","Montenegro",1974,0,0,"0",0,0,0
"6118","Montenegro",1975,0,0,"0",0,0,0
"6119","Montenegro",1976,0,0,"0",0,0,0
"6120","Montenegro",1977,0,0,"0",0,0,0
"6121","Montenegro",1978,0,0,"0",0,0,0
"6122","Montenegro",1979,0,0,"0",0,0,0
"6123","Montenegro",1980,0,0,"0",0,0,0
"6124","Montenegro",1981,0,0,"0",0,0,0
"6125","Montenegro",1982,0,0,"0",0,0,0
"6126","Montenegro",1983,0,0,"0",0,0,0
"6127","Montenegro",1984,0,0,"0",0,0,0
"6128","Montenegro",1985,0,0,"0",0,0,0
"6129","Montenegro",1986,0,0,"0",0,0,0
"6130","Montenegro",1987,0,0,"0",0,0,0
"6131","Montenegro",1988,0,0,"0",0,0,0
"6132","Montenegro",1989,0,0,"0",0,0,0
"6133","Montenegro",1990,0,0,"0",0,0,0
"6134","Montenegro",1991,0,0,"0",0,0,0
"6135","Montenegro",1992,0,0,"0",0,0,0
"6136","Montenegro",1993,0,0,"0",0,0,0
"6137","Montenegro",1994,0,0,"0",0,0,0
"6138","Montenegro",1995,0,0,"0",0,0,0
"6139","Montenegro",1996,0,0,"0",0,0,0
"6140","Montenegro",1997,0,0,"0",0,0,0
"6141","Montenegro",1998,0,0,"0",0,0,0
"6142","Montenegro",1999,0,0,"0",0,0,0
"6143","Montenegro",2000,0,0,"0",0,0,0
"6144","Montenegro",2001,0,0,"0",0,0,0
"6145","Montenegro",2002,0,0,"0",0,0,0
"6146","Montenegro",2003,0,0,"0",0,0,0
"6147","Montenegro",2004,0,0,"0",0,0,0
"6148","Montenegro",2005,0,0,"0",0,0,0
"6149","Montenegro",2006,20737193,23812,"Japan",20761005,10.0779449342733,16.8474394092724
"6150","Montenegro",2007,51759482,2478,"Japan",51761960,7.81520706218909,17.7621182003789
"6151","Montenegro",2008,54005885,506235,"Japan",54512120,13.1347562673343,17.804603580072
"6152","Montenegro",2009,24471837,24960,"Japan",24496797,10.1250298224834,17.0130335041173
"6153","Montenegro",2010,23220830,889537,"Japan",24110367,13.6984563816254,16.9605602786426
"6154","Montenegro",2011,6684334,2284056,"Japan",8968390,14.6414633678463,15.7152771375268
"6155","Montenegro",2012,4932337,2038518,"Japan",6970855,14.5277336312245,15.4113234702102
"6156","Montenegro",2013,4144259,4060701,"Japan",8204960,15.2168661767724,15.2372345609684
"6157","Montenegro",2014,8745550,3162457,"Japan",11908007,14.9668598150875,15.9840555575389
"6158","Montenegro",2015,5164100,3438014,"Japan",8602114,15.0504045370516,15.4572413955946
"6159","Montenegro",2016,4872282,2769045,"Japan",7641327,14.8340130533753,15.3990729684702
"6160","Montenegro",2017,26374126,1441364.5,"Japan",27815490.5,14.1811007923361,17.0878940117707
"6161","Mongolia",1962,120000,55000,"Japan",175000,10.9150884642146,11.6952470217642
"6162","Mongolia",1963,464000,144000,"Japan",608000,11.8775685785581,13.0476398312084
"6163","Mongolia",1964,533000,194000,"Japan",727000,12.1756134380455,13.186276703148
"6164","Mongolia",1965,218000,239000,"Japan",457000,12.3842188309136,12.2922503417712
"6165","Mongolia",1966,188000,381000,"Japan",569000,12.8505546541088,12.1441972418121
"6166","Mongolia",1967,264000,659000,"Japan",923000,13.3984788134846,12.4837043821285
"6167","Mongolia",1968,387000,642000,"Japan",1029000,13.3723435826721,12.8661799720119
"6168","Mongolia",1969,396000,388000,"Japan",784000,12.8687606186054,12.8891694902366
"6169","Mongolia",1970,399000,643000,"Japan",1042000,13.3739000032198,12.896716695872
"6170","Mongolia",1971,388000,463000,"Japan",851000,13.0454823330684,12.8687606186054
"6171","Mongolia",1972,512000,574000,"Japan",1086000,13.2603846753017,13.1460799040216
"6172","Mongolia",1973,656000,955000,"Japan",1611000,13.7694666194629,13.3939160679262
"6173","Mongolia",1974,519000,1279000,"Japan",1798000,14.061589080561,13.159659162148
"6174","Mongolia",1975,807000,456000,"Japan",1263000,13.0302480884965,13.6010789472521
"6175","Mongolia",1976,469000,425000,"Japan",894000,12.9598444479066,13.0583580474284
"6176","Mongolia",1977,1391000,1535000,"Japan",2926000,14.2440409390034,14.1455334709056
"6177","Mongolia",1978,1992000,1754000,"Japan",3746000,14.3774094519143,14.5046497171267
"6178","Mongolia",1979,14350000,1199000,"Japan",15549000,13.9969984340097,16.4792605001699
"6179","Mongolia",1980,4297000,1247000,"Japan",5544000,14.0362512246622,15.2734276627571
"6180","Mongolia",1981,655000,3839000,"Japan",4494000,15.1607224739829,13.3923905146174
"6181","Mongolia",1982,1787000,8e+06,"Japan",9787000,15.8949520996441,14.3960487941416
"6182","Mongolia",1983,2763000,1988000,"Japan",4751000,14.5026396661987,14.8318276039056
"6183","Mongolia",1984,1585743,9524408,"Japan",11110151,16.0693683248145,14.2765636251714
"6184","Mongolia",1985,1948037,6804456,"Japan",8752493,15.7330882496525,14.4823327568441
"6185","Mongolia",1986,2845307,6190196,"Japan",9035503,15.6384773081336,14.8611815283325
"6186","Mongolia",1987,1945257,11757316,"Japan",13702573,16.2799862430935,14.4809046599819
"6187","Mongolia",1988,4251714,23772649,"Japan",28024363,16.9840462761224,15.262832753717
"6188","Mongolia",1989,7283605,35277128,"Japan",42560733,17.3787453798935,15.8011364899133
"6189","Mongolia",1990,14626218,16435763,"Japan",31061981,16.6149701893147,16.4983262296657
"6190","Mongolia",1991,46269824,19600543,"Japan",65870367,16.7910678278986,17.6500005571154
"6191","Mongolia",1992,37488093,38889869,"Japan",76377962,17.4762443376511,17.4395339205205
"6192","Mongolia",1993,19392464,23983814,"Japan",43376278,16.9928897441243,16.7803950949577
"6193","Mongolia",1994,24614541,51439504,"Japan",76054045,17.7559169955454,17.0188479238342
"6194","Mongolia",1995,42672930,82305022,"Japan",124977952,18.2259426844418,17.5690753193172
"6195","Mongolia",1996,59582092,81605442,"Japan",141187534,18.217406508887,17.9028656170868
"6196","Mongolia",1997,47022061,57534946,"Japan",104557007,17.8679030776801,17.6661274325273
"6197","Mongolia",1998,43582000,14106000,"Japan",57688000,16.4621107967503,17.590154779039
"6198","Mongolia",1999,56886435,11439873,"Japan",68326308,16.2526154424557,17.8565674699716
"6199","Mongolia",2000,28475998,8666322,"Japan",37142320,15.9749550372961,17.1645721149713
"6200","Mongolia",2001,51552644,9778158,"Japan",61330802,16.0956616807138,17.7581140571217
"6201","Mongolia",2002,30898977,6708322,"Japan",37607299,15.7188594031584,17.2462336345238
"6202","Mongolia",2003,61557491,6219934,"Japan",67777425,15.6432698537266,17.9354821091193
"6203","Mongolia",2004,74087813,7372450,"Japan",81460263,15.8132606376886,18.1207616098036
"6204","Mongolia",2005,81277210,5909875,"Japan",87187085,15.5921352385664,18.2133762154179
"6205","Mongolia",2006,102713219,7652827,"Japan",110366046,15.8505856800224,18.4474513813188
"6206","Mongolia",2007,127543838,14737410,"Japan",142281248,16.5058997169389,18.6639706909186
"6207","Mongolia",2008,228814532,32940568,"Japan",261755100,17.3102155260381,19.248422329439
"6208","Mongolia",2009,106179385,6618748,"Japan",112798133,15.7054167861599,18.4806405330518
"6209","Mongolia",2010,158745443,20810864,"Japan",179556307,16.8509857160087,18.8828124898133
"6210","Mongolia",2011,321480721,17635863,"Japan",339116584,16.6854450572284,19.5884481340585
"6211","Mongolia",2012,343616106,25782820,"Japan",369398926,17.0652189366148,19.6550356212482
"6212","Mongolia",2013,298827347,19051079,"Japan",317878426,16.7626342983529,19.5153765297927
"6213","Mongolia",2014,325120794,17098780,"Japan",342219574,16.6545176738985,19.5997073450865
"6214","Mongolia",2015,251009534,53808465,"Japan",304817999,17.8009413547625,19.3410014804384
"6215","Mongolia",2016,276627254,17490804,"Japan",294118058,16.6771858150635,19.4381815045174
"6216","Mongolia",2017,358478300.5,21007370.5,"Japan",379485671,16.8603839103004,19.6973786875807
"6217","Mozambique",1962,4626000,6762000,"Japan",11388000,15.72682926225,15.3472031217735
"6218","Mozambique",1963,6954000,7825000,"Japan",14779000,15.8728342943905,15.7548275915499
"6219","Mozambique",1964,7620000,16511000,"Japan",24131000,16.619537383414,15.8462869276628
"6220","Mozambique",1965,8883000,10937000,"Japan",19820000,16.2076620943174,15.9996498957518
"6221","Mozambique",1966,11117000,7156000,"Japan",18273000,15.7834617236107,16.2239860262158
"6222","Mozambique",1967,15467000,16516000,"Japan",31983000,16.6198401659881,16.5542192800203
"6223","Mozambique",1968,21788000,17679000,"Japan",39467000,16.6878880524882,16.8968699174857
"6224","Mozambique",1969,23231000,20094000,"Japan",43325000,16.8159318210044,16.9609981516031
"6225","Mozambique",1970,36899000,22584000,"Japan",59483000,16.9327522489155,17.4236950083725
"6226","Mozambique",1971,37391000,9397000,"Japan",46788000,16.0559010473652,17.4369405917147
"6227","Mozambique",1972,38519000,31335000,"Japan",69854000,17.2602462416409,17.4666621840172
"6228","Mozambique",1973,39414000,24307000,"Japan",63721000,17.0062749326714,17.4896316411027
"6229","Mozambique",1974,36593000,83344000,"Japan",119937000,18.2384871789671,17.4153675232491
"6230","Mozambique",1975,23833000,63347000,"Japan",87180000,17.9641381076511,16.9865817328843
"6231","Mozambique",1976,13342000,35687000,"Japan",49029000,17.3902970347745,16.4064275122516
"6232","Mozambique",1977,16201000,36977000,"Japan",53178000,17.4258066557001,16.6005835266926
"6233","Mozambique",1978,30917000,43538000,"Japan",74455000,17.589144677943,17.2468167523967
"6234","Mozambique",1979,10102000,38362000,"Japan",48464000,17.4625779442638,16.1282439820101
"6235","Mozambique",1980,35135000,18915000,"Japan",54050000,16.7554658160493,17.3747083426084
"6236","Mozambique",1981,15310000,27201000,"Japan",42511000,17.1187642952963,16.5440167676339
"6237","Mozambique",1982,17784000,22226000,"Japan",40010000,16.9167733327277,16.6938097346262
"6238","Mozambique",1983,23559000,15961000,"Japan",39520000,16.5856588046647,16.9750184710251
"6239","Mozambique",1984,11558151,12825783,"Japan",24383934,16.3669679997891,16.2629014603186
"6240","Mozambique",1985,11999554,13199755,"Japan",25199309,16.3957088267783,16.3003800403949
"6241","Mozambique",1986,18494410,15818813,"Japan",34313223,16.5767104858832,16.7329790822262
"6242","Mozambique",1987,25813951,18877296,"Japan",44691247,16.7534704880856,17.0664256401807
"6243","Mozambique",1988,25617747,22846487,"Japan",48464234,16.9443079216907,17.0587959114559
"6244","Mozambique",1989,39358241,15371437,"Japan",54729678,16.5480216049636,17.488215939109
"6245","Mozambique",1990,39981502,15024790,"Japan",55006292,16.5252120615824,17.5039274551152
"6246","Mozambique",1991,38626240,19955614,"Japan",58581854,16.8090210652224,17.4694423962267
"6247","Mozambique",1992,25210317,14124614,"Japan",39334931,16.4634295071897,17.0427638734603
"6248","Mozambique",1993,42069122,17359631,"Japan",59428753,16.6696580112102,17.5548245853703
"6249","Mozambique",1994,37657984,23249621,"Japan",60907605,16.9617993887895,17.4440555481619
"6250","Mozambique",1995,18214237,30184004,"Japan",48398241,17.2228226731468,16.7177140989941
"6251","Mozambique",1996,20671700,16532831,"Japan",37204531,16.620858719501,16.8442761730753
"6252","Mozambique",1997,23226933,16649540,"Japan",39876473,16.6278931463814,16.9608230684796
"6253","Mozambique",1998,21487000,18578000,"Japan",40065000,16.7374886429296,16.8829586590599
"6254","Mozambique",1999,66451408,16327435,"Japan",82778843,16.6083573797374,18.0119815317629
"6255","Mozambique",2000,48671731,20785030,"Japan",69456761,16.8497435740164,17.7006089472343
"6256","Mozambique",2001,10707492,19399148,"Japan",30106640,16.7807397055434,16.1864542413315
"6257","Mozambique",2002,80897664,17711672,"Japan",98609336,16.6897344152406,18.2086955064573
"6258","Mozambique",2003,33181298,12291021,"Japan",45472319,16.3243795537629,17.3174969619132
"6259","Mozambique",2004,26732966,16456383,"Japan",43189349,16.6162239842298,17.1014080434258
"6260","Mozambique",2005,68234767,14930902,"Japan",83165669,16.5189435829617,18.0384647729786
"6261","Mozambique",2006,45214939,13937013,"Japan",59151952,16.4500586648701,17.626938099046
"6262","Mozambique",2007,97935961,8639057,"Japan",106575018,15.9718039913051,18.3998243638537
"6263","Mozambique",2008,50453161,29717058,"Japan",80170219,17.2072317823352,17.7365559588962
"6264","Mozambique",2009,143770106,26458699,"Japan",170228805,17.091095546886,18.7837260956872
"6265","Mozambique",2010,92739640,9727834,"Japan",102467474,16.0905018188978,18.3453065550999
"6266","Mozambique",2011,108164318,6274158,"Japan",114438476,15.6519498507118,18.4991620917993
"6267","Mozambique",2012,136299303,40476263,"Japan",176775566,17.5162262614883,18.7303637829339
"6268","Mozambique",2013,202413086,68658819,"Japan",271071905,18.0446601451468,19.1258211474378
"6269","Mozambique",2014,190178614,56807943,"Japan",246986557,17.8551867154638,19.0634742622164
"6270","Mozambique",2015,138485936,77351919,"Japan",215837855,18.1638759439839,18.7462793333093
"6271","Mozambique",2016,51098550,127675602,"Japan",178774152,18.6650032455838,17.7492666790375
"6272","Mozambique",2017,102538317,95482283.5,"Japan",198020600.5,18.3744512751523,18.4457471110781
"6273","Mauritania",1962,34000,9000,"Japan",43000,9.10497985631836,10.4341158035983
"6274","Mauritania",1963,2000,0,"Japan",2000,0,7.60090245954208
"6275","Mauritania",1964,0,887000,"Japan",887000,13.6956002612917,0
"6276","Mauritania",1965,10000,0,"Japan",10000,0,9.21034037197618
"6277","Mauritania",1966,3000,756000,"Japan",759000,13.5357966551617,8.00636756765025
"6278","Mauritania",1967,20000,6551000,"Japan",6571000,15.695128267714,9.90348755253613
"6279","Mauritania",1968,21000,7961000,"Japan",7982000,15.8900651780707,9.95227771670556
"6280","Mauritania",1969,25000,5115000,"Japan",5140000,15.4476879573679,10.1266311038503
"6281","Mauritania",1970,18000,9171000,"Japan",9189000,16.0315568895411,9.7981270368783
"6282","Mauritania",1971,66000,10454000,"Japan",10520000,16.162495238255,11.0974100210086
"6283","Mauritania",1972,1017000,16641000,"Japan",17658000,16.6273800877055,13.8323676750307
"6284","Mauritania",1973,7610000,20871000,"Japan",28481000,16.8538711935739,15.8449737298379
"6285","Mauritania",1974,6918000,38787000,"Japan",45705000,17.4735956969048,15.7496372684793
"6286","Mauritania",1975,3853000,26987000,"Japan",30840000,17.1108658265377,15.1643626236083
"6287","Mauritania",1976,5763000,31854000,"Japan",37617000,17.2766735207939,15.5669687304188
"6288","Mauritania",1977,7914000,32290000,"Japan",40204000,17.2902681427345,15.8841439009275
"6289","Mauritania",1978,7411000,20264000,"Japan",27675000,16.8243564706636,15.8184759409335
"6290","Mauritania",1979,4488000,26236000,"Japan",30724000,17.0826430713958,15.3169177261847
"6291","Mauritania",1980,2861000,28926000,"Japan",31787000,17.1802514026158,14.8666817720322
"6292","Mauritania",1981,12844000,51960000,"Japan",64804000,17.7659847497667,16.3683873341915
"6293","Mauritania",1982,9442000,56920000,"Japan",66362000,17.8571573311859,16.0606783800884
"6294","Mauritania",1983,4164000,75487000,"Japan",79651000,18.1394710139632,15.241986708717
"6295","Mauritania",1984,4574434,56536341,"Japan",61110775,17.8503941928898,15.3359935331913
"6296","Mauritania",1985,3287424,80194465,"Japan",83481889,18.1999650554925,15.0056148373302
"6297","Mauritania",1986,7027061,125191066,"Japan",132218127,18.6453516562567,15.7652791109393
"6298","Mauritania",1987,4549990,132290090,"Japan",136840080,18.7005077207619,15.3306355931225
"6299","Mauritania",1988,4108656,167064740,"Japan",171173396,18.9338919599292,15.2286065256946
"6300","Mauritania",1989,5642206,170722873,"Japan",176365079,18.9555521741015,15.5457856817528
"6301","Mauritania",1990,6445921,106067756,"Japan",112513677,18.4795886554174,15.67895808562
"6302","Mauritania",1991,6190399,112568789,"Japan",118759188,18.5390750505224,15.6385101013879
"6303","Mauritania",1992,20789016,136562674,"Japan",157351690,18.7322942173952,16.8499353282667
"6304","Mauritania",1993,12968208,105253551,"Japan",118221759,18.471882768675,16.3780113817508
"6305","Mauritania",1994,29101895,127051741,"Japan",156153636,18.660104970903,17.1863138502964
"6306","Mauritania",1995,29011586,158738116,"Japan",187749702,18.8827663330924,17.1832058254064
"6307","Mauritania",1996,13929781,170256645,"Japan",184186426,18.9528175330692,16.4495396241679
"6308","Mauritania",1997,17519079,89861176,"Japan",107380255,18.3137765485449,16.6788010735976
"6309","Mauritania",1998,16092000,100393000,"Japan",116485000,18.4246030416757,16.5938328120518
"6310","Mauritania",1999,19796007,102917783,"Japan",122713790,18.4494410041431,16.8009908086606
"6311","Mauritania",2000,14527828,72191456,"Japan",86719284,18.0948322589104,16.4915765405461
"6312","Mauritania",2001,15523788,38795417,"Japan",54319205,17.4738126790603,16.5578841151035
"6313","Mauritania",2002,17769592,37820251,"Japan",55589843,17.4483552578727,16.6929992398222
"6314","Mauritania",2003,18275551,70711067,"Japan",88986618,18.07411265327,16.7210747136244
"6315","Mauritania",2004,28550961,101270691,"Japan",129821652,18.4333075986287,17.167201153745
"6316","Mauritania",2005,28691505,112323571,"Japan",141015076,18.5368942908276,17.1721116438839
"6317","Mauritania",2006,16165891,88872234,"Japan",105038125,18.3027103232405,16.5984140867071
"6318","Mauritania",2007,19136452,91339120,"Japan",110475572,18.3300897313415,16.7671055558549
"6319","Mauritania",2008,36566028,99504207,"Japan",136070235,18.415710482642,17.414630170609
"6320","Mauritania",2009,17011362,128082851,"Japan",145094213,18.6681878859303,16.6493920317133
"6321","Mauritania",2010,32011280,122294758,"Japan",154306038,18.6219447379236,17.2815988986505
"6322","Mauritania",2011,39766749,150429980,"Japan",190196729,18.8290082847218,17.4985416688086
"6323","Mauritania",2012,40411182,214262291,"Japan",254673473,19.182711481358,17.5146170868125
"6324","Mauritania",2013,45749098,148773047,"Japan",194522145,18.8179325282035,17.6386826336444
"6325","Mauritania",2014,26013490,105275056,"Japan",131288546,18.4720870639523,17.0741258075855
"6326","Mauritania",2015,10415394,130654857,"Japan",141070251,18.6880697249001,16.1587954620145
"6327","Mauritania",2016,11465169,128254030,"Japan",139719199,18.6695234645234,16.2548242146801
"6328","Mauritania",2017,39444769.5,139966460.5,"Japan",179411230,18.7569133840155,17.4904120109146
"6329","Malawi",1962,0,0,"0",0,0,0
"6330","Malawi",1963,0,0,"0",0,0,0
"6331","Malawi",1964,0,0,"0",0,0,0
"6332","Malawi",1965,3387000,324000,"Japan",3711000,12.6884987947745,15.0354551317999
"6333","Malawi",1966,3737000,14000,"Japan",3751000,9.5468126085974,15.1337937084676
"6334","Malawi",1967,5923000,645000,"Japan",6568000,13.3770055957779,15.5943536352591
"6335","Malawi",1968,3371000,259000,"Japan",3630000,12.4645833406817,15.0307199942162
"6336","Malawi",1969,3843000,53000,"Japan",3896000,10.8780471925343,15.161763869547
"6337","Malawi",1970,4495000,304000,"Japan",4799000,12.6247829803884,15.3184762258879
"6338","Malawi",1971,7901000,626000,"Japan",8527000,13.3471056500822,15.8824998917049
"6339","Malawi",1972,9404000,569000,"Japan",9973000,13.2516357131085,16.0566456886421
"6340","Malawi",1973,9155000,3086000,"Japan",12241000,14.9423863119052,16.0298107360907
"6341","Malawi",1974,10225000,3689000,"Japan",13914000,15.1208659765788,16.1403462598931
"6342","Malawi",1975,18471000,1500000,"Japan",19971000,14.2209756660724,16.7317124925615
"6343","Malawi",1976,15778000,2414000,"Japan",18192000,14.6967956806396,16.5741271226372
"6344","Malawi",1977,20387000,885000,"Japan",21272000,13.6933429239901,16.8304080007793
"6345","Malawi",1978,28640000,2167000,"Japan",30807000,14.5888542805185,17.1703149000567
"6346","Malawi",1979,37676000,2327000,"Japan",40003000,14.6600904422844,17.4445338449248
"6347","Malawi",1980,30821000,4356000,"Japan",35177000,15.287064763035,17.2437068337932
"6348","Malawi",1981,15237000,11145000,"Japan",26382000,16.2265015248021,16.5392372384515
"6349","Malawi",1982,13501000,12267000,"Japan",25768000,16.3224232880149,16.4182743147394
"6350","Malawi",1983,12527000,9533000,"Japan",22060000,16.0702700214757,16.3433968728263
"6351","Malawi",1984,13157146,10708757,"Japan",23865903,16.1865723759312,16.392475591041
"6352","Malawi",1985,16788029,10494019,"Japan",27282048,16.1663160337856,16.6361766308585
"6353","Malawi",1986,11658818,13414274,"Japan",25073092,16.4118299218534,16.2715733615354
"6354","Malawi",1987,15535219,22970156,"Japan",38505375,16.9497063661093,16.5586201979098
"6355","Malawi",1988,31733647,34134646,"Japan",65868293,17.3458234381934,17.2728880954984
"6356","Malawi",1989,22058424,32082847,"Japan",54141271,17.2838320839076,16.9092051277144
"6357","Malawi",1990,24924526,41958455,"Japan",66882981,17.5521905200328,17.0313628565802
"6358","Malawi",1991,40139189,68399632,"Japan",108538821,18.0408780024613,17.5078636968434
"6359","Malawi",1992,40150180,60665062,"Japan",100815242,17.9208785054737,17.508137481535
"6360","Malawi",1993,23555421,48207067,"Japan",71762488,17.6910161865307,16.9748665430196
"6361","Malawi",1994,28709632,46411357,"Japan",75120989,17.653054750178,17.1727432341816
"6362","Malawi",1995,13037892,46388308,"Japan",59426200,17.6525580026849,16.3833704449533
"6363","Malawi",1996,18697795,24156959,"Japan",42854754,17.0000830539034,16.7439161604339
"6364","Malawi",1997,28714470,40294612,"Japan",69009082,17.5117283207082,17.1729117348579
"6365","Malawi",1998,26629000,44582000,"Japan",71211000,17.612840748083,17.0975114054515
"6366","Malawi",1999,27531314,19960667,"Japan",47491981,16.8092742451229,17.1308346057291
"6367","Malawi",2000,25478112,46444797,"Japan",71922909,17.6537750040331,17.0533302885917
"6368","Malawi",2001,17252400,32813051,"Japan",50065451,17.3063368905561,16.6634618221987
"6369","Malawi",2002,15275950,23363586,"Japan",38639536,16.9666892144168,16.541790254214
"6370","Malawi",2003,19252683,24114772,"Japan",43367455,16.9983351567443,16.7731609856094
"6371","Malawi",2004,9749625,12008227,"Japan",21757852,16.3011025561807,16.0927393806959
"6372","Malawi",2005,5534990,29353181,"Japan",34888171,17.1949114799669,15.5266003174385
"6373","Malawi",2006,9429525,19097724,"Japan",28527249,16.7650797236128,16.0593562821851
"6374","Malawi",2007,7768355,23570589,"Japan",31338944,16.9755102639934,15.865568988218
"6375","Malawi",2008,12767797,27737860,"Japan",40505657,17.138308824958,16.3624366994225
"6376","Malawi",2009,16140615,34866116,"Japan",51006731,17.3670260273032,16.5968493241694
"6377","Malawi",2010,54506481,34529218,"Japan",89035699,17.3573164221361,17.8138301699945
"6378","Malawi",2011,20750293,27192261,"Japan",47942554,17.1184429687233,16.8480709250232
"6379","Malawi",2012,40096422,29808075,"Japan",69904497,17.2102898879234,17.5067976613632
"6380","Malawi",2013,44796165,23599315,"Japan",68395480,16.9767282441509,17.6176330910425
"6381","Malawi",2014,31494643,11070586,"Japan",42565229,16.2198022391465,17.2653280258414
"6382","Malawi",2015,29819703,14658113,"Japan",44477816,16.5005045285391,17.2106799074927
"6383","Malawi",2016,18656950,12176084,"Japan",30833034,16.3149842578772,16.7417292887913
"6384","Malawi",2017,42651303,11568928.5,"Japan",54220231.5,16.2638334846825,17.5685683824318
"6385","Malaysia",1962,80519000,262151000,"Japan",342670000,19.3844312315855,18.204003739384
"6386","Malaysia",1963,96332000,269990000,"Japan",366322000,19.4138954792397,18.3833111164824
"6387","Malaysia",1964,100985000,256137000,"Japan",357122000,19.3612230155488,18.4304825489246
"6388","Malaysia",1965,112710000,262567000,"Japan",375277000,19.3860168455235,18.5403287062183
"6389","Malaysia",1966,132266000,307152000,"Japan",439418000,19.5428532970295,18.7003256043716
"6390","Malaysia",1967,141291000,334501000,"Japan",475792000,19.6281504270647,18.7663321513587
"6391","Malaysia",1968,289285000,343386000,"Japan",632671000,19.6543657368138,19.4829229193107
"6392","Malaysia",1969,186244000,406773000,"Japan",593017000,19.8237658482546,19.0425681999399
"6393","Malaysia",1970,244744000,418925000,"Japan",663669000,19.8532024642511,19.3157233242634
"6394","Malaysia",1971,281423000,372957000,"Japan",654380000,19.7369736894613,19.4553694334907
"6395","Malaysia",1972,330808000,395501000,"Japan",726309000,19.7956638736138,19.6170487046182
"6396","Malaysia",1973,554640000,772219000,"Japan",1326859000,20.4647787465163,20.1338298125985
"6397","Malaysia",1974,916201000,976301000,"Japan",1892502000,20.6992814984707,20.6357463308811
"6398","Malaysia",1975,707625000,692154000,"Japan",1399779000,20.3553190321754,20.3774248503211
"6399","Malaysia",1976,810581000,1362228000,"Japan",2172809000,21.0323874315448,20.5132618324562
"6400","Malaysia",1977,1061672000,1560638000,"Japan",2622310000,21.1683605489596,20.7831108608377
"6401","Malaysia",1978,1154997000,1899723000,"Japan",3054720000,21.3649739230168,20.8673635835142
"6402","Malaysia",1979,1751150000,3257113000,"Japan",5008263000,21.9041070571428,21.2835385519152
"6403","Malaysia",1980,2463807000,3470856000,"Japan",5934663000,21.9676670863622,21.6249735516278
"6404","Malaysia",1981,2827132000,2926152000,"Japan",5753284000,21.796954086247,21.7625286071748
"6405","Malaysia",1982,3103856000,3009057000,"Japan",6112913000,21.8248925775854,21.8559110464387
"6406","Malaysia",1983,2769810000,3130260000,"Japan",5900070000,21.8643819051412,21.7420445627354
"6407","Malaysia",1984,3329002148,4016642300,"Japan",7345644448,22.1137121418065,21.9259384407779
"6408","Malaysia",1985,2618247310,3890736052,"Japan",6508983362,22.08186419313,21.6857709652132
"6409","Malaysia",1986,2003451739,3494430894,"Japan",5497882633,21.9744363650385,21.4181373994049
"6410","Malaysia",1987,2487833626,4341902148,"Japan",6829735774,22.1915783719901,21.6346781390086
"6411","Malaysia",1988,3529007153,4243015657,"Japan",7772022810,22.1685400932376,21.9842824085573
"6412","Malaysia",1989,4959137897,4644256494,"Japan",9603394391,22.258897130523,22.3244977514876
"6413","Malaysia",1990,6379073170,4899790177,"Japan",11278863347,22.3124582201257,22.5762886525904
"6414","Malaysia",1991,8629861514,5853500842,"Japan",14483362356,22.4903057537296,22.8784942948678
"6415","Malaysia",1992,9341442759,5938700686,"Japan",15280143445,22.5047562066633,22.9577265482428
"6416","Malaysia",1993,11299838954,6845189487,"Japan",18145028441,22.6468119778457,23.1480543107047
"6417","Malaysia",1994,14333927775,7404308809,"Japan",21738236584,22.7253279391888,23.3858951357863
"6418","Malaysia",1995,19047152442,9483691975,"Japan",28530844417,22.9728395262375,23.6701834492359
"6419","Malaysia",1996,17274183313,10579235924,"Japan",27853419237,23.0821590418651,23.5724789298242
"6420","Malaysia",1997,10277787596,7799837925,"Japan",18077625521,22.7773687915799,23.0532508594146
"6421","Malaysia",1998,11180598000,8390204000,"Japan",19570802000,22.8503306717902,23.137445791615
"6422","Malaysia",1999,12230121997,9989559714,"Japan",22219681711,23.024806355963,23.2271677618206
"6423","Malaysia",2000,15487526995,13153852392,"Japan",28641379387,23.299980510233,23.4633008269187
"6424","Malaysia",2001,12754711819,11551921797,"Japan",24306633616,23.1701176494237,23.2691665947138
"6425","Malaysia",2002,12719794042,10057527516,"Japan",22777321558,23.0315871976532,23.2664252030606
"6426","Malaysia",2003,12754145098,11293701847,"Japan",24047846945,23.1475110486101,23.2691221614409
"6427","Malaysia",2004,15265327331,12720797308,"Japan",27986124639,23.2665040743405,23.4488499061395
"6428","Malaysia",2005,14871788999,13173560525,"Japan",28045349524,23.3014776673402,23.4227318994623
"6429","Malaysia",2006,15586167412,13936578741,"Japan",29522746153,23.3577827846816,23.4696496534881
"6430","Malaysia",2007,16936443921,15399460548,"Japan",32335904469,23.4575983164018,23.5527335821147
"6431","Malaysia",2008,17427924573,20309212560,"Japan",37737137133,23.7343404407383,23.5813396172717
"6432","Malaysia",2009,13796842300,14597352995,"Japan",28394195295,23.4041060475112,23.347705584086
"6433","Malaysia",2010,18506288786,20043523514,"Japan",38549812300,23.7211719217597,23.6413764456445
"6434","Malaysia",2011,18196469458,27441201104,"Japan",45637670562,24.0353114108578,23.6244934263873
"6435","Malaysia",2012,17269990778,27581360269,"Japan",44851351047,24.0404060289438,23.5722361951153
"6436","Malaysia",2013,14661271049,25947485628,"Japan",40608756677,23.9793405489159,23.4084752314883
"6437","Malaysia",2014,13671044778,25812742256,"Japan",39483787034,23.974134092844,23.3385459132914
"6438","Malaysia",2015,11715433991,19844669846,"Japan",31560103837,23.7112012864091,23.1841729539733
"6439","Malaysia",2016,11769244440,16431929577,"Japan",28201174017,23.5224922044005,23.1887555624453
"6440","Malaysia",2017,13871893766,18506346552,"Japan",32378240318,23.641379567065,23.353130598795
"6441","Namibia",1962,0,0,"0",0,0,0
"6442","Namibia",1963,0,0,"0",0,0,0
"6443","Namibia",1964,0,0,"0",0,0,0
"6444","Namibia",1965,0,0,"0",0,0,0
"6445","Namibia",1966,0,0,"0",0,0,0
"6446","Namibia",1967,0,0,"0",0,0,0
"6447","Namibia",1968,0,0,"0",0,0,0
"6448","Namibia",1969,0,0,"0",0,0,0
"6449","Namibia",1970,0,0,"0",0,0,0
"6450","Namibia",1971,0,0,"0",0,0,0
"6451","Namibia",1972,0,0,"0",0,0,0
"6452","Namibia",1973,0,0,"0",0,0,0
"6453","Namibia",1974,0,0,"0",0,0,0
"6454","Namibia",1975,0,0,"0",0,0,0
"6455","Namibia",1976,0,0,"0",0,0,0
"6456","Namibia",1977,0,0,"0",0,0,0
"6457","Namibia",1978,0,0,"0",0,0,0
"6458","Namibia",1979,0,0,"0",0,0,0
"6459","Namibia",1980,0,0,"0",0,0,0
"6460","Namibia",1981,0,0,"0",0,0,0
"6461","Namibia",1982,0,0,"0",0,0,0
"6462","Namibia",1983,0,0,"0",0,0,0
"6463","Namibia",1984,0,0,"0",0,0,0
"6464","Namibia",1985,0,0,"0",0,0,0
"6465","Namibia",1986,0,0,"0",0,0,0
"6466","Namibia",1987,0,0,"0",0,0,0
"6467","Namibia",1988,0,0,"0",0,0,0
"6468","Namibia",1989,0,0,"0",0,0,0
"6469","Namibia",1990,0,0,"0",0,0,0
"6470","Namibia",1991,0,0,"0",0,0,0
"6471","Namibia",1992,0,0,"0",0,0,0
"6472","Namibia",1993,0,0,"0",0,0,0
"6473","Namibia",1994,0,0,"0",0,0,0
"6474","Namibia",1995,0,0,"0",0,0,0
"6475","Namibia",1996,0,0,"0",0,0,0
"6476","Namibia",1997,0,0,"0",0,0,0
"6477","Namibia",1998,0,0,"0",0,0,0
"6478","Namibia",1999,0,0,"0",0,0,0
"6479","Namibia",2000,12964211,13484945,"Japan",26449156,16.4170844359418,16.3777031189519
"6480","Namibia",2001,3408456,13999067,"Japan",17407523,16.4545012425017,15.0417699607974
"6481","Namibia",2002,3231227,19549387,"Japan",22780614,16.7884544884053,14.9883724992251
"6482","Namibia",2003,7142721,13664685,"Japan",20807406,16.430325325487,15.7816043541555
"6483","Namibia",2004,10933464,17462581,"Japan",28396045,16.6755709210477,16.2073387358344
"6484","Namibia",2005,8447012,27280121,"Japan",35727133,17.1216688264136,15.9493233273313
"6485","Namibia",2006,9679699,36611984,"Japan",46291683,17.4158861764715,16.085541363728
"6486","Namibia",2007,10933705,35972890,"Japan",46906595,17.3982761571761,16.2073607780109
"6487","Namibia",2008,13612698,49152320,"Japan",62765018,17.710434605885,16.4265135915721
"6488","Namibia",2009,9590028,38426104,"Japan",48016132,17.4642475782709,16.0762343665634
"6489","Namibia",2010,13827182,79744972,"Japan",93572154,18.1943442506197,16.4421469229369
"6490","Namibia",2011,19554560,40624276,"Japan",60178836,17.5198763769169,16.7887190652794
"6491","Namibia",2012,20329067,12778790,"Japan",33107857,16.3632973232451,16.8275622917821
"6492","Namibia",2013,34329652,11495331,"Japan",45824983,16.2574515108932,17.351520028476
"6493","Namibia",2014,37472054,13928322,"Japan",51400376,16.4494348790601,17.4391059864545
"6494","Namibia",2015,25844047,11701032,"Japan",37545079,16.2751876010063,17.0675908422625
"6495","Namibia",2016,28014057,8706827,"Japan",36720884,15.9796179885425,17.148216977876
"6496","Namibia",2017,28937223,7164898,"Japan",36102121,15.7847043832743,17.1806393174107
"6497","New Caledonia",1962,323000,12151000,"Japan",12474000,16.3129220288907,12.6854076022048
"6498","New Caledonia",1963,790000,14899000,"Japan",15689000,16.5168046545695,13.5797882244432
"6499","New Caledonia",1964,1644000,28852000,"Japan",30496000,17.1776898726057,14.3126428545983
"6500","New Caledonia",1965,1078000,26907000,"Japan",27985000,17.1078970337682,13.8906180304511
"6501","New Caledonia",1966,1195000,27238000,"Japan",28433000,17.120123615111,13.9936567433477
"6502","New Caledonia",1967,1845000,30934000,"Japan",32779000,17.2473664605802,14.4279898354568
"6503","New Caledonia",1968,3814000,54875000,"Japan",58689000,17.8205684293596,15.1541890651425
"6504","New Caledonia",1969,6487000,72931000,"Japan",79418000,18.1050243466448,15.6853107321952
"6505","New Caledonia",1970,6352000,109353000,"Japan",115705000,18.510091739553,15.6642802819091
"6506","New Caledonia",1971,5681000,106032000,"Japan",111713000,18.4792514933101,15.5526378315393
"6507","New Caledonia",1972,7179000,58523000,"Japan",65702000,17.8849303973272,15.7866706555586
"6508","New Caledonia",1973,3937000,76017000,"Japan",79954000,18.1464675574475,15.1859295699259
"6509","New Caledonia",1974,6184000,120926000,"Japan",127110000,18.6106893462277,15.6374758692494
"6510","New Caledonia",1975,18759000,94232000,"Japan",112991000,18.3612703846208,16.7471841952175
"6511","New Caledonia",1976,19372000,111827000,"Japan",131199000,18.5324635922116,16.7793392825053
"6512","New Caledonia",1977,11478000,116907000,"Japan",128385000,18.5768893048891,16.2559427176504
"6513","New Caledonia",1978,19573000,63483000,"Japan",83056000,17.966282711485,16.7896616234847
"6514","New Caledonia",1979,28139000,103031000,"Japan",131170000,18.450540471785,17.1526670724164
"6515","New Caledonia",1980,40733000,139802000,"Japan",180535000,18.7557376938133,17.5225491326941
"6516","New Caledonia",1981,39874000,115609000,"Japan",155483000,18.5657243658433,17.5012350403849
"6517","New Caledonia",1982,41943000,91655000,"Japan",133598000,18.3335420861356,17.5518221116381
"6518","New Caledonia",1983,16942000,63686000,"Japan",80628000,17.9694753161674,16.6453063039736
"6519","New Caledonia",1984,12025553,58299800,"Japan",70325353,17.8811092207831,16.3025443604247
"6520","New Caledonia",1985,7790390,69666259,"Japan",77456649,18.0592266695692,15.8684014807786
"6521","New Caledonia",1986,18230426,41587320,"Japan",59817746,17.5433058710759,16.7186025144564
"6522","New Caledonia",1987,21034340,46637243,"Japan",67671583,17.6579099859094,16.8616668982369
"6523","New Caledonia",1988,21701492,144448163,"Japan",166149655,18.7884312675925,16.8928915719075
"6524","New Caledonia",1989,30887176,212662921,"Japan",243550097,19.1752189396332,17.2458516395437
"6525","New Caledonia",1990,28212299,133876792,"Japan",162089091,18.7124304722635,17.155268575581
"6526","New Caledonia",1991,35360768,156932590,"Japan",192293358,18.8713269080525,17.3811135149549
"6527","New Caledonia",1992,43477982,119030997,"Japan",162508979,18.5948944961486,17.5877652069967
"6528","New Caledonia",1993,29859967,112154785,"Japan",142014752,18.5353904840925,17.2120292449173
"6529","New Caledonia",1994,26974370,110591637,"Japan",137566007,18.5213550293654,17.1103977138774
"6530","New Caledonia",1995,32098971,172939500,"Japan",205038471,18.9684523803162,17.2843345315117
"6531","New Caledonia",1996,33319742,156076214,"Japan",189395956,18.8658549971935,17.3216606321357
"6532","New Caledonia",1997,27054310,128885086,"Japan",155939396,18.6744317591208,17.11335688513
"6533","New Caledonia",1998,67851000,244036000,"Japan",311887000,19.312826313358,18.0328246825301
"6534","New Caledonia",1999,41638389,103023170,"Japan",144661559,18.4504644723524,17.5445331122018
"6535","New Caledonia",2000,30651305,176814645,"Japan",207465950,18.9906125384477,17.2381857969279
"6536","New Caledonia",2001,27330078,111989833,"Japan",139319911,18.5339186483532,17.1234984119068
"6537","New Caledonia",2002,32157270,98795916,"Japan",130953186,18.4085668258314,17.2861491106121
"6538","New Caledonia",2003,37101176,136964567,"Japan",174065743,18.7352328153041,17.4291592251885
"6539","New Caledonia",2004,45543399,210527882,"Japan",256071281,19.1651286583722,17.6341762534958
"6540","New Caledonia",2005,55848091,213212161,"Japan",269060252,19.1777982889669,17.8381459020538
"6541","New Caledonia",2006,57208710,237488253,"Japan",294696963,19.2856287191631,17.862216717485
"6542","New Caledonia",2007,65334807,474746575,"Japan",540081382,19.9782916933073,17.9950354843947
"6543","New Caledonia",2008,95353178,283171156,"Japan",378524334,19.4615620643143,18.3730982192927
"6544","New Caledonia",2009,68821167,126798871,"Japan",195620038,18.6581126961423,18.0470219154697
"6545","New Caledonia",2010,65130591,263218919,"Japan",328349510,19.3884966355312,17.9919049046408
"6546","New Caledonia",2011,43125479,377235477,"Japan",420360956,19.7483801578533,17.5796245405005
"6547","New Caledonia",2012,35909626,264710329,"Japan",300619955,19.3941466879698,17.3965159512218
"6548","New Caledonia",2013,26744205,236346097,"Japan",263090302,19.2808078014221,17.1018283723234
"6549","New Caledonia",2014,56851771,293519350,"Japan",350371121,19.497454123509,17.8559579298304
"6550","New Caledonia",2015,32641176,231794159,"Japan",264435335,19.2613602901055,17.3010851168229
"6551","New Caledonia",2016,32175832,169421865,"Japan",201597697,18.9479024050525,17.286726169698
"6552","New Caledonia",2017,0,0,"0",0,0,0
"6553","Niger",1962,18000,0,"Japan",18000,0,9.7981270368783
"6554","Niger",1963,6000,83000,"Japan",89000,11.3265958867787,8.69951474821019
"6555","Niger",1964,99000,124000,"Japan",223000,11.7280368445872,11.5028751291167
"6556","Niger",1965,259000,40000,"Japan",299000,10.5966347330961,12.4645833406817
"6557","Niger",1966,1615000,0,"Japan",1615000,0,14.2948455146389
"6558","Niger",1967,2210000,170000,"Japan",2380000,12.0435537160324,14.6085030734939
"6559","Niger",1968,1634000,261000,"Japan",1895000,12.4722756863048,14.3065415544021
"6560","Niger",1969,2515000,162000,"Japan",2677000,11.9953516142145,14.737783361516
"6561","Niger",1970,1251000,263000,"Japan",1514000,12.4799093111599,14.039453789449
"6562","Niger",1971,513000,704000,"Japan",1217000,13.4645336351402,13.1480311241529
"6563","Niger",1972,606000,156000,"Japan",762000,11.9576112862317,13.3146352650515
"6564","Niger",1973,638000,140000,"Japan",778000,11.8493977015914,13.3660935623269
"6565","Niger",1974,748000,19000,"Japan",767000,9.85219425814858,13.5251582569566
"6566","Niger",1975,1179000,647000,"Japan",1826000,13.380101573483,13.9801771795195
"6567","Niger",1976,3782000,347000,"Japan",4129000,12.757080058929,15.1457635282005
"6568","Niger",1977,30348000,360000,"Japan",30708000,12.7938593104323,17.2282411754401
"6569","Niger",1978,23041000,34000,"Japan",23075000,10.4341158035983,16.9527857956279
"6570","Niger",1979,18613000,33000,"Japan",18646000,10.4042628404486,16.7393708192805
"6571","Niger",1980,20016000,157000,"Japan",20173000,11.9640010843304,16.8120425116888
"6572","Niger",1981,12718000,2336000,"Japan",15054000,14.6639506229303,16.3585288708095
"6573","Niger",1982,15879000,1143000,"Japan",17022000,13.9491669427769,16.5805080395082
"6574","Niger",1983,14414000,4376000,"Japan",18790000,15.291645623084,16.4837105144665
"6575","Niger",1984,7927356,3229333,"Japan",11156689,14.9877861723265,15.8858301206128
"6576","Niger",1985,9374301,3052118,"Japan",12426419,14.9313463338108,16.053482567041
"6577","Niger",1986,8216398,11892,"Japan",8228290,9.38362118411799,15.9216424714815
"6578","Niger",1987,19883138,360304,"Japan",20243442,12.7947033985341,16.8053825938187
"6579","Niger",1988,22426420,67546,"Japan",22493966,11.120564126239,16.9257502860894
"6580","Niger",1989,15753908,0,"Japan",15753908,0,16.5725990194416
"6581","Niger",1990,13624497,4335,"Japan",13628832,8.37447688921464,16.4273799804009
"6582","Niger",1991,13498627,232118,"Japan",13730745,12.3550011420344,16.4180985345328
"6583","Niger",1992,10012893,202638,"Japan",10215531,12.2191764149072,16.1193841205248
"6584","Niger",1993,8718323,618010,"Japan",9336333,13.3342599175387,15.9809374608762
"6585","Niger",1994,7377090,333369,"Japan",7710459,12.7170052635721,15.8138898098734
"6586","Niger",1995,8624492,223310,"Japan",8847802,12.3163162196289,15.9701166205964
"6587","Niger",1996,6320360,462240,"Japan",6782600,13.0438395157001,15.6592867265261
"6588","Niger",1997,4390346,49879,"Japan",4440225,10.8173553514775,15.2949185974353
"6589","Niger",1998,3598000,0,"Japan",3598000,0,15.0958886934926
"6590","Niger",1999,5274468,278451,"Japan",5552919,12.5369973803204,15.4783883791598
"6591","Niger",2000,6239457,1252521,"Japan",7491978,14.0406688782677,15.6464037173284
"6592","Niger",2001,1919700,2519970,"Japan",4439670,14.7397575546548,14.4676794817957
"6593","Niger",2002,3084567,418442,"Japan",3503009,12.9442935691041,14.9419218489067
"6594","Niger",2003,3140396,5689146,"Japan",8829542,15.5540707069647,14.9598594645823
"6595","Niger",2004,3164166,22872082,"Japan",26036248,16.9454275981475,14.9674000717273
"6596","Niger",2005,3900346,1532897,"Japan",5433243,14.2426699670775,15.1765758251134
"6597","Niger",2006,4287993,221358,"Japan",4509351,12.307536579364,15.2713293492688
"6598","Niger",2007,7507351,189975,"Japan",7697326,12.154647763538,15.8313932318228
"6599","Niger",2008,17446041,289308,"Japan",17735349,12.5752471435373,16.6746233040814
"6600","Niger",2009,20930574,176822,"Japan",21107396,12.0828988558335,16.8567215187953
"6601","Niger",2010,17208480,44989,"Japan",17253469,10.7141732944266,16.6609128435435
"6602","Niger",2011,7400577,159859,"Japan",7560436,11.9820474556869,15.8170685281076
"6603","Niger",2012,9531144,478417,"Japan",10009561,13.0782380161043,16.0700753103986
"6604","Niger",2013,4772672,728398,"Japan",5501070,13.4986028810877,15.378416873744
"6605","Niger",2014,3076446,368922,"Japan",3445368,12.8183405185645,14.9392855925952
"6606","Niger",2015,19509323,275299,"Japan",19784622,12.5256130587231,16.7864030118435
"6607","Niger",2016,7387557,621228,"Japan",8008785,13.3394534432911,15.8153076564028
"6608","Niger",2017,0,0,"0",0,0,0
"6609","Nigeria",1962,67949000,5220000,"Japan",73169000,15.4680079598588,18.0342679817497
"6610","Nigeria",1963,75430000,6760000,"Japan",82190000,15.7265334480191,18.1387156318298
"6611","Nigeria",1964,86272000,7352000,"Japan",93624000,15.8104829430177,18.2730156538141
"6612","Nigeria",1965,71717000,9287000,"Japan",81004000,16.0441261307581,18.08823837649
"6613","Nigeria",1966,40095000,13674000,"Japan",53769000,16.4310067774559,17.5067621962233
"6614","Nigeria",1967,52494000,16164000,"Japan",68658000,16.5982971051805,17.7762094353165
"6615","Nigeria",1968,20060000,14504000,"Japan",34564000,16.4899350314168,16.8142383404981
"6616","Nigeria",1969,26415000,12949000,"Japan",39364000,16.376529123051,17.0894425885806
"6617","Nigeria",1970,66444000,12842000,"Japan",79286000,16.3682316073361,18.0118700455931
"6618","Nigeria",1971,127469000,26948000,"Japan",154417000,17.1094196410627,18.6633837557452
"6619","Nigeria",1972,149352000,79961000,"Japan",229313000,18.1970495737714,18.8218164938993
"6620","Nigeria",1973,169420000,189538000,"Japan",358958000,19.0601000900882,18.9478913969677
"6621","Nigeria",1974,256405000,449582000,"Japan",705987000,19.9238288201551,19.3622687836007
"6622","Nigeria",1975,595107000,279076000,"Japan",874183000,19.4469947041248,20.2042517792749
"6623","Nigeria",1976,761274000,108731000,"Japan",870005000,18.5043875000254,20.450503903585
"6624","Nigeria",1977,1172276000,20290000,"Japan",1192566000,16.825638711802,20.8822129952572
"6625","Nigeria",1978,953435000,7528000,"Japan",960963000,15.8341399602474,20.6755818107807
"6626","Nigeria",1979,1113319000,42465000,"Japan",1155784000,17.5641907651962,20.8306114809325
"6627","Nigeria",1980,1493610000,120172000,"Japan",1613782000,18.6044346078379,21.1244618454024
"6628","Nigeria",1981,2158837000,340371000,"Japan",2499208000,19.6455467571447,21.4928354877133
"6629","Nigeria",1982,1209057000,8003000,"Japan",1217060000,15.8953270293492,20.9131065538697
"6630","Nigeria",1983,567802000,6706000,"Japan",574508000,15.7185132060083,20.157283324364
"6631","Nigeria",1984,445517607,6333589,"Japan",451851196,15.6613776160689,19.9147473259797
"6632","Nigeria",1985,342028883,5184888,"Japan",347213771,15.461258798641,19.6504057446773
"6633","Nigeria",1986,194766858,4648373,"Japan",199415231,15.3520278238638,19.0873138012281
"6634","Nigeria",1987,345984420,4726201,"Japan",350710621,15.3686322665059,19.6619043031064
"6635","Nigeria",1988,308928790,4823749,"Japan",313752539,15.3890619845264,19.5486213552292
"6636","Nigeria",1989,266991465,4200429,"Japan",271191894,15.2506972208945,19.4027272495615
"6637","Nigeria",1990,269226013,12932054,"Japan",282158067,16.375219593507,19.4110617818242
"6638","Nigeria",1991,371343970,7437500,"Japan",378781470,15.822045328836,19.7326393338974
"6639","Nigeria",1992,526681929,2225409,"Japan",528907338,14.6154512769143,20.0821073740112
"6640","Nigeria",1993,497613582,8939995,"Japan",506553577,16.0060455878654,20.0253343940328
"6641","Nigeria",1994,198035337,17788170,"Japan",215823507,16.6940441875718,19.103956042432
"6642","Nigeria",1995,179198541,122290530,"Japan",301489071,18.6219101651164,19.0040049167309
"6643","Nigeria",1996,240656978,149513112,"Japan",390170090,18.8228946526347,19.2988831497609
"6644","Nigeria",1997,215013272,76178195,"Japan",291191467,18.1485858248511,19.1862103144193
"6645","Nigeria",1998,232139000,83969000,"Japan",316108000,18.2459582410737,19.2628468881501
"6646","Nigeria",1999,250806520,177183600,"Japan",427990120,18.9926970410621,19.3401923631953
"6647","Nigeria",2000,256650440,195827291,"Japan",452477731,19.0927436603704,19.3632255613662
"6648","Nigeria",2001,338318782,245979462,"Japan",584298244,19.3207586026065,19.6394991509801
"6649","Nigeria",2002,394558632,668855271,"Japan",1063413903,20.3210782583656,19.793278310781
"6650","Nigeria",2003,334276165,815275046,"Japan",1149551211,20.5190360940263,19.6274780506134
"6651","Nigeria",2004,385682921,1291691061,"Japan",1677373982,20.9792180968408,19.7705261416691
"6652","Nigeria",2005,518704150,883841222,"Japan",1402545372,20.5997879913474,20.0668442400608
"6653","Nigeria",2006,795101225,738582107,"Japan",1533683332,20.4202428345274,20.4939799915572
"6654","Nigeria",2007,725496103,590052711,"Japan",1315548814,20.1957224315514,20.4023662588061
"6655","Nigeria",2008,734968594,1564923797,"Japan",2299892391,21.1711029677403,20.4153383270125
"6656","Nigeria",2009,910777506,476646012,"Japan",1387423518,19.9822846601427,20.6298091948792
"6657","Nigeria",2010,1078735536,487623218,"Japan",1566358754,20.0050535713368,20.7990553921608
"6658","Nigeria",2011,621325077,1657069003,"Japan",2278394080,21.2283162178551,20.2473649763633
"6659","Nigeria",2012,620726907,4724003449,"Japan",5344730356,22.2759224653829,20.2464017798885
"6660","Nigeria",2013,641718823,3541881644,"Japan",4183600467,21.987923960729,20.2796607953122
"6661","Nigeria",2014,721092821,4469110045,"Japan",5190202866,22.2204551306715,20.3962784262141
"6662","Nigeria",2015,358081832,2818075755,"Japan",3176157587,21.7593201326024,19.6962720992499
"6663","Nigeria",2016,320761779,864968838,"Japan",1185730617,20.5782040388137,19.5862092840905
"6664","Nigeria",2017,274290019.5,641925360.5,"Japan",916215380,20.279982593992,19.4296965699014
"6665","Nicaragua",1962,5333000,25618000,"Japan",30951000,17.0588057873732,15.4894244895827
"6666","Nicaragua",1963,6486000,31808000,"Japan",38294000,17.2752283884384,15.6851565658494
"6667","Nicaragua",1964,7352000,33517000,"Japan",40869000,17.3275633307662,15.8104829430177
"6668","Nicaragua",1965,11161000,54499000,"Japan",65660000,17.8136929108413,16.2279361166379
"6669","Nicaragua",1966,9802000,47330000,"Japan",57132000,17.6726549018824,16.0980970044516
"6670","Nicaragua",1967,13359000,51348000,"Japan",64707000,17.754136545187,16.4077008729719
"6671","Nicaragua",1968,13918000,47297000,"Japan",61215000,17.6719574265036,16.4486935243869
"6672","Nicaragua",1969,12586000,32579000,"Japan",45165000,17.29917846699,16.348095643069
"6673","Nicaragua",1970,12705000,27564000,"Japan",40269000,17.1320211314592,16.3575061747364
"6674","Nicaragua",1971,17196000,38445000,"Japan",55641000,17.4647392064484,16.6601873565983
"6675","Nicaragua",1972,18123000,51112000,"Japan",69235000,17.7495298612643,16.712692407789
"6676","Nicaragua",1973,22977000,43067000,"Japan",66044000,17.5782676005528,16.9500042735598
"6677","Nicaragua",1974,41329000,35350000,"Japan",76679000,17.3808089503069,17.5370749906956
"6678","Nicaragua",1975,37138000,64224000,"Japan",101362000,17.9778875305782,17.4301512621427
"6679","Nicaragua",1976,41181000,81893000,"Japan",123074000,18.2209240750851,17.5334875429019
"6680","Nicaragua",1977,76948000,89293000,"Japan",166241000,18.3074336553163,18.1586404270082
"6681","Nicaragua",1978,26722000,61460000,"Japan",88182000,17.9338971146666,17.100997754131
"6682","Nicaragua",1979,15524000,40682000,"Japan",56206000,17.5212962921446,16.5578977714709
"6683","Nicaragua",1980,30369000,15640000,"Japan",46009000,16.5653422930814,17.228932909249
"6684","Nicaragua",1981,28222000,62837000,"Japan",91059000,17.9560546299193,17.1556123735998
"6685","Nicaragua",1982,18485000,48744000,"Japan",67229000,17.7020926709105,16.7324701503529
"6686","Nicaragua",1983,8718000,72677000,"Japan",81395000,18.1015355238104,15.9809004117805
"6687","Nicaragua",1984,12999163,95456561,"Japan",108455724,18.3741818433326,16.3803955287376
"6688","Nicaragua",1985,23339215,52986751,"Japan",76325966,17.7855524591338,16.9656455510094
"6689","Nicaragua",1986,9455826,37778973,"Japan",47234799,17.4472632359731,16.0621416174435
"6690","Nicaragua",1987,13792050,26459528,"Japan",40251578,17.0911268782456,16.4396028971691
"6691","Nicaragua",1988,13356086,38017513,"Japan",51373599,17.4535574799445,16.4074827190786
"6692","Nicaragua",1989,17328584,18804133,"Japan",36132717,16.7495872440643,16.6678679503327
"6693","Nicaragua",1990,26988217,19086593,"Japan",46074810,16.7644967093708,17.1109109213078
"6694","Nicaragua",1991,30342487,37342485,"Japan",67684972,17.4356422444794,17.2280594995206
"6695","Nicaragua",1992,44202704,21332793,"Japan",65535497,16.8757560242101,17.6042965216473
"6696","Nicaragua",1993,34813969,1841393,"Japan",36655362,14.4260329083732,17.365529272248
"6697","Nicaragua",1994,28719371,1201875,"Japan",29921246,13.9993933953252,17.1730824007903
"6698","Nicaragua",1995,36255494,10854807,"Japan",47110301,16.2001185813115,17.4061014864018
"6699","Nicaragua",1996,42350109,5382565,"Japan",47732674,15.4986755843205,17.5614815528489
"6700","Nicaragua",1997,92040205,4597484,"Japan",96637689,15.3410197553023,18.3377360504214
"6701","Nicaragua",1998,78392000,4862000,"Japan",83254000,15.3969604338582,18.1772324392978
"6702","Nicaragua",1999,88506452,5757199,"Japan",94263651,15.5659616296751,18.2985860112756
"6703","Nicaragua",2000,79744450,5856599,"Japan",85601049,15.5830796176436,18.1943377047311
"6704","Nicaragua",2001,63971457,6647221,"Japan",70618678,15.7097094305529,17.9739475574683
"6705","Nicaragua",2002,49532156,6216686,"Japan",55748842,15.6427475253007,17.7181326327913
"6706","Nicaragua",2003,73700135,4867434,"Japan",78567569,15.3980774568145,18.1155151889082
"6707","Nicaragua",2004,88046752,7410971,"Japan",95457723,15.8184720278237,18.2933785040944
"6708","Nicaragua",2005,75233497,10364269,"Japan",85597766,16.1538747755569,18.1361071285714
"6709","Nicaragua",2006,100251407,9272298,"Japan",109523705,16.0425418032609,18.4231916589652
"6710","Nicaragua",2007,107460630,14197127,"Japan",121657757,16.4685501781576,18.4926351058943
"6711","Nicaragua",2008,96227727,21119609,"Japan",117347336,16.8657125033734,18.382228096561
"6712","Nicaragua",2009,74008255,10257265,"Japan",84265520,16.1434967929702,18.1196871990008
"6713","Nicaragua",2010,105732882,19528113,"Japan",125260995,16.7873656776011,18.4764264904475
"6714","Nicaragua",2011,97929475,31839030,"Japan",129768505,17.2762034536523,18.3997581347105
"6715","Nicaragua",2012,114393873,26792318,"Japan",141186191,17.1036257626004,18.5551580777834
"6716","Nicaragua",2013,74736078,27159912,"Japan",101895990,17.1172526205906,18.1294735053972
"6717","Nicaragua",2014,89016991,31754558,"Japan",120771549,17.2735468320545,18.3043378195878
"6718","Nicaragua",2015,95173357,23146390,"Japan",118319747,16.9573493868118,18.3712105971471
"6719","Nicaragua",2016,86615271,27288802,"Japan",113904073,17.1219869928569,18.2769866974786
"6720","Nicaragua",2017,118858563,31905314,"Japan",150763877,17.2782831369538,18.5934447979761
"6721","Netherlands",1962,31537000,41065000,"Japan",72602000,17.5306667351564,17.2666720176639
"6722","Netherlands",1963,37890000,49658000,"Japan",87548000,17.720670063371,17.4501977829948
"6723","Netherlands",1964,45933000,58799000,"Japan",104732000,17.8896354059215,17.6426943709553
"6724","Netherlands",1965,60256000,43439000,"Japan",103695000,17.5868682130672,17.914112710439
"6725","Netherlands",1966,69199000,60542000,"Japan",129741000,17.9188478970214,18.0524969696164
"6726","Netherlands",1967,86028000,100573000,"Japan",186601000,18.4263943899449,18.270183382623
"6727","Netherlands",1968,79110000,85615000,"Japan",164725000,18.2653710594052,18.1863498469976
"6728","Netherlands",1969,98368000,79489000,"Japan",177857000,18.1911292052714,18.4042261058804
"6729","Netherlands",1970,136098000,103599000,"Japan",239697000,18.4560382352334,18.7288857724366
"6730","Netherlands",1971,207087000,109319000,"Japan",316406000,18.5097807715253,19.1486495527877
"6731","Netherlands",1972,247809000,134382000,"Japan",382191000,18.7161970485127,19.3281688461124
"6732","Netherlands",1973,305011000,164619000,"Japan",469630000,18.9191442708943,19.5358583994951
"6733","Netherlands",1974,395398000,221630000,"Japan",617028000,19.2165198827359,19.7954034105191
"6734","Netherlands",1975,483336000,214377000,"Japan",697713000,19.183246705287,19.9962226219369
"6735","Netherlands",1976,592232000,251337000,"Japan",843569000,19.3423052260571,20.1994090079706
"6736","Netherlands",1977,849682000,298434000,"Japan",1148116000,19.5140593608219,20.5603727198021
"6737","Netherlands",1978,1171245000,318170000,"Japan",1489415000,19.5780963890965,20.8813331225644
"6738","Netherlands",1979,1286763000,419005000,"Japan",1705768000,19.8533934109894,20.9753955994187
"6739","Netherlands",1980,1435467000,379501000,"Japan",1814968000,19.7543677898426,21.0847560687554
"6740","Netherlands",1981,1257899000,426781000,"Japan",1684680000,19.8717815590626,20.952708705833
"6741","Netherlands",1982,1304320000,347256000,"Japan",1651576000,19.6655728180672,20.9889476691185
"6742","Netherlands",1983,1313826000,443354000,"Japan",1757180000,19.9098791059668,20.9962093281492
"6743","Netherlands",1984,1334129753,393752812,"Japan",1727882565,19.7912338896659,21.0115450458267
"6744","Netherlands",1985,1427951318,397177362,"Japan",1825128680,19.7998934945534,21.0795066092463
"6745","Netherlands",1986,2266933529,527550582,"Japan",2794484111,20.0837553087647,21.5416938869127
"6746","Netherlands",1987,2788048352,685778263,"Japan",3473826615,20.3460649016611,21.7486076725924
"6747","Netherlands",1988,2847322370,907753410,"Japan",3755075780,20.6264833247926,21.7696448703038
"6748","Netherlands",1989,2805305232,1018446250,"Japan",3823751482,20.7415440185518,21.7547781871132
"6749","Netherlands",1990,3539370602,1063394686,"Japan",4602765288,20.7847321618432,21.9872147522393
"6750","Netherlands",1991,4045504836,1109366588,"Japan",5154871424,20.8270550479514,22.1208721846138
"6751","Netherlands",1992,4288759928,1197214464,"Japan",5485974392,20.9032634153934,22.1792634670279
"6752","Netherlands",1993,4236516915,1204193643,"Japan",5440710558,20.9090760039573,22.1670072862775
"6753","Netherlands",1994,4286577368,1461671797,"Japan",5748249165,21.1028466840165,22.1787544351445
"6754","Netherlands",1995,5084367354,1964669584,"Japan",7049036938,21.3985899174926,22.3494364445476
"6755","Netherlands",1996,5587377008,1894208791,"Japan",7481585799,21.3620670637549,22.4437757846528
"6756","Netherlands",1997,6345698199,1658346149,"Japan",8004044348,21.2290866468992,22.5710429713024
"6757","Netherlands",1998,7211383000,1751971000,"Japan",8963354000,21.2840072768122,22.6989265867697
"6758","Netherlands",1999,6852362386,1818434429,"Japan",8670796815,21.3212417640013,22.6478593036338
"6759","Netherlands",2000,7099479059,1804682823,"Japan",8904161882,21.3136506919608,22.68328724633
"6760","Netherlands",2001,6468178564,1676690678,"Japan",8144869242,21.2400878531622,22.5901603855777
"6761","Netherlands",2002,5016784629,1622655094,"Japan",6639439723,21.2073295914965,22.3360550532831
"6762","Netherlands",2003,6125072505,1707738267,"Japan",7832810772,21.2584356811091,22.5356564308582
"6763","Netherlands",2004,7173450709,1825729725,"Japan",8999180434,21.3252455933775,22.6936526462168
"6764","Netherlands",2005,6614300514,1974566847,"Japan",8588867361,21.4036148932711,22.6124998865186
"6765","Netherlands",2006,7142538707,1989082977,"Japan",9131621684,21.4109395538968,22.6893341113055
"6766","Netherlands",2007,7746890457,2545609400,"Japan",10292499857,21.6576359081871,22.770557368442
"6767","Netherlands",2008,10439700338,3444192290,"Japan",13883892628,21.9599552552866,23.0688817157323
"6768","Netherlands",2009,7348981383,3221375967,"Japan",10570357350,21.8930744241721,22.7178275532201
"6769","Netherlands",2010,9310630022,3631085063,"Japan",12941715085,22.0127973559839,22.9544225974818
"6770","Netherlands",2011,14564394086,5614702070,"Japan",20179096156,22.4486543640675,23.4018456258059
"6771","Netherlands",2012,13081041452,4884775820,"Japan",17965817272,22.3093892298835,23.2944298015184
"6772","Netherlands",2013,10832125678,4327967303,"Japan",15160092981,22.1883638237023,23.1057821555232
"6773","Netherlands",2014,10742992770,4220486298,"Japan",14963479068,22.163216194848,23.0975195436342
"6774","Netherlands",2015,9591016907,2687829484,"Japan",12278846391,21.7119998215833,22.9840927584891
"6775","Netherlands",2016,9998638846,2318696942,"Japan",12317335788,21.5642712019019,23.0257148052759
"6776","Netherlands",2017,10694242566,3246352897.5,"Japan",13940595463.5,21.900798017782,23.0929713556545
"6777","Norway",1962,18157000,9284000,"Japan",27441000,16.0438030463765,16.7145667192528
"6778","Norway",1963,12946000,4799000,"Japan",17745000,15.3839181208404,16.3762974180876
"6779","Norway",1964,58798000,12735000,"Japan",71533000,16.3598646663957,17.8896183986849
"6780","Norway",1965,82257000,9443000,"Japan",91700000,16.0607842842452,18.2253590503714
"6781","Norway",1966,116187000,21392000,"Japan",137579000,16.8785275783239,18.5707115200478
"6782","Norway",1967,223235000,36287000,"Japan",259522000,17.4069701083706,19.2237355862139
"6783","Norway",1968,159371000,25154000,"Japan",184525000,17.0405274875892,18.8867453755228
"6784","Norway",1969,91367000,23712000,"Japan",115079000,16.981491807078,18.3303949209018
"6785","Norway",1970,162410000,34208000,"Japan",196618000,17.3479700928069,18.9056345601508
"6786","Norway",1971,193477000,27308000,"Japan",220785000,17.1226902575203,19.0806692003202
"6787","Norway",1972,227875000,33672000,"Japan",261547000,17.3321771894325,19.2443077909631
"6788","Norway",1973,477739000,57841000,"Japan",535580000,17.8732084247386,19.9845751162251
"6789","Norway",1974,524408000,88708000,"Japan",613116000,18.3008606348701,20.0777805652676
"6790","Norway",1975,594095000,75906000,"Japan",670001000,18.1450062906249,20.202549797199
"6791","Norway",1976,750786000,105590000,"Japan",856376000,18.4750742277827,20.436631215726
"6792","Norway",1977,918625000,95451000,"Japan",1014076000,18.3741235847705,20.6383885448133
"6793","Norway",1978,577310000,100151000,"Japan",677461000,18.4221896050487,20.1738899418974
"6794","Norway",1979,463347000,202684000,"Japan",666031000,19.127158673921,19.9539867913888
"6795","Norway",1980,604020000,185752000,"Japan",789772000,19.0399230086643,20.2191178679337
"6796","Norway",1981,1021766000,239166000,"Japan",1260932000,19.2926684294696,20.7447983396939
"6797","Norway",1982,948571000,176904000,"Japan",1125475000,18.9911177705194,20.6704671995721
"6798","Norway",1983,739647000,205204000,"Japan",944851000,19.1395151642483,20.4216836033219
"6799","Norway",1984,602760918,277938423,"Japan",880699341,19.4429101471202,20.2170311885073
"6800","Norway",1985,860836029,283008193,"Japan",1143844222,19.4609864057185,20.5734146017468
"6801","Norway",1986,1359564953,232560613,"Japan",1592125566,19.2646614500903,21.0304305980195
"6802","Norway",1987,1166437239,286015876,"Japan",1452453115,19.471557877733,20.8772198451494
"6803","Norway",1988,953430173,466030690,"Japan",1419460863,19.9597620482905,20.6755767480211
"6804","Norway",1989,790836804,508762567,"Japan",1299599371,20.0474919961359,20.4886021883902
"6805","Norway",1990,1059013718,586920908,"Japan",1645934626,20.1904006293616,20.7806038572117
"6806","Norway",1991,1124999545,743670831,"Japan",1868670376,20.4271090634441,20.8410484681583
"6807","Norway",1992,1483620353,647793181,"Japan",2131413534,20.2890820382491,21.1177511221429
"6808","Norway",1993,1729746377,738565532,"Japan",2468311909,20.4202203926271,21.2712406318187
"6809","Norway",1994,1472285828,776224960,"Japan",2248510788,20.4699529330427,21.1100820150337
"6810","Norway",1995,1130533849,894573473,"Japan",2025107322,20.6118575961648,20.8459557908528
"6811","Norway",1996,1200664992,910991370,"Japan",2111656362,20.6300439820729,20.9061414002504
"6812","Norway",1997,1511042599,936867128,"Japan",2447909727,20.6580520243842,21.1360657124273
"6813","Norway",1998,1669778000,1022012000,"Japan",2691790000,20.745039070342,21.2359565204068
"6814","Norway",1999,1294674977,1192109896,"Japan",2486784873,20.8989905959708,20.9815255175848
"6815","Norway",2000,1601575113,1073249409,"Japan",2674824522,20.7939567144049,21.1942534275683
"6816","Norway",2001,1102279872,1051459003,"Japan",2153738875,20.7734445632837,20.820646482765
"6817","Norway",2002,957470146,1127603508,"Japan",2085073654,20.8433604282317,20.6798050994207
"6818","Norway",2003,1289508181,1156741957,"Japan",2446250138,20.8688732326258,20.9775267275851
"6819","Norway",2004,1474564046,1122125059,"Japan",2596689105,20.8384900986199,21.1116282210172
"6820","Norway",2005,1576545215,1049106549,"Japan",2625651764,20.7712047331758,21.1785017171597
"6821","Norway",2006,1552067430,1253431856,"Japan",2805499286,20.9491511111013,21.1628537049286
"6822","Norway",2007,1501473476,1517956165,"Japan",3019429641,21.1406306386913,21.12971278023
"6823","Norway",2008,1678523449,1853048454,"Japan",3531571903,21.3400979328554,21.2411803444983
"6824","Norway",2009,1436704457,1494377446,"Japan",2931081903,21.1249755329802,21.0856177562243
"6825","Norway",2010,1424734781,1812097748,"Japan",3236832529,21.3177509879246,21.0772515147483
"6826","Norway",2011,1395890183,2170705248,"Japan",3566595431,21.4983179507764,21.0567981727195
"6827","Norway",2012,1226072191,2212153075,"Japan",3438225266,21.5172321202917,20.9270815560874
"6828","Norway",2013,1161603608,1844925659,"Japan",3006529267,21.3357048204022,20.8730673080906
"6829","Norway",2014,1255940553,1970996668,"Japan",3226937221,21.4018051746031,20.9511505734583
"6830","Norway",2015,953963227,1596291860,"Japan",2550255087,21.1909491889296,20.676135682548
"6831","Norway",2016,985243430,1624115382,"Japan",2609358812,21.2082291241917,20.7083993056589
"6832","Norway",2017,1344476694.5,1528284229.5,"Japan",2872760924,21.1474115244629,21.0192706995698
"6833","Nepal",1962,189000,15000,"Japan",204000,9.61580548008435,12.1495022940418
"6834","Nepal",1963,89000,2000,"Japan",91000,7.60090245954208,11.3963916487143
"6835","Nepal",1964,767000,76000,"Japan",843000,11.2384886192685,13.5502420803494
"6836","Nepal",1965,326000,359000,"Japan",685000,12.7910776674704,12.6946526603488
"6837","Nepal",1966,1016000,267000,"Japan",1283000,12.4950039373824,13.8313839071206
"6838","Nepal",1967,2533000,670000,"Japan",3203000,13.4150329913671,14.7449149289838
"6839","Nepal",1968,4238000,1392000,"Japan",5630000,14.1462521198765,15.2596020178104
"6840","Nepal",1969,3728000,1645000,"Japan",5373000,14.3132509421816,15.1313824547876
"6841","Nepal",1970,4752000,1074000,"Japan",5826000,13.8869005540509,15.3740761400246
"6842","Nepal",1971,6036000,1010000,"Japan",7046000,13.8254608888174,15.6132520988699
"6843","Nepal",1972,7733000,1137000,"Japan",8870000,13.9439037727327,15.8610074435912
"6844","Nepal",1973,9551000,2959000,"Japan",12510000,14.9003619313823,16.0721564190169
"6845","Nepal",1974,13865000,2560000,"Japan",16425000,14.7555178164557,16.444878237032
"6846","Nepal",1975,13893000,1789000,"Japan",15682000,14.3971673624909,16.446895674131
"6847","Nepal",1976,9244000,3665000,"Japan",12909000,15.1143388933029,16.0394852503764
"6848","Nepal",1977,13562000,5191000,"Japan",18753000,15.4624369148094,16.4227823222259
"6849","Nepal",1978,32593000,6882000,"Japan",39475000,15.7444198653396,17.2996080993541
"6850","Nepal",1979,22340000,9693000,"Japan",32033000,16.0869145334747,16.9218893516053
"6851","Nepal",1980,1534000,8498000,"Japan",10032000,15.9553413996569,14.2433892609093
"6852","Nepal",1981,44233000,2272000,"Japan",46505000,14.6361710588232,17.6049816748109
"6853","Nepal",1982,54119000,1411000,"Japan",55530000,14.159809230835,17.8066958836386
"6854","Nepal",1983,42359000,903000,"Japan",43262000,13.7134778323991,17.5616914712422
"6855","Nepal",1984,39375450,487973,"Japan",39863423,13.0980153554358,17.4886530836162
"6856","Nepal",1985,60992822,1017650,"Japan",62010472,13.833006605581,17.9262667430825
"6857","Nepal",1986,65400525,1431776,"Japan",66832301,14.1744261896861,17.9960408439181
"6858","Nepal",1987,79303685,2361335,"Japan",81665020,14.6747376950324,18.1887951546301
"6859","Nepal",1988,61670080,2058715,"Japan",63728795,14.5375925597223,17.937309444194
"6860","Nepal",1989,71383819,1670469,"Japan",73054288,14.3286149832886,18.0835817769767
"6861","Nepal",1990,57762766,2336929,"Japan",60099695,14.6643482322294,17.8718549392139
"6862","Nepal",1991,96808502,1547595,"Japan",98356097,14.2522126709943,18.3882453789684
"6863","Nepal",1992,59335083,1990999,"Japan",61326082,14.504147080786,17.8987113079175
"6864","Nepal",1993,67656545,3586911,"Japan",71243456,15.0928019443861,18.0299546558688
"6865","Nepal",1994,66108018,2900329,"Japan",69008347,14.8803347367978,18.0068005985245
"6866","Nepal",1995,58802932,1595529,"Japan",60398461,14.2827159006556,17.8897022755713
"6867","Nepal",1996,65497177,1801149,"Japan",67298326,14.4039353525517,17.99751760044
"6868","Nepal",1997,24517448,3389463,"Japan",27906911,15.0361820597293,17.0148955853123
"6869","Nepal",1998,20930000,2815000,"Japan",23745000,14.8504728195559,16.8566940944222
"6870","Nepal",1999,25975558,4612202,"Japan",30587760,15.3442159581977,17.0726665769132
"6871","Nepal",2000,31025164,25421853,"Japan",56447017,17.0511197164268,17.2503091751006
"6872","Nepal",2001,21485069,10173745,"Japan",31658814,16.1353209401624,16.882868786729
"6873","Nepal",2002,16796794,5662905,"Japan",22459699,15.5494475693946,16.6366985928292
"6874","Nepal",2003,26802551,6471780,"Japan",33274331,15.6829617445593,17.1040076275183
"6875","Nepal",2004,22656030,6851797,"Japan",29507827,15.7400215116008,16.9359365996272
"6876","Nepal",2005,19330471,9109348,"Japan",28439819,16.0248116969713,16.7771932171577
"6877","Nepal",2006,22271571,8034838,"Japan",30306409,15.8992973951583,16.9188215800773
"6878","Nepal",2007,43949784,7551832,"Japan",51501616,15.8373007407973,17.5985582674076
"6879","Nepal",2008,50467819,10096476,"Japan",60564295,16.1276970100368,17.7368464435923
"6880","Nepal",2009,72269793,10407459,"Japan",82677252,16.1580333185768,18.095916798996
"6881","Nepal",2010,79983887,8637292,"Japan",88621179,15.9715996657261,18.1973357598519
"6882","Nepal",2011,34032259,12128544,"Japan",46160803,16.3110722407396,17.3428194268774
"6883","Nepal",2012,45794263,15501212,"Japan",61295475,16.5564287723809,17.6396693792297
"6884","Nepal",2013,26529392,15343330,"Japan",41872722,16.5461914098757,17.0937638083994
"6885","Nepal",2014,33989500,15394079,"Japan",49383579,16.5494935129328,17.3415622113552
"6886","Nepal",2015,43471664,15933141,"Japan",59404805,16.583911837591,17.5876198815054
"6887","Nepal",2016,45290866,12906812,"Japan",58197678,16.3732657919717,17.6286159365684
"6888","Nepal",2017,36156698.5,11223084,"Japan",47379782.5,16.2334832866002,17.4033727867757
"6889","New Zealand",1962,26760000,34022000,"Japan",60782000,17.3425179321517,17.1024187932243
"6890","New Zealand",1963,43555000,54949000,"Japan",98504000,17.8219160402862,17.5895350652351
"6891","New Zealand",1964,50258000,56771000,"Japan",107029000,17.8545361899292,17.7326802962119
"6892","New Zealand",1965,67311000,61248000,"Japan",128559000,17.9304417537948,18.02483422851
"6893","New Zealand",1966,64077000,113201000,"Japan",177278000,18.5446755576166,17.9755960431491
"6894","New Zealand",1967,68522000,111796000,"Japan",180318000,18.5321863398699,18.0426654195523
"6895","New Zealand",1968,70842000,120458000,"Japan",191300000,18.6068117024203,18.0759626031173
"6896","New Zealand",1969,85247000,143873000,"Japan",229120000,18.784441523954,18.2610634828929
"6897","New Zealand",1970,122529000,157743000,"Japan",280272000,18.8764776843915,18.6238582946257
"6898","New Zealand",1971,148120000,161482000,"Japan",309602000,18.899904239307,18.8135333140097
"6899","New Zealand",1972,182529000,248483000,"Japan",431012000,19.3308849906981,19.0224196224725
"6900","New Zealand",1973,290936000,415999000,"Japan",706935000,19.8461934143765,19.4886138696759
"6901","New Zealand",1974,534256000,401263000,"Japan",935519000,19.8101276306376,20.0963856827977
"6902","New Zealand",1975,426254000,367879000,"Japan",794133000,19.7232646377174,19.8705459706822
"6903","New Zealand",1976,509438000,454295000,"Japan",963733000,19.9342573247259,20.0488187152931
"6904","New Zealand",1977,495190000,507073000,"Japan",1002263000,20.0441655354116,20.0204520852697
"6905","New Zealand",1978,507364000,638625000,"Japan",1145989000,20.2748279856152,20.0447392526715
"6906","New Zealand",1979,648849000,805452000,"Japan",1454301000,20.5069141684892,20.2907105819581
"6907","New Zealand",1980,786625000,828352000,"Japan",1614977000,20.5349487427842,20.4832621998114
"6908","New Zealand",1981,988706000,887196000,"Japan",1875902000,20.603576485424,20.7119075754238
"6909","New Zealand",1982,1040164000,857739000,"Japan",1897903000,20.5698104153711,20.7626442299753
"6910","New Zealand",1983,972520000,931719000,"Japan",1904239000,20.652541825043,20.6954011987981
"6911","New Zealand",1984,1177070804,858915712,"Japan",2035986516,20.5711813517348,20.8862948197449
"6912","New Zealand",1985,1127214456,848428101,"Japan",1975642557,20.5588959024542,20.8430153431649
"6913","New Zealand",1986,1177404183,891463782,"Japan",2068867965,20.6083753685308,20.8865780072955
"6914","New Zealand",1987,1260513057,1053817938,"Japan",2314330995,20.7756855377999,20.9547846631265
"6915","New Zealand",1988,1120430117,1516715158,"Japan",2637145275,21.1398127530377,20.8369784815673
"6916","New Zealand",1989,1471788562,1566357770,"Japan",3038146332,21.172018869469,21.1097442069902
"6917","New Zealand",1990,1339189719,1644926758,"Japan",2984116477,21.2209616961604,21.0153305806987
"6918","New Zealand",1991,1201600741,1663574080,"Japan",2865174821,21.2322341850432,20.9069204556517
"6919","New Zealand",1992,1229275940,1578321321,"Japan",2807597261,21.1796276641165,20.9296911663318
"6920","New Zealand",1993,1422337025,1591119056,"Japan",3013456081,21.1877034144263,21.0755671479811
"6921","New Zealand",1994,1666226571,1886490264,"Japan",3552716835,21.3579839364754,21.2338273684431
"6922","New Zealand",1995,1768381110,2313085498,"Japan",4081466608,21.5618481836284,21.2933303378869
"6923","New Zealand",1996,1922515086,2238147779,"Japan",4160662865,21.5289144763809,21.3769001063874
"6924","New Zealand",1997,1208896244,1769881039,"Japan",2978777283,21.294178171669,20.9129735852107
"6925","New Zealand",1998,1337244000,1927485000,"Japan",3264729000,21.3794818812703,21.0138766165456
"6926","New Zealand",1999,1594348327,1749860784,"Japan",3344209111,21.2828020697174,21.189730917281
"6927","New Zealand",2000,1441437595,1971060651,"Japan",3412498246,21.4018376363331,21.0889067823956
"6928","New Zealand",2001,1323504023,1918431763,"Japan",3241935786,21.3747738991271,21.0035486192944
"6929","New Zealand",2002,1615000898,1785392949,"Japan",3400393847,21.3029043674467,21.202601349658
"6930","New Zealand",2003,1947230662,1930678283,"Japan",3877908945,21.3811372200909,21.3896740267868
"6931","New Zealand",2004,2314641509,2307698204,"Japan",4622339713,21.5595164162104,21.5625206567697
"6932","New Zealand",2005,2571243159,2274807862,"Japan",4846051021,21.545161429519,21.6676553383543
"6933","New Zealand",2006,2151566493,2349704899,"Japan",4501271392,21.5775555823237,21.4894620151802
"6934","New Zealand",2007,2566634898,2469488067,"Japan",5036122965,21.627276705781,21.6658614996587
"6935","New Zealand",2008,2441771813,2686862696,"Japan",5128634509,21.7116400659068,21.6159897655989
"6936","New Zealand",2009,1650467669,1947637361,"Japan",3598105030,21.389882865186,21.2243245204562
"6937","New Zealand",2010,1929959200,2512291946,"Japan",4442251146,21.6444612993407,21.3807646997434
"6938","New Zealand",2011,1714497352,3076726857,"Japan",4791224209,21.8471321600903,21.2623857853924
"6939","New Zealand",2012,1861770395,2986436858,"Japan",4848207253,21.8173468274387,21.3447936972419
"6940","New Zealand",2013,1969990761,2694444064,"Japan",4664434825,21.7144577357978,21.4012946898376
"6941","New Zealand",2014,2150986363,2745444677,"Japan",4896431040,21.7332088940522,21.48919234737
"6942","New Zealand",2015,1945204633,2380126951,"Japan",4325331584,21.5904196639635,21.3886330182513
"6943","New Zealand",2016,2101843402,2335713868,"Japan",4437557270,21.5715834063964,21.4660806071017
"6944","New Zealand",2017,2711189773.5,2679143223.5,"Japan",5390332997,21.7087628876327,21.720653406304
"6945","Oman",1962,219000,0,"Japan",219000,0,12.2968270087986
"6946","Oman",1963,254000,81000,"Japan",335000,11.3022044336546,12.4450895460007
"6947","Oman",1964,276000,0,"Japan",276000,0,12.5281561446993
"6948","Oman",1965,768000,7000,"Japan",775000,8.85366542803745,13.5515450121298
"6949","Oman",1966,1181000,12000,"Japan",1193000,9.39266192877014,13.9818720951795
"6950","Oman",1967,835000,14412000,"Japan",15247000,16.4835717508501,13.635187003833
"6951","Oman",1968,2287000,50871000,"Japan",53158000,17.7448035745574,14.6427514730049
"6952","Oman",1969,1119000,64063000,"Japan",65182000,17.9753775321446,13.9279459872941
"6953","Oman",1970,2351000,64964000,"Japan",67315000,17.9893438282766,14.6703513275222
"6954","Oman",1971,3882000,81180000,"Japan",85062000,18.212179469375,15.1718610427111
"6955","Oman",1972,6893000,128705000,"Japan",135598000,18.6730335218506,15.7460169618678
"6956","Oman",1973,12573000,152019000,"Japan",164592000,18.8395160709987,16.3470622155753
"6957","Oman",1974,44902000,378562000,"Japan",423464000,19.7518904219187,17.6199928951503
"6958","Oman",1975,70155000,520009000,"Japan",590164000,20.0693566770823,18.0662176378102
"6959","Oman",1976,83590000,682921000,"Japan",766511000,20.3418897446666,18.2414344536753
"6960","Oman",1977,111056000,882964000,"Japan",994020000,20.5987949876352,18.5255451365615
"6961","Oman",1978,133933000,904099000,"Japan",1038032000,20.6224494256346,18.7128502328735
"6962","Oman",1979,172944000,1339815000,"Japan",1512759000,21.0157973816766,18.9684784006381
"6963","Oman",1980,314972000,1732764000,"Japan",2047736000,21.2729836583719,19.5679943039502
"6964","Oman",1981,513341000,2327749000,"Japan",2841090000,21.5681675431334,20.0564508996572
"6965","Oman",1982,549012000,1702409000,"Japan",2251421000,21.2553101437518,20.1236308571584
"6966","Oman",1983,539530000,2012164000,"Japan",2551694000,21.4224765967965,20.10620894816
"6967","Oman",1984,454541333,2211941816,"Japan",2666483149,21.5171366164631,19.934799409141
"6968","Oman",1985,547688462,2811340350,"Japan",3359028812,21.7569271994497,20.1212171832549
"6969","Oman",1986,322145571,1473601546,"Japan",1795747117,21.1109752725961,19.5905140852005
"6970","Oman",1987,254369343,1307902144,"Japan",1562271487,20.9916902737271,19.3542978750932
"6971","Oman",1988,346057611,1511243402,"Japan",1857301013,21.1361985939615,19.6621158249418
"6972","Oman",1989,331025710,1402643490,"Japan",1733669200,21.0616245002882,19.6177066040409
"6973","Oman",1990,423986127,1761323880,"Japan",2185310007,21.2893315677779,19.8652112933213
"6974","Oman",1991,615958754,1965745358,"Japan",2581704112,21.3991373273935,20.2386905614638
"6975","Oman",1992,806450944,1794296720,"Japan",2600747664,21.3078789826703,20.5081536278891
"6976","Oman",1993,794421953,1432226654,"Japan",2226648607,21.0824961708932,20.4931253050063
"6977","Oman",1994,718425383,1683787885,"Japan",2402213268,21.2443117858069,20.3925724070118
"6978","Oman",1995,626086910,1692312149,"Japan",2318399059,21.2493615663397,20.2549997532937
"6979","Oman",1996,655037470,1770244803,"Japan",2425282273,21.2943836807483,20.3002029980702
"6980","Oman",1997,814280867,989569545,"Japan",1803850412,20.7127806035084,20.5178159099069
"6981","Oman",1998,889421000,1100505000,"Japan",1989926000,20.8190350023098,20.6060812471856
"6982","Oman",1999,645663435,1542208201,"Japan",2187871636,21.1564811230769,20.285788927528
"6983","Oman",2000,822184792,1846332865,"Japan",2668517657,21.3364672736733,20.5274757355409
"6984","Oman",2001,806570937,2120637625,"Japan",2927208562,21.4749826469186,20.5083024082642
"6985","Oman",2002,875544671,1895834057,"Japan",2771378728,21.3629247142696,20.5903567318037
"6986","Oman",2003,969840967,2303682736,"Japan",3273523703,21.5577748689095,20.6926426644738
"6987","Oman",2004,1099470127,1476802262,"Japan",2576272389,21.1131449534018,20.8180941979674
"6988","Oman",2005,1253670452,2479305452,"Japan",3732975904,21.6312442982218,20.9493414471717
"6989","Oman",2006,1706170039,2430296198,"Japan",4136466237,21.6112789790517,21.2575169522097
"6990","Oman",2007,2271611200,3208017280,"Japan",5479628480,21.8889189134698,21.5437551964009
"6991","Oman",2008,3203751745,5030373047,"Japan",8234124792,22.3387599827215,21.8875883803166
"6992","Oman",2009,2430213437,2958410609,"Japan",5388624046,21.8079180046507,21.6112449245981
"6993","Oman",2010,2923374619,4084274428,"Japan",7007649047,22.1304099308777,21.7960044773677
"6994","Oman",2011,2791840909,5115872847,"Japan",7907713756,22.3556138663667,21.7499670392059
"6995","Oman",2012,3578396577,6832825881,"Japan",10411222458,22.6450041703481,21.9981806535097
"6996","Oman",2013,3120651470,5478325237,"Japan",8598976707,22.4240652775108,21.8613076214584
"6997","Oman",2014,3524626276,3894518529,"Japan",7419144805,22.0828358960482,21.9830402465971
"6998","Oman",2015,3195803190,1506731386,"Japan",4702534576,21.1332084965096,21.8851042828542
"6999","Oman",2016,2545437282,1754627597,"Japan",4300064879,21.285522475906,21.6575682922288
"7000","Oman",2017,430444753,74891439,"Japan",505336192,18.1315501428894,19.8803295414249
"7001","Pakistan",1962,58257000,28524000,"Japan",86781000,17.1662563961303,17.8803748148639
"7002","Pakistan",1963,46846000,47746000,"Japan",94592000,17.6814058517486,17.662376184135
"7003","Pakistan",1964,76488000,31145000,"Japan",107633000,17.2541642766704,18.1526444237474
"7004","Pakistan",1965,102602000,26526000,"Japan",129128000,17.0936359420364,18.4463679836883
"7005","Pakistan",1966,79341000,30521000,"Japan",109862000,17.2339255292435,18.1892655769539
"7006","Pakistan",1967,95007000,37640000,"Japan",132647000,17.4435778726815,18.3694611310608
"7007","Pakistan",1968,109646000,56875000,"Japan",166521000,17.8563664352354,18.5127675524546
"7008","Pakistan",1969,111322000,37558000,"Japan",148880000,17.4413969627503,18.5279374606841
"7009","Pakistan",1970,129637000,42349000,"Japan",171986000,17.5614553660327,18.680248794964
"7010","Pakistan",1971,99448000,57928000,"Japan",157376000,17.8747114180508,18.4151454524537
"7011","Pakistan",1972,57479000,110299000,"Japan",167778000,18.5187054179995,17.8669302216682
"7012","Pakistan",1973,86920000,149880000,"Japan",236800000,18.8253455318898,18.2804987133525
"7013","Pakistan",1974,180918000,74453000,"Japan",255371000,18.1256786117828,19.013554447903
"7014","Pakistan",1975,278028000,88531000,"Japan",366559000,18.2988633311294,19.4432323860075
"7015","Pakistan",1976,259726000,105823000,"Japan",365549000,18.4772784450668,19.3751377871397
"7016","Pakistan",1977,372966000,93974000,"Japan",466940000,18.3585287062299,19.7369978206384
"7017","Pakistan",1978,325100000,155715000,"Japan",480815000,18.8635379712776,19.5996433852741
"7018","Pakistan",1979,512015000,205901000,"Japan",717916000,19.1429060287128,20.0538644794496
"7019","Pakistan",1980,548847000,211570000,"Japan",760417000,19.1700664709595,20.1233302721084
"7020","Pakistan",1981,655026000,218978000,"Japan",874004000,19.2044818261137,20.3001854874682
"7021","Pakistan",1982,673822000,236132000,"Japan",909954000,19.2799015286615,20.3284765390419
"7022","Pakistan",1983,768607000,263033000,"Japan",1031640000,19.3877900575558,20.4600903435217
"7023","Pakistan",1984,812160839,217152158,"Japan",1029312997,19.1961088547267,20.5152089560974
"7024","Pakistan",1985,708449946,344172768,"Japan",1052622714,19.6566543218193,20.3785899667518
"7025","Pakistan",1986,836696235,318129704,"Japan",1154825939,19.5779697318002,20.544971641435
"7026","Pakistan",1987,915675055,450279857,"Japan",1365954912,19.9253798518707,20.6351721162523
"7027","Pakistan",1988,906552385,501866062,"Japan",1408418447,20.0338438332913,20.6251593746859
"7028","Pakistan",1989,849325247,531235430,"Japan",1380560677,20.0907158519445,20.5599527651423
"7029","Pakistan",1990,1006702244,487562799,"Japan",1494265043,20.0049296585673,20.7299457207624
"7030","Pakistan",1991,1148839044,589319507,"Japan",1738158551,20.1944790512457,20.8620177424495
"7031","Pakistan",1992,1203152713,478568400,"Japan",1681721113,19.9863097053498,20.908211209357
"7032","Pakistan",1993,1389204618,453743611,"Japan",1842948229,19.9330428630034,21.051997203044
"7033","Pakistan",1994,853184183,498544334,"Japan",1351728517,20.0272030782161,20.5644860059461
"7034","Pakistan",1995,1146483791,535444418,"Japan",1681928209,20.0986076478805,20.8599655223516
"7035","Pakistan",1996,1123595022,519310725,"Japan",1642905747,20.0680129614031,20.8397992227823
"7036","Pakistan",1997,682415564,281126800,"Japan",963542364,19.454316371069,20.341149361619
"7037","Pakistan",1998,745817000,308341000,"Japan",1054158000,19.5467168713643,20.429990819764
"7038","Pakistan",1999,612801884,260392969,"Japan",873194853,19.3777024671661,20.2335522507985
"7039","Pakistan",2000,605242642,226301261,"Japan",831543903,19.2373776828375,20.2211399967486
"7040","Pakistan",2001,476868706,198911387,"Japan",675780093,19.1083699920598,19.9827517614886
"7041","Pakistan",2002,607095824,136501061,"Japan",743596885,18.7318429454529,20.2241972014738
"7042","Pakistan",2003,777220662,121799044,"Japan",899019706,18.6178830642766,20.4712348602917
"7043","Pakistan",2004,1054825887,154132889,"Japan",1208958776,18.8533257038647,20.7766415542355
"7044","Pakistan",2005,1484290584,127670331,"Japan",1611960915,18.6649619604148,21.1182027738438
"7045","Pakistan",2006,1687224252,194554952,"Japan",1881779204,19.0862252106818,21.2463505611365
"7046","Pakistan",2007,1505887793,226889753,"Japan",1732777546,19.2399747878665,21.1326484569082
"7047","Pakistan",2008,1552316975,411128559,"Japan",1963445534,19.8344165191706,21.1630144743231
"7048","Pakistan",2009,1163336839,219073605,"Japan",1382410444,19.2049183272036,20.8745582979551
"7049","Pakistan",2010,1436881351,318457913,"Japan",1755339264,19.5790008829578,21.0857408734807
"7050","Pakistan",2011,1681184912,328660860,"Japan",2009845772,19.6105369563999,21.242764686513
"7051","Pakistan",2012,1667566349,380818286,"Japan",2048384635,19.7578328796865,21.2346311244677
"7052","Pakistan",2013,1398462607,317745839,"Japan",1716208446,19.5767623727475,21.0586393323153
"7053","Pakistan",2014,1596296190,317015271,"Japan",1913311461,19.5744605041828,21.1909519014625
"7054","Pakistan",2015,1656854847,252251210,"Japan",1909106057,19.345936014015,21.2281869716744
"7055","Pakistan",2016,1916458996,244151688,"Japan",2160610684,19.3133002622306,21.3737450473042
"7056","Pakistan",2017,2313920367.5,383422423.5,"Japan",2697342791,19.7646478727811,21.5622090517722
"7057","Panama",1962,4690000,13720000,"Japan",18410000,16.434365180262,15.3609431404225
"7058","Panama",1963,4962000,24866000,"Japan",29828000,17.029011966495,15.4173194432339
"7059","Panama",1964,7113000,11035000,"Japan",18148000,16.216582597673,15.7774346537157
"7060","Panama",1965,10833000,6333000,"Japan",17166000,15.6612846154986,16.1981075889277
"7061","Panama",1966,12028000,8749000,"Japan",20777000,15.9844499660884,16.3027478230906
"7062","Panama",1967,13742000,4019000,"Japan",17761000,15.2065436734313,16.4359673945732
"7063","Panama",1968,14125000,2520000,"Japan",16645000,14.7397694594876,16.4634568349968
"7064","Panama",1969,17757000,1780000,"Japan",19537000,14.3921239222683,16.692290362341
"7065","Panama",1970,23604000,2302000,"Japan",25906000,14.649288868264,16.9769267471592
"7066","Panama",1971,31466000,3521000,"Japan",34987000,15.0742555981372,17.2644181557825
"7067","Panama",1972,38885000,3267000,"Japan",42152000,14.9993826905832,17.4761191301112
"7068","Panama",1973,32730000,9459000,"Japan",42189000,16.0624772271953,17.3038026464774
"7069","Panama",1974,49214000,8400000,"Japan",57614000,15.9437422638135,17.7116886938306
"7070","Panama",1975,44121000,35184000,"Japan",79305000,17.3761019917767,17.6024464175506
"7071","Panama",1976,47569000,35591000,"Japan",83160000,17.3876033548719,17.6776918465352
"7072","Panama",1977,40048000,28810000,"Japan",68858000,17.1762331070607,17.5055892926537
"7073","Panama",1978,1460333000,86389000,"Japan",1546722000,18.2743709108543,21.1019303288516
"7074","Panama",1979,52879000,178654000,"Japan",231533000,19.0009615323314,17.7835168425876
"7075","Panama",1980,89015000,61389000,"Japan",150404000,17.9327412239731,18.3043154528211
"7076","Panama",1981,94605000,131486000,"Japan",226091000,18.6944109400361,18.365220886748
"7077","Panama",1982,119431000,107938000,"Japan",227369000,18.4970675461708,18.5982493567151
"7078","Panama",1983,110160000,68016000,"Japan",178176000,18.0352535295807,18.5174444123847
"7079","Panama",1984,3450413825,152859269,"Japan",3603273094,18.845028245614,21.9617600100717
"7080","Panama",1985,3334110960,72287574,"Japan",3406398534,18.0961628051382,21.9274719020649
"7081","Panama",1986,3207859263,74901422,"Japan",3282760685,18.131683433621,21.8888696553524
"7082","Panama",1987,2426610624,61402247,"Japan",2488012871,17.932956988539,21.6097613157147
"7083","Panama",1988,2657413810,123051094,"Japan",2780464904,18.6281102254567,21.7006192349169
"7084","Panama",1989,2507395266,74367176,"Japan",2581762442,18.1245252196579,21.6425103086329
"7085","Panama",1990,2886260650,99202019,"Japan",2985462669,18.4126689248706,21.7832276085352
"7086","Panama",1991,3950271751,88540406,"Japan",4038812157,18.2989695707558,22.0970502112145
"7087","Panama",1992,4293272477,118813453,"Japan",4412085930,18.5930651992223,22.1803150942422
"7088","Panama",1993,4607971764,122726068,"Japan",4730697832,18.6254653402539,22.2510536327171
"7089","Panama",1994,5887429787,95579892,"Japan",5983009679,18.3754730211701,22.4960853704429
"7090","Panama",1995,7179025510,72224351,"Japan",7251249861,18.095287818468,22.6944294879541
"7091","Panama",1996,5910196118,54838759,"Japan",5965034877,17.8199077829348,22.4999448519086
"7092","Panama",1997,5865188784,34888555,"Japan",5900077339,17.3676693964268,22.4923005067691
"7093","Panama",1998,6184157000,18560000,"Japan",6202717000,16.7365192853223,22.5452565360076
"7094","Panama",1999,6645165039,62935399,"Japan",6708100438,17.9576193455621,22.617155365372
"7095","Panama",2000,6452366996,27580041,"Japan",6479947037,17.1326029169128,22.5877128765589
"7096","Panama",2001,4831134808,50181514,"Japan",4881316322,17.7311572698304,22.298347226911
"7097","Panama",2002,4631814893,70263057,"Japan",4702077950,18.0677567136761,22.2562146137675
"7098","Panama",2003,5469185231,94076934,"Japan",5563262165,18.3596234522978,22.4223954900006
"7099","Panama",2004,6067352510,104725505,"Japan",6172078015,18.466853246939,22.5261881870702
"7100","Panama",2005,7365100438,38316929,"Japan",7403417367,17.4614023669369,22.720018523971
"7101","Panama",2006,8019004327,31502822,"Japan",8050507149,17.2655876870847,22.8050801023646
"7102","Panama",2007,519239996,12032392,"Japan",531272388,16.3031129044283,20.0678767542855
"7103","Panama",2008,592152327,15935254,"Japan",608087581,16.5840444454618,20.1992744688716
"7104","Panama",2009,12735899444,158138622,"Japan",12894038066,18.8789825607712,23.2676905706027
"7105","Panama",2010,465587416,375414304,"Japan",841001720,19.7435407847472,19.9588104265248
"7106","Panama",2011,14929534774,296414195,"Japan",15225948969,19.5072683416025,23.4266072875298
"7107","Panama",2012,14187926650,312553343,"Japan",14500479993,19.5602857101736,23.3756572039826
"7108","Panama",2013,9658217893,324760415,"Japan",9982978308,19.5985982838244,22.9910749850254
"7109","Panama",2014,7002160210,69063038,"Japan",7071223248,18.0505302396913,22.6694845398227
"7110","Panama",2015,4708413376,281164917,"Japan",4989578293,19.454451948382,22.2726168253787
"7111","Panama",2016,5657396357,350963362,"Japan",6008359719,19.6761923942156,22.4562296157284
"7112","Panama",2017,0,0,"0",0,0,0
"7113","Peru",1962,29154000,58371000,"Japan",87525000,17.8823297491216,17.1881026826161
"7114","Peru",1963,35241000,68962000,"Japan",104203000,18.0490661862193,17.3777207354741
"7115","Peru",1964,32330000,99170000,"Japan",131500000,18.4123461071623,17.2915061497016
"7116","Peru",1965,52144000,111073000,"Japan",163217000,18.5256982007722,17.7695196800595
"7117","Peru",1966,59396000,124067000,"Japan",183463000,18.6363323002283,17.8997374419981
"7118","Peru",1967,64032000,154580000,"Japan",218612000,18.856222319643,17.9748935163656
"7119","Peru",1968,39779000,194776000,"Japan",234555000,19.0873607382971,17.4988496928137
"7120","Peru",1969,43233000,210710000,"Japan",253943000,19.165993338493,17.5821146504886
"7121","Peru",1970,48894000,210444000,"Japan",259338000,19.1647301424394,17.7051652475304
"7122","Peru",1971,71894000,174164000,"Japan",246058000,18.9755079420131,18.0907033699741
"7123","Peru",1972,61476000,185462000,"Japan",246938000,19.0383605672748,17.9341574127093
"7124","Peru",1973,113207000,235519000,"Japan",348726000,19.2773021475719,18.5447285592773
"7125","Peru",1974,184348000,297007000,"Japan",481355000,19.5092662655128,19.0323358336569
"7126","Peru",1975,207834000,205806000,"Japan",413640000,19.1424445354582,19.1522502421096
"7127","Peru",1976,143943000,232131000,"Japan",376074000,19.2628124254453,18.7849279458442
"7128","Peru",1977,136055000,303418000,"Japan",439473000,19.5306219507392,18.7285697737126
"7129","Peru",1978,94455000,298974000,"Japan",393429000,19.5158671710523,18.3636340885731
"7130","Peru",1979,111761000,511087000,"Japan",622848000,20.0520503880795,18.5318732206181
"7131","Peru",1980,267587000,475167000,"Japan",742754000,19.9791768791569,19.4049553050682
"7132","Peru",1981,350103000,602246000,"Japan",952349000,20.2161765576771,19.6737379548685
"7133","Peru",1982,340845000,541180000,"Japan",882025000,20.1092624986631,19.6469383864561
"7134","Peru",1983,181356000,487346000,"Japan",668702000,20.0044849010602,19.0159725083403
"7135","Peru",1984,160992789,369142936,"Japan",530135725,19.7266944874337,18.8968701331258
"7136","Peru",1985,168256426,298597499,"Japan",466853925,19.5146070672808,18.9409997189247
"7137","Peru",1986,204996049,294093244,"Japan",499089293,19.4994074314821,19.1385012637462
"7138","Peru",1987,224181558,295686419,"Japan",519867977,19.5048100554623,19.2279668083056
"7139","Peru",1988,114170714,372431343,"Japan",486602057,19.735563264702,18.553205377465
"7140","Peru",1989,77827076,448456197,"Japan",526283273,19.9213215691417,18.1699999491691
"7141","Peru",1990,86560041,524106587,"Japan",610666628,20.0772056319056,18.2763488467222
"7142","Peru",1991,163249434,358036317,"Japan",521285751,19.6961449833539,18.9107898590398
"7143","Peru",1992,286954446,312326372,"Japan",599280818,19.5595592631325,19.4748340363871
"7144","Peru",1993,304147281,305588285,"Japan",609735566,19.5377492800978,19.5330226190231
"7145","Peru",1994,443608005,380822014,"Japan",824430019,19.7578426690845,19.9104518588142
"7146","Peru",1995,481304656,484763708,"Japan",966068364,19.9991721301813,19.9920110080267
"7147","Peru",1996,397427992,383825931,"Japan",781253923,19.7656997030909,19.8005243234474
"7148","Peru",1997,485630067,261160882,"Japan",746790949,19.380647181517,20.0009577130086
"7149","Peru",1998,531386000,286505000,"Japan",817891000,19.4732665459738,20.0909992454405
"7150","Peru",1999,437343274,261214740,"Japan",698558014,19.3808533856273,19.8962289687248
"7151","Peru",2000,438557156,318392527,"Japan",756949683,19.5787955411817,19.8990007056382
"7152","Peru",2001,387815303,380712481,"Japan",768527784,19.75755500516,19.7760397610567
"7153","Peru",2002,371383985,386321020,"Japan",757705005,19.7721792398243,19.7327470853285
"7154","Peru",2003,335683770,390883974,"Japan",726567744,19.7839213322251,19.6316801140434
"7155","Peru",2004,323969320,616002421,"Japan",939971741,20.2387614516849,19.5961593779151
"7156","Peru",2005,403336112,638045106,"Japan",1041381218,20.2739195378696,19.8152807971194
"7157","Peru",2006,513259466,1196716025,"Japan",1709975491,20.902846996446,20.056292056947
"7158","Peru",2007,706649609,2015341705,"Japan",2721991314,21.424054598613,20.3760454984633
"7159","Peru",2008,1091806951,1922678135,"Japan",3014485086,21.376984913049,20.8110999138423
"7160","Peru",2009,787767260,1497309197,"Japan",2285076457,21.1269354654787,20.4847132488662
"7161","Peru",2010,1191578750,1897339359,"Japan",3088918109,21.3637184043617,20.8985449454789
"7162","Peru",2011,901087625,2260183066,"Japan",3161270691,21.5387116496049,20.619113063896
"7163","Peru",2012,1027787900,2714499178,"Japan",3742287078,21.7218733084915,20.7506746597347
"7164","Peru",2013,977982702,2530666469,"Japan",3508649171,21.6517485314774,20.7010025407261
"7165","Peru",2014,738836141,1526845890,"Japan",2265682031,21.1464699347106,20.4205867236094
"7166","Peru",2015,745147597,1224903170,"Japan",1970050767,20.9261276329209,20.4290928734998
"7167","Peru",2016,673276465,1243355664,"Japan",1916632129,20.9410797420945,20.3276665982039
"7168","Peru",2017,895919413,1953016903.5,"Japan",2848936316.5,21.3926411439494,20.6133610260461
"7169","Philippines",1962,106419000,183955000,"Japan",290374000,19.0302017204449,18.4828946903584
"7170","Philippines",1963,114817000,230184000,"Japan",345001000,19.254389547058,18.5588501145101
"7171","Philippines",1964,173237000,224333000,"Japan",397570000,19.2286421130557,18.9701711571439
"7172","Philippines",1965,213541000,253697000,"Japan",467238000,19.3516511995094,19.1793394096668
"7173","Philippines",1966,264629000,324998000,"Japan",589627000,19.5993295864289,19.3938394030349
"7174","Philippines",1967,334367000,374471000,"Japan",708838000,19.7410249213411,19.6277497500947
"7175","Philippines",1968,353027000,397974000,"Japan",751001000,19.8018972344817,19.6820550992247
"7176","Philippines",1969,363311000,468073000,"Japan",831384000,19.9641348246238,19.7107697747402
"7177","Philippines",1970,370413000,533504000,"Japan",903917000,20.094977126335,19.7301291573126
"7178","Philippines",1971,390466000,515294000,"Japan",905760000,20.060248169528,19.7828514555917
"7179","Philippines",1972,424500000,470388000,"Japan",894888000,19.9690684440192,19.8664225637157
"7180","Philippines",1973,561098000,818848000,"Japan",1379946000,20.5234090324074,20.1454061362878
"7181","Philippines",1974,935310000,1102662000,"Japan",2037972000,20.8209930932663,20.6563885831043
"7182","Philippines",1975,1052108000,1116851000,"Japan",2168959000,20.8337789551188,20.7740616075895
"7183","Philippines",1976,1072270000,793108000,"Japan",1865378000,20.4914699620031,20.7930437335538
"7184","Philippines",1977,1074229000,897377000,"Japan",1971606000,20.6149866215811,20.7948690319061
"7185","Philippines",1978,1412937000,1057773000,"Japan",2470710000,20.7794315915965,21.0689363536676
"7186","Philippines",1979,1510713000,1582754000,"Japan",3093467000,21.1824322046322,21.1358475617592
"7187","Philippines",1980,1651304000,1951424000,"Japan",3602728000,21.3918251994248,21.2248311157642
"7188","Philippines",1981,1608879000,1731224000,"Japan",3340103000,21.2720945097366,21.19880350014
"7189","Philippines",1982,1661795000,1534456000,"Japan",3196251000,21.1514417577778,21.231164180405
"7190","Philippines",1983,1741095000,1306497000,"Japan",3047592000,20.9906153467111,21.277780062585
"7191","Philippines",1984,790138038,1403155288,"Japan",2193293326,21.0619893147644,20.4877182198071
"7192","Philippines",1985,712844708,1188603960,"Japan",1901448668,20.896045312542,20.384774153815
"7193","Philippines",1986,838298448,1171296886,"Japan",2009595334,20.8813774214521,20.5468847382405
"7194","Philippines",1987,1414701923,1312641576,"Japan",2727343499,20.9953074140414,21.070184690727
"7195","Philippines",1988,1383359308,1835996535,"Japan",3219355843,21.330853241888,21.0477806592121
"7196","Philippines",1989,1980873951,1871491632,"Japan",3852365583,21.350001614019,21.4068039736632
"7197","Philippines",1990,2165819542,1970076371,"Japan",4135895913,21.40133814595,21.4960646681117
"7198","Philippines",1991,2284954897,2127477820,"Japan",4412432717,21.4782029929756,21.5496121223669
"7199","Philippines",1992,2999169855,2195647183,"Japan",5194817038,21.5097426842069,21.8216013723219
"7200","Philippines",1993,3884751536,2148728278,"Japan",6033479814,21.488142005477,22.0803248640233
"7201","Philippines",1994,5041199557,2468564353,"Japan",7509763910,21.6269025850013,22.3409098980517
"7202","Philippines",1995,5677853069,3133351021,"Japan",8811204090,21.8653688825383,22.4598390174169
"7203","Philippines",1996,7080463610,4102851377,"Japan",11183314987,22.1349480267428,22.6806052241466
"7204","Philippines",1997,5723548515,3992512626,"Japan",9716061141,22.107686600478,22.4678548197436
"7205","Philippines",1998,6364929000,4299063000,"Japan",10663992000,22.181662928924,22.574068914141
"7206","Philippines",1999,5863072862,4797045465,"Japan",10660118327,22.29126603722,22.4919396822775
"7207","Philippines",2000,6263882429,6501367563,"Japan",12765249992,22.5952783860259,22.558066026142
"7208","Philippines",2001,6294143458,5785527075,"Japan",12079670533,22.4786253040727,22.5628854281474
"7209","Philippines",2002,7127205817,5889632736,"Japan",13016838553,22.4964594788458,22.6871851035394
"7210","Philippines",2003,7462286098,6340966277,"Japan",13803252375,22.5702970034038,22.7331276516697
"7211","Philippines",2004,7275512626,7439915119,"Japan",14715427745,22.7301252769898,22.7077801115765
"7212","Philippines",2005,7644841136,6939060913,"Japan",14583902049,22.6604322871795,22.7572968959938
"7213","Philippines",2006,6945005834,7302734500,"Japan",14247740334,22.7115147040009,22.6612886531812
"7214","Philippines",2007,6746604329,8061308971,"Japan",14807913300,22.8103417836288,22.6323051528822
"7215","Philippines",2008,6686586711,7642738693,"Japan",14329325404,22.7570218435608,22.623369373263
"7216","Philippines",2009,5601395204,5716758599,"Japan",11318153803,22.4666678032187,22.4462815472278
"7217","Philippines",2010,7103151636,7098919420,"Japan",14202071056,22.6832084150447,22.683804414897
"7218","Philippines",2011,10755661217,8825042223,"Japan",19580703440,22.9008592242302,23.0986980777391
"7219","Philippines",2012,11427055181,9230000605,"Japan",20657055786,22.9457249510083,23.1592496421008
"7220","Philippines",2013,9251392101,9172647739,"Japan",18424039840,22.9394918207961,22.9480398745526
"7221","Philippines",2014,9395211625,10080426783,"Japan",19475638408,23.0338614382767,22.9634659948376
"7222","Philippines",2015,8918660075,8741449425,"Japan",17660109500,22.8913418509649,22.9114115564476
"7223","Philippines",2016,9662375277,8864572077,"Japan",18526947354,22.9053285042415,22.9915053428336
"7224","Philippines",2017,11367988826,10422974235,"Japan",21790963061,23.0672782677635,23.1540672448062
"7225","Papua New Guinea",1962,3946000,1861000,"Japan",5807000,14.4366245356244,15.1882129655647
"7226","Papua New Guinea",1963,4664000,2266000,"Japan",6930000,14.6335267205701,15.3553840070125
"7227","Papua New Guinea",1964,6592000,2699000,"Japan",9291000,14.8083918920001,15.7013673505714
"7228","Papua New Guinea",1965,8787000,3040000,"Japan",11827000,14.9273680733824,15.988783914478
"7229","Papua New Guinea",1966,12757000,3180000,"Japan",15937000,14.9723917547564,16.3615906985204
"7230","Papua New Guinea",1967,13737000,3991000,"Japan",17728000,15.1995523840309,16.4356034803073
"7231","Papua New Guinea",1968,16790000,6946000,"Japan",23736000,15.7536765122862,16.6362940290537
"7232","Papua New Guinea",1969,21731000,8217000,"Japan",29948000,15.9217157369133,16.8942503705019
"7233","Papua New Guinea",1970,37743000,15757000,"Japan",53500000,16.5727952689442,17.4463105860014
"7234","Papua New Guinea",1971,48104000,17113000,"Japan",65217000,16.6553489665596,17.6888758917015
"7235","Papua New Guinea",1972,43951000,66093000,"Japan",110044000,18.0065733990628,17.5985859349652
"7236","Papua New Guinea",1973,44808000,222363000,"Japan",267171000,19.2198217395937,17.6178972528718
"7237","Papua New Guinea",1974,56151000,292988000,"Japan",349139000,19.4956422105112,17.8435550484291
"7238","Papua New Guinea",1975,71356000,143965000,"Japan",215321000,18.7850807724419,18.0831919908533
"7239","Papua New Guinea",1976,63101000,171553000,"Japan",234654000,18.9604028147288,17.9602471752464
"7240","Papua New Guinea",1977,97792000,207279000,"Japan",305071000,19.1495762698144,18.3983533320683
"7241","Papua New Guinea",1978,119054000,227510000,"Japan",346564000,19.2427047514332,18.5950877296607
"7242","Papua New Guinea",1979,123234000,367127000,"Japan",490361000,19.721218395204,18.6295955450158
"7243","Papua New Guinea",1980,167975000,405210000,"Japan",573185000,19.8199160092051,18.9393257167705
"7244","Papua New Guinea",1981,178139000,328153000,"Japan",506292000,19.6089905210028,18.9980747023899
"7245","Papua New Guinea",1982,127411000,286370000,"Japan",413781000,19.4727952389609,18.6629286396043
"7246","Papua New Guinea",1983,141569000,322229000,"Japan",463798000,19.5907730308642,18.7682977887023
"7247","Papua New Guinea",1984,138568796,258905781,"Japan",397474577,19.3719747735571,18.7468774822878
"7248","Papua New Guinea",1985,142532695,228999482,"Japan",371532177,19.2492302995072,18.7750819699525
"7249","Papua New Guinea",1986,149478046,266381302,"Japan",415859348,19.4004393064795,18.8226600905132
"7250","Papua New Guinea",1987,188250895,359958446,"Japan",548209341,19.7014991549744,19.053286178949
"7251","Papua New Guinea",1988,218142652,501936857,"Japan",720079509,20.0339848868761,19.2006597737211
"7252","Papua New Guinea",1989,213785105,486438426,"Japan",700223531,20.0026208863182,19.1804818862144
"7253","Papua New Guinea",1990,145624761,303700916,"Japan",449325677,19.5315539461458,18.7965437410812
"7254","Papua New Guinea",1991,163504678,336966556,"Japan",500471234,19.6354942430359,18.9123521595131
"7255","Papua New Guinea",1992,166749613,372959385,"Japan",539708998,19.73698008428,18.9320039219177
"7256","Papua New Guinea",1993,186722537,602697575,"Japan",789420112,20.2169260948845,19.0451343135996
"7257","Papua New Guinea",1994,178870518,672619232,"Japan",851489750,20.3266899503794,19.0021727389232
"7258","Papua New Guinea",1995,120423209,655369563,"Japan",775792772,20.3007098528088,18.6065228380428
"7259","Papua New Guinea",1996,154454267,534990652,"Japan",689444919,20.0977598318104,18.855408604011
"7260","Papua New Guinea",1997,151788410,288764357,"Japan",440552767,19.4811215397763,18.8379980695498
"7261","Papua New Guinea",1998,94050000,265743000,"Japan",359793000,19.3980402342938,18.3593371137113
"7262","Papua New Guinea",1999,64209082,324099702,"Japan",388308784,19.5965617486421,17.9776552228295
"7263","Papua New Guinea",2000,106305890,331650871,"Japan",437956761,19.619593380195,18.4818312509963
"7264","Papua New Guinea",2001,101045366,270324808,"Japan",371370174,19.4151347865395,18.4310801422765
"7265","Papua New Guinea",2002,58090370,251642799,"Japan",309733169,19.3435211756371,17.8775104593752
"7266","Papua New Guinea",2003,59250442,269802027,"Japan",329052469,19.4131990146823,17.8972837978673
"7267","Papua New Guinea",2004,75167032,250601112,"Japan",325768144,19.3393730377668,18.1352232885375
"7268","Papua New Guinea",2005,79424245,460357909,"Japan",539782154,19.9475148079568,18.1903142322516
"7269","Papua New Guinea",2006,92898903,595316467,"Japan",688215370,20.2046036994242,18.3470223953182
"7270","Papua New Guinea",2007,152476483,747600389,"Japan",900076872,20.4323791538773,18.8425209322841
"7271","Papua New Guinea",2008,179939440,817424890,"Japan",997364330,20.5216695788388,19.0081309077999
"7272","Papua New Guinea",2009,157044959,619210498,"Japan",776255457,20.2439558342304,18.8720426853758
"7273","Papua New Guinea",2010,294274979,866301265,"Japan",1160576244,20.5797432870925,19.500025190901
"7274","Papua New Guinea",2011,323726491,927679043,"Japan",1251405534,20.6481963720913,19.5954095536696
"7275","Papua New Guinea",2012,470190971,1127492478,"Japan",1597683449,20.843261957922,19.9686494914188
"7276","Papua New Guinea",2013,306807586,524336731,"Japan",831144317,20.077644652308,19.5417313533577
"7277","Papua New Guinea",2014,179483097,2132402018,"Japan",2311885115,21.480514889264,19.0055915943277
"7278","Papua New Guinea",2015,171425316,2583253692,"Japan",2754679008,21.6723155622651,18.9596582545047
"7279","Papua New Guinea",2016,160268620,1931037903,"Japan",2091306523,21.3813234688899,18.8923618404629
"7280","Papua New Guinea",2017,0,0,"0",0,0,0
"7281","Poland",1962,2687000,1488000,"Japan",4175000,14.2129434943752,14.8039358875976
"7282","Poland",1963,1179000,1343000,"Japan",2522000,14.1104164755054,13.9801771795195
"7283","Poland",1964,2468000,2078000,"Japan",4546000,14.5469164506413,14.7189186640074
"7284","Poland",1965,5401000,1948000,"Japan",7349000,14.4823137631846,15.502094679575
"7285","Poland",1966,2983000,4118000,"Japan",7101000,15.2308781665699,14.9084400634969
"7286","Poland",1967,5919000,26267000,"Japan",32186000,17.0838239564348,15.5936780736729
"7287","Poland",1968,7061000,39384000,"Japan",46445000,17.4888702004202,15.7700972424985
"7288","Poland",1969,14067000,43672000,"Japan",57739000,17.5922177224437,16.4593421867398
"7289","Poland",1970,22411000,39570000,"Japan",61981000,17.4935818133616,16.9250624677177
"7290","Poland",1971,41767000,31508000,"Japan",73275000,17.2657520398054,17.5476171120123
"7291","Poland",1972,88746000,39921000,"Japan",128667000,17.502413059194,18.3012889148816
"7292","Poland",1973,130193000,48964000,"Japan",179157000,17.7065958921775,18.6845285228526
"7293","Poland",1974,220449000,79446000,"Japan",299895000,18.1905881035499,19.2111769335819
"7294","Poland",1975,257161000,79905000,"Japan",337066000,18.1963489870013,19.3652129058598
"7295","Poland",1976,253743000,77045000,"Japan",330788000,18.1599002246981,19.3518325017329
"7296","Poland",1977,299829000,73274000,"Japan",373103000,18.1097163972487,19.5187228701087
"7297","Poland",1978,265650000,62577000,"Japan",328227000,17.9519083564174,19.3976902108612
"7298","Poland",1979,221125000,72937000,"Japan",294062000,18.1051066128033,19.2142387104442
"7299","Poland",1980,142910000,61570000,"Japan",204480000,17.9356852968874,18.777725619458
"7300","Poland",1981,99491000,35910000,"Japan",135401000,17.3965263662023,18.4155777457765
"7301","Poland",1982,60846000,38938000,"Japan",99784000,17.477481195521,17.9238566398222
"7302","Poland",1983,70187000,57499000,"Japan",127686000,17.867278114312,18.066673666662
"7303","Poland",1984,63161780,64792681,"Japan",127954461,17.9867032074126,17.9612099293485
"7304","Poland",1985,73213417,60428679,"Japan",133642096,17.9169743680955,18.1088892544853
"7305","Poland",1986,146086986,50269313,"Japan",196356299,17.7329053693729,18.7997127967781
"7306","Poland",1987,166861825,68080247,"Japan",234942072,18.0361976703074,18.9326766326911
"7307","Poland",1988,258063709,104022890,"Japan",362086599,18.4601215290419,19.3687170465112
"7308","Poland",1989,200878170,118311273,"Japan",319189443,18.5888296160401,19.1182091628557
"7309","Poland",1990,304183506,167548763,"Japan",471732269,18.9367849892496,19.5331417154122
"7310","Poland",1991,344477774,171347819,"Japan",515825593,18.9592060778701,19.6575401296458
"7311","Poland",1992,302951414,149426666,"Japan",452378080,18.8223163020185,19.5290830007812
"7312","Poland",1993,296679123,93616733,"Japan",390295856,18.3547196968376,19.5081617187813
"7313","Poland",1994,302637476,64054190,"Japan",366691666,17.9752400018098,19.5280461983124
"7314","Poland",1995,421098693,76985370,"Japan",498084063,18.1591259617657,19.8583777893515
"7315","Poland",1996,537781605,82569814,"Japan",620351419,18.2291547237569,20.1029630970489
"7316","Poland",1997,806083054,67672766,"Japan",873755820,18.0301943822068,20.5076973398272
"7317","Poland",1998,903676000,68989000,"Japan",972665000,18.0494576295629,20.6219814470336
"7318","Poland",1999,836510882,73935425,"Japan",910446307,18.1187026350656,20.5447500872725
"7319","Poland",2000,934415401,75423382,"Japan",1009838783,18.138627891006,20.655431652137
"7320","Poland",2001,869163322,85715195,"Japan",954878517,18.2665406724022,20.5830416080333
"7321","Poland",2002,918427099,91145241,"Japan",1009572340,18.3279648470841,20.6381730898451
"7322","Poland",2003,1123940784,117987550,"Japan",1241928334,18.586089668389,20.8401069037561
"7323","Poland",2004,1540394870,192310349,"Japan",1732705219,19.0746210260636,21.1553046295957
"7324","Poland",2005,1759977106,207268378,"Japan",1967245484,19.1495250235609,21.2885666379573
"7325","Poland",2006,1850308905,236886920,"Japan",2087195825,19.2830934544346,21.3386184377734
"7326","Poland",2007,2705969774,342643099,"Japan",3048612873,19.6521999357087,21.71872619664
"7327","Poland",2008,3730055471,432247447,"Japan",4162302918,19.884508776206,22.0396889420733
"7328","Poland",2009,2503354051,341621448,"Japan",2844975499,19.6492138047929,21.6408972900521
"7329","Poland",2010,3110369811,519629529,"Japan",3629999340,20.0686266714,21.8580074663577
"7330","Poland",2011,2476564369,795012353,"Japan",3271576722,20.4938682108627,21.6301381015789
"7331","Poland",2012,1702017380,953863949,"Japan",2655881329,20.6760316081315,21.2550800785613
"7332","Poland",2013,1600790981,1005361360,"Japan",2606152341,20.7286128760195,21.19376370716
"7333","Poland",2014,1704644913,1115417683,"Japan",2820062596,20.8324947752995,21.2566226638222
"7334","Poland",2015,1645462491,1040684381,"Japan",2686146872,20.7631443923279,21.2212873311927
"7335","Poland",2016,1691902768,1121058861,"Japan",2812961629,20.8375394872405,21.2491196307582
"7336","Poland",2017,2793931931,871125920,"Japan",3665057851,20.585297093828,21.7507157349218
"7337","Puerto Rico",1962,0,0,"0",0,0,0
"7338","Puerto Rico",1963,0,0,"0",0,0,0
"7339","Puerto Rico",1964,0,0,"0",0,0,0
"7340","Puerto Rico",1965,0,0,"0",0,0,0
"7341","Puerto Rico",1966,0,0,"0",0,0,0
"7342","Puerto Rico",1967,0,0,"0",0,0,0
"7343","Puerto Rico",1968,0,0,"0",0,0,0
"7344","Puerto Rico",1969,0,0,"0",0,0,0
"7345","Puerto Rico",1970,0,0,"0",0,0,0
"7346","Puerto Rico",1971,0,0,"0",0,0,0
"7347","Puerto Rico",1972,0,0,"0",0,0,0
"7348","Puerto Rico",1973,0,0,"0",0,0,0
"7349","Puerto Rico",1974,0,0,"0",0,0,0
"7350","Puerto Rico",1975,0,0,"0",0,0,0
"7351","Puerto Rico",1976,0,0,"0",0,0,0
"7352","Puerto Rico",1977,0,0,"0",0,0,0
"7353","Puerto Rico",1978,0,0,"0",0,0,0
"7354","Puerto Rico",1979,0,0,"0",0,0,0
"7355","Puerto Rico",1980,0,0,"0",0,0,0
"7356","Puerto Rico",1981,0,0,"0",0,0,0
"7357","Puerto Rico",1982,0,0,"0",0,0,0
"7358","Puerto Rico",1983,0,0,"0",0,0,0
"7359","Puerto Rico",1984,0,0,"0",0,0,0
"7360","Puerto Rico",1985,0,0,"0",0,0,0
"7361","Puerto Rico",1986,0,0,"0",0,0,0
"7362","Puerto Rico",1987,0,0,"0",0,0,0
"7363","Puerto Rico",1988,0,0,"0",0,0,0
"7364","Puerto Rico",1989,0,0,"0",0,0,0
"7365","Puerto Rico",1990,0,0,"0",0,0,0
"7366","Puerto Rico",1991,0,0,"0",0,0,0
"7367","Puerto Rico",1992,0,0,"0",0,0,0
"7368","Puerto Rico",1993,0,0,"0",0,0,0
"7369","Puerto Rico",1994,0,0,"0",0,0,0
"7370","Puerto Rico",1995,0,0,"0",0,0,0
"7371","Puerto Rico",1996,0,0,"0",0,0,0
"7372","Puerto Rico",1997,0,0,"0",0,0,0
"7373","Puerto Rico",1998,0,0,"0",0,0,0
"7374","Puerto Rico",1999,0,0,"0",0,0,0
"7375","Puerto Rico",2000,0,0,"0",0,0,0
"7376","Puerto Rico",2001,0,0,"0",0,0,0
"7377","Puerto Rico",2002,0,0,"0",0,0,0
"7378","Puerto Rico",2003,0,0,"0",0,0,0
"7379","Puerto Rico",2004,0,0,"0",0,0,0
"7380","Puerto Rico",2005,0,0,"0",0,0,0
"7381","Puerto Rico",2006,0,0,"0",0,0,0
"7382","Puerto Rico",2007,0,0,"0",0,0,0
"7383","Puerto Rico",2008,0,0,"0",0,0,0
"7384","Puerto Rico",2009,0,0,"0",0,0,0
"7385","Puerto Rico",2010,0,0,"0",0,0,0
"7386","Puerto Rico",2011,0,0,"0",0,0,0
"7387","Puerto Rico",2012,0,0,"0",0,0,0
"7388","Puerto Rico",2013,0,0,"0",0,0,0
"7389","Puerto Rico",2014,0,0,"0",0,0,0
"7390","Puerto Rico",2015,0,0,"0",0,0,0
"7391","Puerto Rico",2016,0,0,"0",0,0,0
"7392","Puerto Rico",2017,0,0,"0",0,0,0
"7393","North Korea",1962,4779000,4553000,"Japan",9332000,15.3312969143169,15.3797418775603
"7394","North Korea",1963,5347000,9429000,"Japan",14776000,16.0593006044478,15.4920462139309
"7395","North Korea",1964,11284000,20235000,"Japan",31519000,16.8229243362921,16.238896351104
"7396","North Korea",1965,16505000,14723000,"Japan",31228000,16.5049214548475,16.6191739232694
"7397","North Korea",1966,5011000,22695000,"Japan",27706000,16.9376551938727,15.4271460539419
"7398","North Korea",1967,6367000,29606000,"Japan",35973000,17.2034876014556,15.6666389589992
"7399","North Korea",1968,20742000,34034000,"Japan",54776000,17.3428705829135,16.8476711881318
"7400","North Korea",1969,24153000,32188000,"Japan",56341000,17.2871042702482,16.9999191539502
"7401","North Korea",1970,23336000,34418000,"Japan",57754000,17.354090241307,16.9655077905297
"7402","North Korea",1971,28679000,30076000,"Japan",58755000,17.2192380694801,17.1716757055843
"7403","North Korea",1972,93436000,38310000,"Japan",131746000,17.4612215166768,18.3527872679087
"7404","North Korea",1973,99661000,72200000,"Japan",171861000,18.0949506038631,18.4172849848832
"7405","North Korea",1974,251914000,108874000,"Japan",360788000,18.5057018082498,19.3445983173886
"7406","North Korea",1975,179722000,64982000,"Japan",244704000,17.9896208664327,19.0069217705263
"7407","North Korea",1976,96056000,71626000,"Japan",167682000,18.0869686945073,18.3804419126927
"7408","North Korea",1977,125086000,66620000,"Japan",191706000,18.0145153907298,18.6445120587031
"7409","North Korea",1978,183346000,105789000,"Japan",289135000,18.476957102229,19.0268856360451
"7410","North Korea",1979,283830000,150929000,"Japan",434759000,18.8323200855256,19.4638860253487
"7411","North Korea",1980,374312000,179089000,"Japan",553401000,19.0033934469426,19.7406002322058
"7412","North Korea",1981,290992000,138931000,"Japan",429923000,18.7494879649686,19.4888063333489
"7413","North Korea",1982,313163000,151270000,"Japan",464433000,18.8345768775384,19.5622343797256
"7414","North Korea",1983,327070000,126149000,"Japan",453219000,18.652974305949,19.6056847732307
"7415","North Korea",1984,254718578,131545119,"Japan",386263697,18.6948604609994,19.3556698780042
"7416","North Korea",1985,247083840,162005502,"Japan",409089342,18.9031408555829,19.3252382701962
"7417","North Korea",1986,183970904,157248156,"Japan",341219060,18.873335726926,19.0302881726345
"7418","North Korea",1987,213738854,221017089,"Japan",434755943,19.2137505822844,19.1802655193923
"7419","North Korea",1988,238798471,294250599,"Japan",533049070,19.4999423397865,19.2911305366147
"7420","North Korea",1989,197923907,272472621,"Japan",470396528,19.4230486936253,19.1033932067127
"7421","North Korea",1990,175680756,271406553,"Japan",447087309,19.4191284502467,18.9841790195549
"7422","North Korea",1991,224576485,257174035,"Japan",481750520,19.3652635926656,19.2297268975479
"7423","North Korea",1992,223338446,234335453,"Japan",457673899,19.2722642065851,19.2241988739565
"7424","North Korea",1993,217463680,225181473,"Japan",442645153,19.2324171817514,19.1975424060431
"7425","North Korea",1994,169972450,288348020,"Japan",458320470,19.479678711347,18.9511469230581
"7426","North Korea",1995,253102739,308106676,"Japan",561209415,19.5459566316217,19.3493060472664
"7427","North Korea",1996,226869387,262246279,"Japan",489115666,19.3847946163888,19.2398850221815
"7428","North Korea",1997,174603798,198629847,"Japan",373233645,19.1069535852924,18.9780299537105
"7429","North Korea",1998,167332000,217979000,"Japan",385311000,19.1999092858381,18.9354904208287
"7430","North Korea",1999,146245132,181597952,"Japan",327843084,19.0173057465348,18.8007947580522
"7431","North Korea",2000,206719129,232764602,"Japan",439483731,19.2655382089957,19.1468715651208
"7432","North Korea",2001,1066562903,203271441,"Japan",1269834344,19.1300527916033,20.7877070749146
"7433","North Korea",2002,132296841,212127182,"Japan",344424023,19.1726965678535,18.7005587512491
"7434","North Korea",2003,91799239,157424750,"Japan",249223989,18.87445812428,18.335114565796
"7435","North Korea",2004,88590685,147915588,"Japan",236506273,18.8121523176648,18.299537274608
"7436","North Korea",2005,62367973,118586902,"Japan",180954875,18.5911565999806,17.948562448375
"7437","North Korea",2006,43685952,70191990,"Japan",113877942,18.0667447599217,17.5925371438541
"7438","North Korea",2007,9079651,0,"Japan",9079651,0,16.0215463137154
"7439","North Korea",2008,7631663,0,"Japan",7631663,0,15.8478163349509
"7440","North Korea",2009,2807783,0,"Japan",2807783,0,14.8479057619394
"7441","North Korea",2010,0,0,"0",0,0,0
"7442","North Korea",2011,0,0,"0",0,0,0
"7443","North Korea",2012,0,0,"0",0,0,0
"7444","North Korea",2013,0,0,"0",0,0,0
"7445","North Korea",2014,0,0,"0",0,0,0
"7446","North Korea",2015,0,0,"0",0,0,0
"7447","North Korea",2016,0,0,"0",0,0,0
"7448","North Korea",2017,0,0,"0",0,0,0
"7449","Portugal",1962,1134000,4626000,"Japan",5760000,15.3472031217735,13.9412617632698
"7450","Portugal",1963,6627000,5785000,"Japan",12412000,15.5707789186099,15.7066627710704
"7451","Portugal",1964,1477000,5940000,"Japan",7417000,15.5972196913388,14.2055235615135
"7452","Portugal",1965,2055000,5641000,"Japan",7696000,15.5455719127221,14.5357864059125
"7453","Portugal",1966,8830000,6403000,"Japan",15233000,15.6722771885009,15.9936655725801
"7454","Portugal",1967,5610000,9614000,"Japan",15224000,16.078730927436,15.5400612774989
"7455","Portugal",1968,9013000,7667000,"Japan",16680000,15.852435962541,16.0141785375385
"7456","Portugal",1969,21231000,7558000,"Japan",28789000,15.8381171628916,16.870972935726
"7457","Portugal",1970,43855000,9422000,"Japan",53277000,16.0585579382421,17.5963992953676
"7458","Portugal",1971,51658000,9130000,"Japan",60788000,16.0270762525712,17.7601556302097
"7459","Portugal",1972,67184000,14563000,"Japan",81747000,16.4939946234647,18.0229456819061
"7460","Portugal",1973,130317000,31509000,"Japan",161826000,17.265783777273,18.6854805017353
"7461","Portugal",1974,146930000,46177000,"Japan",193107000,17.6479923965929,18.8054668408521
"7462","Portugal",1975,129552000,25466000,"Japan",155018000,17.0528547871155,18.679592902908
"7463","Portugal",1976,138270000,28047000,"Japan",166317000,17.1493922323416,18.7447188533648
"7464","Portugal",1977,188383000,24324000,"Japan",212707000,17.0069740752221,19.0539876824896
"7465","Portugal",1978,168545000,32419000,"Japan",200964000,17.2942552286388,18.9427133344164
"7466","Portugal",1979,166736000,41748000,"Japan",208484000,17.5471621039221,18.9319222812143
"7467","Portugal",1980,283262000,54435000,"Japan",337697000,17.8125178872974,19.4618828223766
"7468","Portugal",1981,340158000,47713000,"Japan",387871000,17.6807144554148,19.6449207735145
"7469","Portugal",1982,327029000,49041000,"Japan",376070000,17.7081672409015,19.6055594099445
"7470","Portugal",1983,235798000,56849000,"Japan",292647000,17.8559091878566,19.2784860642674
"7471","Portugal",1984,181296140,64498363,"Japan",245794503,17.982150401599,19.01564238482
"7472","Portugal",1985,203881393,50351283,"Japan",254232676,17.7345346584328,19.1330489758632
"7473","Portugal",1986,302003896,74741223,"Japan",376745119,18.1295423452808,19.5259504759182
"7474","Portugal",1987,482620068,78821116,"Japan",561441184,18.1826914884738,19.9947402933822
"7475","Portugal",1988,590285959,94081613,"Japan",684367572,18.3596731869506,20.1961176537176
"7476","Portugal",1989,532185016,151286508,"Japan",683471524,18.8346860009555,20.0925017612825
"7477","Portugal",1990,618553073,198393820,"Japan",816946893,19.1057646031364,20.2428935553313
"7478","Portugal",1991,697643458,165273694,"Japan",862917152,18.9231134091711,20.3632187250637
"7479","Portugal",1992,846799893,170599198,"Japan",1017399091,18.9548274919557,20.5569749708669
"7480","Portugal",1993,707156152,155403305,"Japan",862559457,18.8615342633679,20.376762065103
"7481","Portugal",1994,696830180,170969958,"Japan",867800138,18.9569984148221,20.3620522948493
"7482","Portugal",1995,669983514,201902112,"Japan",871885626,19.1232935438524,20.3227636640764
"7483","Portugal",1996,685974242,173148892,"Japan",859123134,18.9696624297163,20.3463506368803
"7484","Portugal",1997,955636069,137756416,"Japan",1093392485,18.7409975820451,20.6778877175759
"7485","Portugal",1998,1051010000,147148000,"Japan",1198158000,18.8069494409782,20.7730174435438
"7486","Portugal",1999,972682901,132870323,"Japan",1105553224,18.7048841955121,20.6955686887811
"7487","Portugal",2000,884117009,129543845,"Japan",1013660854,18.6795299532301,20.6000999749649
"7488","Portugal",2001,658783360,127318496,"Japan",786101856,18.6622023475531,20.3059052979038
"7489","Portugal",2002,615238563,131062852,"Japan",746301415,18.6911875523643,20.2375206578713
"7490","Portugal",2003,687970868,151621424,"Japan",839592292,18.8368973404491,20.3492570519779
"7491","Portugal",2004,734554094,181315925,"Japan",915870019,19.0157515097054,20.4147741982455
"7492","Portugal",2005,650978197,179541281,"Japan",830519478,19.0059157171677,20.2939867080605
"7493","Portugal",2006,635850391,172001950,"Japan",807852341,18.9630163719228,20.2704738593557
"7494","Portugal",2007,696667740,156204100,"Japan",852871840,18.8666740434249,20.3618191549237
"7495","Portugal",2008,779859239,199476170,"Japan",979335409,19.1112053385381,20.474623998542
"7496","Portugal",2009,351022249,206724174,"Japan",557746423,19.1468959699181,19.6763601668856
"7497","Portugal",2010,439721888,246777691,"Japan",686499579,19.323998452879,19.9016530123071
"7498","Portugal",2011,458069427,503625948,"Japan",961695375,20.037344383827,19.9425313179265
"7499","Portugal",2012,344082704,489473880,"Japan",833556584,20.0088416579391,19.6563926050464
"7500","Portugal",2013,338306042,355184637,"Japan",693490679,19.6881483164577,19.6394614934791
"7501","Portugal",2014,369677286,330941647,"Japan",700618933,19.6174526247485,19.7281409830148
"7502","Portugal",2015,381080220,328789392,"Japan",709869612,19.6109279578521,19.7585204621093
"7503","Portugal",2016,366860764,283141328,"Japan",650002092,19.4614567231789,19.7204929443866
"7504","Portugal",2017,405004297,277685352.5,"Japan",682689649.5,19.4419992051171,19.8194082348911
"7505","Paraguay",1962,2574000,68000,"Japan",2642000,11.1272629841582,14.7609716671382
"7506","Paraguay",1963,1862000,78000,"Japan",1940000,11.2644641056717,14.4371617368191
"7507","Paraguay",1964,2471000,564000,"Japan",3035000,13.2428095304802,14.7201334849707
"7508","Paraguay",1965,3630000,474000,"Japan",4104000,13.0689626006772,15.104743206241
"7509","Paraguay",1966,3023000,272000,"Japan",3295000,12.5135573452781,14.9217602737616
"7510","Paraguay",1967,3647000,673000,"Japan",4320000,13.4195006086269,15.1094154697908
"7511","Paraguay",1968,3883000,1408000,"Japan",5291000,14.1576808157001,15.1721186087138
"7512","Paraguay",1969,5538000,1634000,"Japan",7172000,14.3065415544021,15.527143982713
"7513","Paraguay",1970,5072000,2043000,"Japan",7115000,14.5299298737998,15.4392457750992
"7514","Paraguay",1971,4798000,840000,"Japan",5638000,13.6411571708195,15.3837097223818
"7515","Paraguay",1972,3770000,1577000,"Japan",5347000,14.2710348659452,15.1425855594242
"7516","Paraguay",1973,5102000,3090000,"Japan",8192000,14.9436816488739,15.4451431776839
"7517","Paraguay",1974,7372000,4224000,"Japan",11596000,15.2562931043682,15.8131995977719
"7518","Paraguay",1975,11108000,6341000,"Japan",17449000,15.6625470426822,16.2231761274088
"7519","Paraguay",1976,11014000,11290000,"Japan",22304000,16.2394279361258,16.2146777488046
"7520","Paraguay",1977,47570000,16428000,"Japan",63998000,16.6144977540586,17.6777128684085
"7521","Paraguay",1978,45291000,34943000,"Japan",80234000,17.3692287204611,17.628618895218
"7522","Paraguay",1979,47472000,36245000,"Japan",83717000,17.4058119987171,17.6756506215127
"7523","Paraguay",1980,71270000,34102000,"Japan",105372000,17.3448665915602,18.0819860394781
"7524","Paraguay",1981,77283000,32651000,"Japan",109934000,17.3013860410891,18.1629845669908
"7525","Paraguay",1982,31544000,19424000,"Japan",50968000,16.7820199728414,17.2668939545396
"7526","Paraguay",1983,39856000,13701000,"Japan",53557000,16.4329793808352,17.5007835164841
"7527","Paraguay",1984,50875019,13803558,"Japan",64678577,16.440436942983,17.7448825751913
"7528","Paraguay",1985,34986064,7692907,"Japan",42678971,15.855809293456,17.3704603687338
"7529","Paraguay",1986,60606386,5567777,"Japan",66174163,15.532506429907,17.9199108250255
"7530","Paraguay",1987,77704700,19542440,"Japan",97247140,16.7880990688404,18.168426302569
"7531","Paraguay",1988,95959953,47682355,"Japan",143642308,17.6800719712802,18.3794415061482
"7532","Paraguay",1989,99153463,16895550,"Japan",116049013,16.6425608316107,18.4121793391986
"7533","Paraguay",1990,189168714,7338566,"Japan",196507280,15.8086540136565,19.0581498415006
"7534","Paraguay",1991,178092091,8789119,"Japan",186881210,15.989025037107,18.9978113396377
"7535","Paraguay",1992,161888973,15569319,"Japan",177458292,16.560812804896,18.9024213063839
"7536","Paraguay",1993,189556435,31563306,"Japan",221119741,17.2675058013075,19.0601973481765
"7537","Paraguay",1994,205996414,26175013,"Japan",232171427,17.0803158113779,19.1433693188353
"7538","Paraguay",1995,248062975,33760099,"Japan",281823074,17.3347901601522,19.3291932033457
"7539","Paraguay",1996,186110084,95455955,"Japan",281566039,18.3741754948751,19.041848906066
"7540","Paraguay",1997,142378186,60704775,"Japan",203082961,17.9215329185041,18.7739973570054
"7541","Paraguay",1998,96966000,67352000,"Japan",164318000,18.0254431559996,18.3898709595588
"7542","Paraguay",1999,105621824,18825578,"Japan",124447402,16.7507270350301,18.4753755745505
"7543","Paraguay",2000,92460563,18496013,"Japan",110956576,16.7330657533087,18.3422927656254
"7544","Paraguay",2001,86750773,19248120,"Japan",105998893,16.7729239515911,18.2785498874144
"7545","Paraguay",2002,50069990,20751006,"Japan",70820996,16.8481052853935,17.7289323845857
"7546","Paraguay",2003,45442803,25633748,"Japan",71076551,17.05942032253,17.6319650162141
"7547","Paraguay",2004,82957729,16305615,"Japan",99263344,16.6070200849855,18.2338417468725
"7548","Paraguay",2005,89212412,16395653,"Japan",105608065,16.6125267966839,18.3065307358521
"7549","Paraguay",2006,183127585,23201621,"Japan",206329206,16.9597327048854,19.0256936536769
"7550","Paraguay",2007,228323759,30991992,"Japan",259315751,17.2492394064978,19.2462751752924
"7551","Paraguay",2008,393380699,83851507,"Japan",477232206,18.2445580186421,19.7902884006923
"7552","Paraguay",2009,293655484,40306829,"Japan",333962313,17.5120314666555,19.4979178150521
"7553","Paraguay",2010,313434640,24447485,"Japan",337882125,17.0120379056087,19.5631014114528
"7554","Paraguay",2011,117900974,63580309,"Japan",181481283,17.967814373454,18.5853556267118
"7555","Paraguay",2012,69404334,35699668,"Japan",105104002,17.3906519469867,18.0554598730949
"7556","Paraguay",2013,62392705,79456272,"Japan",141848977,18.1907173905625,17.9489589194542
"7557","Paraguay",2014,65676090,132931694,"Japan",198607784,18.7053459753118,18.0002454902767
"7558","Paraguay",2015,69067405,91546847,"Japan",160614252,18.3323613882951,18.0505934697788
"7559","Paraguay",2016,77521656,41979340,"Japan",119500996,17.5526881504609,18.1660678875477
"7560","Paraguay",2017,196345443,57543504.5,"Japan",253888947.5,17.8680518196901,19.0953861301628
"7561","Qatar",1962,3994000,7038000,"Japan",11032000,15.7668345968637,15.2003037929579
"7562","Qatar",1963,4752000,14627000,"Japan",19379000,16.4983796938692,15.3740761400246
"7563","Qatar",1964,7513000,8776000,"Japan",16289000,15.9875312809372,15.8321454113513
"7564","Qatar",1965,7904000,14805000,"Japan",22709000,16.5104755195178,15.8828795184098
"7565","Qatar",1966,11799000,20735000,"Japan",32534000,16.8473336516626,16.2835253400821
"7566","Qatar",1967,19887000,23577000,"Japan",43464000,16.9757822185164,16.8055768098916
"7567","Qatar",1968,32522000,63792000,"Japan",96314000,17.9711383486033,17.2974273413678
"7568","Qatar",1969,39397000,83493000,"Japan",122890000,18.2402733539716,17.4892002292372
"7569","Qatar",1970,36905000,117482000,"Japan",154387000,18.5817956883241,17.4238576011863
"7570","Qatar",1971,62603000,228516000,"Japan",291119000,19.247116787729,17.9523237582447
"7571","Qatar",1972,16159000,4721000,"Japan",20880000,15.3675311995284,16.5979877279544
"7572","Qatar",1973,19788000,7405000,"Japan",27193000,15.817666005684,16.8005862513297
"7573","Qatar",1974,46613000,21309000,"Japan",67922000,16.8746400766481,17.6573900301481
"7574","Qatar",1975,122508000,27545000,"Japan",150053000,17.131331588889,18.6236868919392
"7575","Qatar",1976,228843000,30426000,"Japan",259269000,17.2308080640052,19.2485467368749
"7576","Qatar",1977,275220000,197275000,"Japan",472495000,19.1001092523714,19.4330813358014
"7577","Qatar",1978,324466000,560504000,"Japan",884970000,20.1443469369363,19.5976913120396
"7578","Qatar",1979,265034000,971413000,"Japan",1236447000,20.6942622705329,19.3953686776073
"7579","Qatar",1980,238337000,1803081000,"Japan",2041418000,21.3127627052833,19.2891961964872
"7580","Qatar",1981,176779000,2234635000,"Japan",2411414000,21.5273437407133,18.9904109228326
"7581","Qatar",1982,347360000,1783775000,"Japan",2131135000,21.3019977420741,19.6658722640943
"7582","Qatar",1983,232884000,1700801000,"Japan",1933685000,21.2543651535104,19.2660510334822
"7583","Qatar",1984,222002526,2366654231,"Japan",2588656757,21.5847430778047,19.2181993181502
"7584","Qatar",1985,195045448,1997518939,"Japan",2192564387,21.4151717169114,19.0887431560389
"7585","Qatar",1986,147541668,1027426929,"Japan",1174968597,20.7503233864774,18.8096211887652
"7586","Qatar",1987,150446129,810084322,"Japan",960530451,20.5126489014472,18.8291156312311
"7587","Qatar",1988,171830257,1016897333,"Japan",1188727590,20.7400219980812,18.9620176695861
"7588","Qatar",1989,206965484,1410747106,"Japan",1617712590,21.0673852634203,19.148062593365
"7589","Qatar",1990,153068751,1953596208,"Japan",2106664959,21.3929377202869,18.8463977313691
"7590","Qatar",1991,208844141,1956852659,"Japan",2165696800,21.3946032333078,19.1570987948869
"7591","Qatar",1992,285237668,1983600450,"Japan",2268838118,21.4081794394395,19.4688333135195
"7592","Qatar",1993,282030773,1943325467,"Japan",2225356240,21.3876665007766,19.4575267470623
"7593","Qatar",1994,238069838,1784835034,"Japan",2022904872,21.30259182998,19.2880746255663
"7594","Qatar",1995,349016379,1968974745,"Japan",2317991124,21.4007788102134,19.6706294102976
"7595","Qatar",1996,242300271,2230851144,"Japan",2473151415,21.5256490285213,19.3056883042343
"7596","Qatar",1997,366734325,2508818930,"Japan",2875553255,21.6430779335319,19.7201482337877
"7597","Qatar",1998,531377000,2795141000,"Japan",3326518000,21.7511483895082,20.0909823084564
"7598","Qatar",1999,230254811,3113375339,"Japan",3343630150,21.8589732926122,19.2546971275611
"7599","Qatar",2000,325684480,5285533070,"Japan",5611217550,22.3882393158936,19.6014396178983
"7600","Qatar",2001,331231680,5393282242,"Japan",5724513922,22.4084199868106,19.6183286280749
"7601","Qatar",2002,395793405,4713585939,"Japan",5109379344,22.2737148011579,19.7964029285381
"7602","Qatar",2003,467519372,5903252950,"Japan",6370772322,22.4987693833795,19.9629513432677
"7603","Qatar",2004,285816332,7135985072,"Japan",7421801404,22.6884161402937,19.4708599666839
"7604","Qatar",2005,1056020044,9640890036,"Japan",10696910080,22.9892792686928,20.7777730031109
"7605","Qatar",2006,1773734137,13464591430,"Japan",15238325567,23.3233292196378,21.2963528431991
"7606","Qatar",2007,2118911804,15151955624,"Japan",17270867428,23.4413954446636,21.4741684938468
"7607","Qatar",2008,2411605038,23958344354,"Japan",26369949392,23.8995825073888,21.6035583536468
"7608","Qatar",2009,1634392735,14234555647,"Japan",15868948382,23.3789383416641,21.2145371564015
"7609","Qatar",2010,1576571922,19592941392,"Japan",21169513314,23.6984352052582,21.1785186572218
"7610","Qatar",2011,1016018857,28165052867,"Japan",29181071724,24.0613477863373,20.7391577459698
"7611","Qatar",2012,1501559666,34157015872,"Japan",35658575538,24.2542338446739,21.1297701821939
"7612","Qatar",2013,1306992512,35481564079,"Japan",36788556591,24.2922790768152,20.9909945424214
"7613","Qatar",2014,1547970875,31630465643,"Japan",33178436518,24.1773865957174,21.1602107973375
"7614","Qatar",2015,1542725930,14944070166,"Japan",16486796096,23.4275804136842,21.1568167730343
"7615","Qatar",2016,1536014265,9573735236,"Japan",11109749501,22.9822892730534,21.1524567587381
"7616","Qatar",2017,0,0,"0",0,0,0
"7617","Romania",1962,6366000,3511000,"Japan",9877000,15.0714114551506,15.6664818868242
"7618","Romania",1963,8136000,7651000,"Japan",15787000,15.850346916214,15.9118092167105
"7619","Romania",1964,19157000,11857000,"Japan",31014000,16.2884289684402,16.7681787420472
"7620","Romania",1965,15238000,19037000,"Japan",34275000,16.7618950118879,16.5393028660151
"7621","Romania",1966,21941000,19772000,"Japan",41713000,16.799777353409,16.9038675906241
"7622","Romania",1967,27320000,32030000,"Japan",59350000,17.2821835215853,17.1231295926669
"7623","Romania",1968,21888000,15243000,"Japan",37131000,16.539630939244,16.9014490994044
"7624","Romania",1969,22211000,14260000,"Japan",36471000,16.4729689729504,16.9160982196206
"7625","Romania",1970,26148000,4287000,"Japan",30435000,15.2710977455801,17.0792832637148
"7626","Romania",1971,35950000,8347000,"Japan",44297000,15.9374127508329,17.3976396421313
"7627","Romania",1972,48009000,11218000,"Japan",59227000,16.2330301890504,17.6868990512962
"7628","Romania",1973,71431000,27794000,"Japan",99225000,17.1403307280287,18.0842425067532
"7629","Romania",1974,166285000,65769000,"Japan",232054000,18.0016591606614,18.9292137416585
"7630","Romania",1975,135505000,45619000,"Japan",181124000,17.6358348543698,18.7245190979722
"7631","Romania",1976,133730000,46490000,"Japan",180220000,17.6547477936668,18.711333399849
"7632","Romania",1977,258514000,40349000,"Japan",298863000,17.5130771692257,19.3704604090536
"7633","Romania",1978,231661000,63421000,"Japan",295082000,17.9653055948467,19.2607856541301
"7634","Romania",1979,181062000,114758000,"Japan",295820000,18.5583361212504,19.0143500720126
"7635","Romania",1980,202656000,65578000,"Japan",268234000,17.998750831813,19.1270205182983
"7636","Romania",1981,186653000,57953000,"Japan",244606000,17.8751428951763,19.0447618360593
"7637","Romania",1982,91356000,34108000,"Japan",125464000,17.3450425188441,18.3302745200764
"7638","Romania",1983,69092000,96676000,"Japan",165768000,18.38687573934,18.0509495077953
"7639","Romania",1984,74184257,115689881,"Japan",189874138,18.5664237293936,18.1220625158151
"7640","Romania",1985,89566154,58332771,"Japan",147898925,17.8816746031732,18.3104880610456
"7641","Romania",1986,111475682,86125528,"Japan",197601210,18.2713164179034,18.5293170264228
"7642","Romania",1987,76436071,119896587,"Japan",196332658,18.6021401542048,18.1519652762246
"7643","Romania",1988,52214406,126174775,"Japan",178389181,18.6531786069514,17.7708689917897
"7644","Romania",1989,49512417,181202938,"Japan",230715355,19.0151281655697,17.7177340445665
"7645","Romania",1990,80449513,88207848,"Japan",168657361,18.2952064966104,18.203140377935
"7646","Romania",1991,56648848,84885290,"Japan",141534138,18.2568113736079,17.8523822098388
"7647","Romania",1992,76923876,70504103,"Japan",147427979,18.0711814646706,18.1583268674309
"7648","Romania",1993,54063086,63262260,"Japan",117325346,17.9627995007806,17.805662181904
"7649","Romania",1994,52793814,55155376,"Japan",107949190,17.825664778514,17.7819045827219
"7650","Romania",1995,71141050,51764877,"Japan",122905927,17.7622224270567,18.0801750840046
"7651","Romania",1996,96422932,45559093,"Japan",141982025,17.6345207885312,18.3842546151083
"7652","Romania",1997,79788007,43849822,"Japan",123637829,17.5962812174812,18.1948837629051
"7653","Romania",1998,72031000,46383000,"Japan",118414000,17.6524435707528,18.0926071398734
"7654","Romania",1999,102529913,41284619,"Japan",143814532,17.5360005672577,18.4456651481138
"7655","Romania",2000,152659682,43788111,"Japan",196447793,17.5948729001445,18.843721701272
"7656","Romania",2001,138127092,41271854,"Japan",179398946,17.5356913243931,18.743684775823
"7657","Romania",2002,194640361,46000959,"Japan",240641320,17.6441728020621,19.0866641111439
"7658","Romania",2003,266324351,56913554,"Japan",323237905,17.8570440781111,19.4002254885863
"7659","Romania",2004,393884805,94595077,"Japan",488479882,18.3651159924988,19.7915690514164
"7660","Romania",2005,531615205,140362445,"Japan",671977650,18.7597385280203,20.0914304867269
"7661","Romania",2006,596954892,165855417,"Japan",762810309,18.926626984868,20.2073521107133
"7662","Romania",2007,381551039,200992422,"Japan",582543461,19.1187777638201,19.7597551847993
"7663","Romania",2008,397699523,199474989,"Japan",597174512,19.1111994180139,19.8012073107807
"7664","Romania",2009,258389427,196837044,"Japan",455226471,19.0978867565764,19.3699784118529
"7665","Romania",2010,246054374,264068187,"Japan",510122561,19.3917179118519,19.3210631019929
"7666","Romania",2011,388037707,432981348,"Japan",821019055,19.8862052088265,19.7766130758553
"7667","Romania",2012,338748876,427198677,"Japan",765947553,19.8727597486954,19.6407696120715
"7668","Romania",2013,307715366,503590701,"Japan",811306067,20.0372743949124,19.5446857772969
"7669","Romania",2014,330510366,489318137,"Japan",819828503,20.0085234228113,19.6161485813632
"7670","Romania",2015,321682770,427005105,"Japan",748687875,19.8723065266249,19.5890764315582
"7671","Romania",2016,382037653,470117064,"Japan",852154717,19.9684922939954,19.7610297297762
"7672","Romania",2017,393016188,543413084.5,"Japan",936429272.5,20.113380333614,19.7893613598249
"7673","Russia",1962,0,0,"0",0,0,0
"7674","Russia",1963,0,0,"0",0,0,0
"7675","Russia",1964,0,0,"0",0,0,0
"7676","Russia",1965,0,0,"0",0,0,0
"7677","Russia",1966,0,0,"0",0,0,0
"7678","Russia",1967,0,0,"0",0,0,0
"7679","Russia",1968,0,0,"0",0,0,0
"7680","Russia",1969,0,0,"0",0,0,0
"7681","Russia",1970,0,0,"0",0,0,0
"7682","Russia",1971,0,0,"0",0,0,0
"7683","Russia",1972,0,0,"0",0,0,0
"7684","Russia",1973,0,0,"0",0,0,0
"7685","Russia",1974,0,0,"0",0,0,0
"7686","Russia",1975,0,0,"0",0,0,0
"7687","Russia",1976,0,0,"0",0,0,0
"7688","Russia",1977,0,0,"0",0,0,0
"7689","Russia",1978,0,0,"0",0,0,0
"7690","Russia",1979,0,0,"0",0,0,0
"7691","Russia",1980,0,0,"0",0,0,0
"7692","Russia",1981,0,0,"0",0,0,0
"7693","Russia",1982,0,0,"0",0,0,0
"7694","Russia",1983,0,0,"0",0,0,0
"7695","Russia",1984,0,0,"0",0,0,0
"7696","Russia",1985,0,0,"0",0,0,0
"7697","Russia",1986,0,0,"0",0,0,0
"7698","Russia",1987,0,0,"0",0,0,0
"7699","Russia",1988,0,0,"0",0,0,0
"7700","Russia",1989,0,0,"0",0,0,0
"7701","Russia",1990,0,0,"0",0,0,0
"7702","Russia",1991,0,0,"0",0,0,0
"7703","Russia",1992,1073795012,2166585259,"Japan",3240380271,21.4964181517048,20.7944649507566
"7704","Russia",1993,1496627686,2470104675,"Japan",3966732361,21.6275263652309,21.1264802047044
"7705","Russia",1994,1174386649,3144908769,"Japan",4319295418,21.869050718411,20.8840118474016
"7706","Russia",1995,1153515301,4237229090,"Japan",5390744391,22.1671753760458,20.8660799003362
"7707","Russia",1996,896979775,3603809004,"Japan",4500788779,22.0052571797277,20.6145438723887
"7708","Russia",1997,753575026,2639397812,"Japan",3392972838,21.6938166265704,20.4403391410807
"7709","Russia",1998,967558000,2880099000,"Japan",3847657000,21.7810905055035,20.6902859293918
"7710","Russia",1999,412289342,3422828961,"Japan",3835118303,21.9537332276737,19.8372359472339
"7711","Russia",2000,522743157,4140506649,"Japan",4663249806,22.1440839962814,20.0746008058
"7712","Russia",2001,793675783,3483250994,"Japan",4276926777,21.9712318883236,20.4921856020673
"7713","Russia",2002,880491576,2963030840,"Japan",3843522416,21.8094785138536,20.5959909185635
"7714","Russia",2003,1716566838,3836234198,"Japan",5552801036,22.067757044763,21.2635921086417
"7715","Russia",2004,3517937671,5162011751,"Japan",8679949422,22.3645922146835,21.981140765936
"7716","Russia",2005,5278779991,5578835065,"Japan",10857615056,22.4422458218309,22.386960845655
"7717","Russia",2006,7072023767,5989109605,"Japan",13061133372,22.5132085911132,22.6794125229944
"7718","Russia",2007,11285757054,9499919810,"Japan",20785676864,22.9745491944647,23.1468073299459
"7719","Russia",2008,16446885707,12223321718,"Japan",28670207425,23.226611580102,23.5234019775113
"7720","Russia",2009,6233056081,8006523090,"Japan",14239579171,22.8035224326295,22.5531325921657
"7721","Russia",2010,8913566774,14580158681,"Japan",23493725455,23.4029274469382,22.9108403096615
"7722","Russia",2011,11602141076,17134836932,"Japan",28736978008,23.5643794755659,23.174455493544
"7723","Russia",2012,12479290374,19864376756,"Japan",32343667130,23.7121938517465,23.2473363372133
"7724","Russia",2013,10847891708,22048084778,"Japan",32895976486,23.8164915769263,23.107236585425
"7725","Russia",2014,9019334326,23015488430,"Japan",32034822756,23.8594332362368,22.9226363685193
"7726","Russia",2015,5005015763,14739081830,"Japan",19744097593,23.4137684307227,22.3337063991592
"7727","Russia",2016,5029253770,10580803785,"Japan",15610057555,23.082307232608,22.3385374541874
"7728","Russia",2017,6925964026,13066680911.5,"Japan",19992644937.5,23.2933313852399,22.6585430888618
"7729","Rwanda",1962,0,0,"0",0,0,0
"7730","Rwanda",1963,0,0,"0",0,0,0
"7731","Rwanda",1964,725000,0,"Japan",725000,0,13.4939269338368
"7732","Rwanda",1965,598000,88000,"Japan",686000,11.3850920934603,13.3013460329328
"7733","Rwanda",1966,1760000,170000,"Japan",1930000,12.0435537160324,14.3808243670143
"7734","Rwanda",1967,1380000,164000,"Japan",1544000,12.0076217068063,14.1375940571334
"7735","Rwanda",1968,2242000,189000,"Japan",2431000,12.1495022940418,14.6228788826142
"7736","Rwanda",1969,1983000,208000,"Japan",2191000,12.2452933586835,14.5001214075019
"7737","Rwanda",1970,3338000,398000,"Japan",3736000,12.8942072842666,15.0208823832039
"7738","Rwanda",1971,2800000,240000,"Japan",3040000,12.3883942023241,14.8451299751454
"7739","Rwanda",1972,1967000,56000,"Japan",2023000,10.9331069697173,14.4920200973712
"7740","Rwanda",1973,2007000,22000,"Japan",2029000,9.99879773234045,14.5121516277785
"7741","Rwanda",1974,4018000,161000,"Japan",4179000,11.9891596439666,15.206294824357
"7742","Rwanda",1975,4579000,281000,"Japan",4860000,12.5461099483159,15.3369911916392
"7743","Rwanda",1976,11400000,349000,"Japan",11749000,12.7628272011846,16.2491239133647
"7744","Rwanda",1977,13221000,3948000,"Japan",17169000,15.1887196795355,16.3973170324922
"7745","Rwanda",1978,17431000,7120000,"Japan",24551000,15.7784182833882,16.673760788197
"7746","Rwanda",1979,17705000,5699000,"Japan",23404000,15.5558012788171,16.6893576435281
"7747","Rwanda",1980,28828000,2041000,"Japan",30869000,14.528950441792,17.1768576950265
"7748","Rwanda",1981,27627000,695000,"Japan",28322000,13.4516671245469,17.1343041133716
"7749","Rwanda",1982,22617000,2495000,"Japan",25112000,14.7297992871678,16.9342123938619
"7750","Rwanda",1983,21856000,1608000,"Japan",23464000,14.290501728721,16.8999860413527
"7751","Rwanda",1984,18466253,1697612,"Japan",20163865,14.3447331156199,16.7314554620765
"7752","Rwanda",1985,22936381,1584475,"Japan",24520856,14.2757636801407,16.9482348978479
"7753","Rwanda",1986,24974102,1616944,"Japan",26591046,14.2960485059249,17.0333499258965
"7754","Rwanda",1987,37699309,725019,"Japan",38424328,13.49395314039,17.4451523233378
"7755","Rwanda",1988,36768519,544066,"Japan",37312585,13.2068258420084,17.4201525750662
"7756","Rwanda",1989,32984683,1693894,"Japan",34678577,14.3425405784465,17.3115538601639
"7757","Rwanda",1990,21788810,1949315,"Japan",23738125,14.4829885867747,16.8969070932221
"7758","Rwanda",1991,9246191,623691,"Japan",9869882,13.3434103323957,16.0397222408986
"7759","Rwanda",1992,15706125,88349,"Japan",15794474,11.3890501590647,16.5695613216272
"7760","Rwanda",1993,23126708,30189,"Japan",23156897,10.3152328986014,16.9564986980947
"7761","Rwanda",1994,6799676,149686,"Japan",6949362,11.9162950456603,15.7323855219524
"7762","Rwanda",1995,11990259,84934,"Japan",12075193,11.3496297632748,16.2996051281048
"7763","Rwanda",1996,9609290,131318,"Japan",9740608,11.785377141527,16.0782408968435
"7764","Rwanda",1997,11687917,601991,"Japan",12289908,13.3079977740131,16.274066131087
"7765","Rwanda",1998,10719000,589000,"Japan",11308000,13.2861814626337,16.1875284256737
"7766","Rwanda",1999,6032327,685293,"Japan",6717620,13.4376017630172,15.6126433980759
"7767","Rwanda",2000,8701144,394366,"Japan",9095510,12.885034691098,15.9789650692331
"7768","Rwanda",2001,5997138,2040998,"Japan",8038136,14.5289494618797,15.6067929133916
"7769","Rwanda",2002,5457119,10743,"Japan",5467862,9.28200965866654,15.5124315527842
"7770","Rwanda",2003,7368858,310382,"Japan",7679240,12.645559075919,15.812773299649
"7771","Rwanda",2004,3537773,4470,"Japan",3542243,8.40514368760761,15.0790079911008
"7772","Rwanda",2005,13172491,58386,"Japan",13230877,10.97483141405,16.3936411978237
"7773","Rwanda",2006,6626739,75860,"Japan",6702599,11.2366448152429,15.706623385958
"7774","Rwanda",2007,13853681,582915,"Japan",14436596,13.2757966571045,16.4440615314587
"7775","Rwanda",2008,24839318,1720521,"Japan",26559839,14.3581377098993,17.0279383589361
"7776","Rwanda",2009,10947201,476818,"Japan",11424019,13.0748901456986,16.208594365113
"7777","Rwanda",2010,6120100,489821,"Japan",6609921,13.1017952972238,15.6270889942243
"7778","Rwanda",2011,8588069,1369288,"Japan",9957357,14.1298014546801,15.9658844724152
"7779","Rwanda",2012,20312802,2456821,"Japan",22769623,14.7143787957765,16.826761885636
"7780","Rwanda",2013,20380512,2354971,"Japan",22735483,14.6720389711318,16.8300897081126
"7781","Rwanda",2014,14863093,1784659,"Japan",16647752,14.3947379185315,16.5143917182601
"7782","Rwanda",2015,11131897,3807367,"Japan",14939264,15.1524484320842,16.22532514898
"7783","Rwanda",2016,6246770,7917882,"Japan",14164652,15.8846343037839,15.6475750881254
"7784","Rwanda",2017,0,0,"0",0,0,0
"7785","Western Sahara",1962,0,0,"0",0,0,0
"7786","Western Sahara",1963,0,0,"0",0,0,0
"7787","Western Sahara",1964,0,0,"0",0,0,0
"7788","Western Sahara",1965,0,0,"0",0,0,0
"7789","Western Sahara",1966,0,0,"0",0,0,0
"7790","Western Sahara",1967,0,0,"0",0,0,0
"7791","Western Sahara",1968,0,0,"0",0,0,0
"7792","Western Sahara",1969,0,0,"0",0,0,0
"7793","Western Sahara",1970,0,0,"0",0,0,0
"7794","Western Sahara",1971,0,0,"0",0,0,0
"7795","Western Sahara",1972,0,0,"0",0,0,0
"7796","Western Sahara",1973,0,0,"0",0,0,0
"7797","Western Sahara",1974,0,0,"0",0,0,0
"7798","Western Sahara",1975,0,0,"0",0,0,0
"7799","Western Sahara",1976,0,0,"0",0,0,0
"7800","Western Sahara",1977,0,0,"0",0,0,0
"7801","Western Sahara",1978,0,0,"0",0,0,0
"7802","Western Sahara",1979,0,0,"0",0,0,0
"7803","Western Sahara",1980,0,0,"0",0,0,0
"7804","Western Sahara",1981,0,0,"0",0,0,0
"7805","Western Sahara",1982,0,0,"0",0,0,0
"7806","Western Sahara",1983,0,0,"0",0,0,0
"7807","Western Sahara",1984,979,0,"Japan",979,0,6.88653164253051
"7808","Western Sahara",1985,21175,0,"Japan",21175,0,9.96057651952026
"7809","Western Sahara",1986,0,593433,"Japan",593433,13.2936795970216,0
"7810","Western Sahara",1987,16226,403059,"Japan",419285,12.9068382321982,9.69437017295501
"7811","Western Sahara",1988,0,148065,"Japan",148065,11.9054066455201,0
"7812","Western Sahara",1989,1578,0,"Japan",1578,0,7.36391350140582
"7813","Western Sahara",1990,5287,256111,"Japan",261398,12.4533662232371,8.57300625623545
"7814","Western Sahara",1991,5853126,0,"Japan",5853126,0,15.5824864354635
"7815","Western Sahara",1992,374101,0,"Japan",374101,0,12.8322810934147
"7816","Western Sahara",1993,1350855,0,"Japan",1350855,0,14.116248283277
"7817","Western Sahara",1994,239161,37120,"Japan",276281,10.5219111869001,12.3848922442873
"7818","Western Sahara",1995,4703,119227,"Japan",123930,11.688784518031,8.45595588194505
"7819","Western Sahara",1996,10012,834693,"Japan",844705,13.6348192715571,9.21153965255166
"7820","Western Sahara",1997,506619,0,"Japan",506619,0,13.1355145207813
"7821","Western Sahara",1998,0,0,"0",0,0,0
"7822","Western Sahara",1999,597024,0,"Japan",597024,0,13.2997125925717
"7823","Western Sahara",2000,100561,13540,"Japan",114101,9.51340354646627,11.5185197875265
"7824","Western Sahara",2001,843287,3211878,"Japan",4055165,14.9823663707621,13.6450626298148
"7825","Western Sahara",2002,0,6363194,"Japan",6363194,15.6660410105133,0
"7826","Western Sahara",2003,0,715760,"Japan",715760,13.4811001942215,0
"7827","Western Sahara",2004,276479,458564,"Japan",735043,13.0358551465427,12.5298901476931
"7828","Western Sahara",2005,0,146795,"Japan",146795,11.896792334637,0
"7829","Western Sahara",2006,529689,1166324,"Japan",1696013,13.9693674803633,13.1800453208454
"7830","Western Sahara",2007,7099,0,"Japan",7099,0,8.86770920803939
"7831","Western Sahara",2008,1483570,6271331,"Japan",7754901,15.6514991707825,14.2099619033093
"7832","Western Sahara",2009,141099,234724,"Japan",375823,12.3661656348131,11.8572170506436
"7833","Western Sahara",2010,358506,0,"Japan",358506,0,12.7897006752834
"7834","Western Sahara",2011,95888,78818,"Japan",174706,11.2748966761566,11.470936122698
"7835","Western Sahara",2012,0,467737,"Japan",467737,13.0556614511258,0
"7836","Western Sahara",2013,81924,585759,"Japan",667683,13.2806637211688,11.3135472672063
"7837","Western Sahara",2014,53485,951308,"Japan",1004793,13.765593158704,10.8871565197402
"7838","Western Sahara",2015,348848,373392,"Japan",722240,12.8303840851147,12.7623915762278
"7839","Western Sahara",2016,84623,152685,"Japan",237308,11.9361322545546,11.3459613762573
"7840","Western Sahara",2017,0,0,"0",0,0,0
"7841","Saudi Arabia",1962,22543000,164656000,"Japan",187199000,18.919369007058,16.9309351544363
"7842","Saudi Arabia",1963,26781000,178889000,"Japan",205670000,19.0022760597244,17.1032032388296
"7843","Saudi Arabia",1964,36595000,198228000,"Japan",234823000,19.1049284413253,17.4154221770175
"7844","Saudi Arabia",1965,48486000,231378000,"Japan",279864000,19.2595632947382,17.6967856544436
"7845","Saudi Arabia",1966,52258000,246985000,"Japan",299243000,19.3248381640032,17.7717035471369
"7846","Saudi Arabia",1967,51244000,315632000,"Japan",366876000,19.5700875359658,17.7521090959585
"7847","Saudi Arabia",1968,51968000,389166000,"Japan",441134000,19.7795165457756,17.7661387025035
"7848","Saudi Arabia",1969,77230000,414840000,"Japan",492070000,19.8434034616858,18.1622985405454
"7849","Saudi Arabia",1970,83799000,435127000,"Japan",518926000,19.8911485004657,18.2439316322069
"7850","Saudi Arabia",1971,133159000,593472000,"Japan",726631000,20.201500593142,18.7070544608802
"7851","Saudi Arabia",1972,237781000,901206000,"Japan",1138987000,20.6192444242898,19.286860639954
"7852","Saudi Arabia",1973,387693000,1388356000,"Japan",1776049000,21.0513861502944,19.7757243472808
"7853","Saudi Arabia",1974,455361000,5240199000,"Japan",5695560000,22.3796253116575,19.936601068928
"7854","Saudi Arabia",1975,643858000,6139280000,"Japan",6783138000,22.5379733083859,20.2829887628612
"7855","Saudi Arabia",1976,1057262000,7823960000,"Japan",8881222000,22.7804566571914,20.7789483844535
"7856","Saudi Arabia",1977,1698414000,8505479000,"Japan",10203893000,22.8639763810202,21.2529607113716
"7857","Saudi Arabia",1978,3254347000,8459652000,"Japan",11713999000,22.8585738749667,21.9032574780419
"7858","Saudi Arabia",1979,3875753000,12133880000,"Japan",16009633000,23.2192673768511,22.0780058034542
"7859","Saudi Arabia",1980,5412499000,19538142000,"Japan",24950641000,23.695634392039,22.4119767455175
"7860","Saudi Arabia",1981,6451313000,21482582000,"Japan",27933895000,23.7905083042048,22.5875495129288
"7861","Saudi Arabia",1982,7778430000,20527583000,"Japan",28306013000,23.7450353308955,22.7746203552866
"7862","Saudi Arabia",1983,6686574000,15529981000,"Japan",22216555000,23.4660382506678,22.6233674722913
"7863","Saudi Arabia",1984,6888597550,13443172127,"Japan",20331769677,23.3217371655469,22.653133352632
"7864","Saudi Arabia",1985,5111038318,9341562701,"Japan",14452601019,22.9577393879328,22.3546684138674
"7865","Saudi Arabia",1986,3170862140,4753056380,"Japan",7923918520,22.2820536964898,21.8772693563131
"7866","Saudi Arabia",1987,3743276288,6705045635,"Japan",10448321923,22.6261261597717,22.0432270777318
"7867","Saudi Arabia",1988,4114530673,5696363554,"Japan",9810894227,22.4630938352131,22.137790611837
"7868","Saudi Arabia",1989,3591952775,6424372389,"Japan",10016325164,22.5833647803105,22.0019618400282
"7869","Saudi Arabia",1990,3748063621,9396713868,"Japan",13144777489,22.9636258765914,22.0445051758317
"7870","Saudi Arabia",1991,3604543086,9134948993,"Japan",12739492079,22.9353734430717,22.0054608551291
"7871","Saudi Arabia",1992,4260076352,9265457898,"Japan",13525534250,22.9495591178046,22.1725529200718
"7872","Saudi Arabia",1993,3218935386,8145063114,"Japan",11363998500,22.8206778277733,21.8923165163682
"7873","Saudi Arabia",1994,2523429553,7572302139,"Japan",10095731692,22.7477629716369,21.6488847469689
"7874","Saudi Arabia",1995,2252823020,8766117055,"Japan",11018940075,22.8941597921507,21.5354499422707
"7875","Saudi Arabia",1996,1768664152,9612340179,"Japan",11381004331,22.986313545268,21.2934903822062
"7876","Saudi Arabia",1997,2373122081,6432678788,"Japan",8805800869,22.5846568962151,21.5874722589259
"7877","Saudi Arabia",1998,2574951000,7128110000,"Japan",9703061000,22.6873119590946,21.6690963417548
"7878","Saudi Arabia",1999,2334044548,7498585849,"Japan",9832630397,22.7379802862436,21.5708684571753
"7879","Saudi Arabia",2000,2871313342,12828553205,"Japan",15699866547,23.2749392426526,21.7780353724992
"7880","Saudi Arabia",2001,3278068966,11048796440,"Japan",14326865406,23.125587339521,21.9105203560949
"7881","Saudi Arabia",2002,3282652113,10486335664,"Japan",13768987777,23.0733388812653,21.9119175036616
"7882","Saudi Arabia",2003,3570530174,13241570108,"Japan",16812100282,23.3066269686418,21.995979929835
"7883","Saudi Arabia",2004,3939222297,16747900738,"Japan",20687123035,23.5415387582885,22.0942491542247
"7884","Saudi Arabia",2005,4860055519,26026914352,"Japan",30886969871,23.9823970069362,22.3043156984561
"7885","Saudi Arabia",2006,5077281896,33958084384,"Japan",39035366280,24.2483927887891,22.3480418954987
"7886","Saudi Arabia",2007,7062538108,31682340229,"Japan",38744878337,24.1790252720292,22.6780703292274
"7887","Saudi Arabia",2008,7818475141,46409324288,"Japan",54227799429,24.5607662304727,22.7797553777326
"7888","Saudi Arabia",2009,8512741845,26232290910,"Japan",34745032755,23.9902569663175,22.8648299185912
"7889","Saudi Arabia",2010,7159899596,32425343278,"Japan",39585242874,24.202206153924,22.6917617949156
"7890","Saudi Arabia",2011,6422239638,49378861538,"Japan",55801101176,24.6227882654741,22.5830327470842
"7891","Saudi Arabia",2012,8154359053,53070943710,"Japan",61225302763,24.694895415991,22.8218184743451
"7892","Saudi Arabia",2013,6809227987,48631412631,"Japan",55440640618,24.6075355094905,22.6415445860707
"7893","Saudi Arabia",2014,7552277030,45738608397,"Japan",53290885427,24.5462086008762,22.7451149481147
"7894","Saudi Arabia",2015,6705134719,1270764650,"Japan",7975899369,20.9628846428497,22.6261394457974
"7895","Saudi Arabia",2016,4964053288,19103055592,"Japan",24067108880,23.6731141378425,22.3254884391224
"7896","Saudi Arabia",2017,0,0,"0",0,0,0
"7897","Sudan",1962,15170000,9077000,"Japan",24247000,16.0212542995088,16.5348303513247
"7898","Sudan",1963,16803000,14334000,"Japan",31137000,16.478144895536,16.6370679998601
"7899","Sudan",1964,19204000,16021000,"Japan",35225000,16.5894109196289,16.770629148633
"7900","Sudan",1965,19578000,8876000,"Japan",28454000,15.9988615630346,16.7899170448035
"7901","Sudan",1966,17786000,13138000,"Japan",30924000,16.3910193524346,16.6939221889417
"7902","Sudan",1967,13156000,17256000,"Japan",30412000,16.6636704670511,16.3923884862911
"7903","Sudan",1968,23297000,23199000,"Japan",46496000,16.9596197322593,16.9638351548814
"7904","Sudan",1969,20536000,26304000,"Japan",46840000,17.085231576838,16.8376900015331
"7905","Sudan",1970,16161000,30072000,"Japan",46233000,17.2191050642262,16.5981114903308
"7906","Sudan",1971,13602000,27221000,"Japan",40823000,17.1194992922057,16.4257273987177
"7907","Sudan",1972,13107000,28972000,"Japan",42079000,17.1818404042974,16.3886569966017
"7908","Sudan",1973,24680000,51862000,"Japan",76542000,17.7640969026995,17.0215037570015
"7909","Sudan",1974,36261000,27153000,"Japan",63414000,17.1169980954774,17.4062533415097
"7910","Sudan",1975,87388000,15820000,"Japan",103208000,16.5767855203038,18.2858685314281
"7911","Sudan",1976,63081000,48965000,"Japan",112046000,17.706616315137,17.9599301728187
"7912","Sudan",1977,118459000,57274000,"Japan",175733000,17.8633573265268,18.5900774671094
"7913","Sudan",1978,83553000,58055000,"Japan",141608000,17.8769013950432,18.2409917190038
"7914","Sudan",1979,50062000,52167000,"Japan",102229000,17.7699606690323,17.7287727952274
"7915","Sudan",1980,55427000,56270000,"Japan",111697000,17.8456720914095,17.8305773976149
"7916","Sudan",1981,92078000,57366000,"Japan",149444000,17.8649623512956,18.3381466018987
"7917","Sudan",1982,77140000,45700000,"Japan",122840000,17.6376088558644,18.1611325107444
"7918","Sudan",1983,55070000,46449000,"Japan",101519000,17.6538654944671,17.8241156612387
"7919","Sudan",1984,53039473,44040912,"Japan",97080385,17.6006295780512,17.7865469678951
"7920","Sudan",1985,39868779,43572005,"Japan",83440784,17.5899254149371,17.5011040943589
"7921","Sudan",1986,54657282,38247589,"Japan",92904871,17.4595910835704,17.8165930116515
"7922","Sudan",1987,77876029,38439053,"Japan",116315082,17.4645845059669,18.1706287484677
"7923","Sudan",1988,71866201,53552303,"Japan",125418504,17.7961693604692,18.0903166287182
"7924","Sudan",1989,96762617,75284801,"Japan",172047418,18.136788826447,18.3877712896405
"7925","Sudan",1990,45933939,30034041,"Japan",75967980,17.217841996341,17.6427148135653
"7926","Sudan",1991,52585889,27299201,"Japan",79885090,17.1223679923276,17.7779583717551
"7927","Sudan",1992,61706161,25934420,"Japan",87640581,17.0710816019163,17.9378943380234
"7928","Sudan",1993,45561401,30361252,"Japan",75922653,17.2286777481131,17.6345714467289
"7929","Sudan",1994,25578790,35137974,"Japan",60716764,17.3747929839672,17.057274050416
"7930","Sudan",1995,30596585,33646736,"Japan",64243321,17.3314266108362,17.2363989593875
"7931","Sudan",1996,27937996,26260828,"Japan",54198824,17.0835889571872,17.1454981840955
"7932","Sudan",1997,46733324,20220066,"Japan",66953390,16.8221860356462,17.6599680441819
"7933","Sudan",1998,44956000,22213000,"Japan",67169000,16.9161882610398,17.6211947916203
"7934","Sudan",1999,35107919,69031292,"Japan",104139211,18.0500704670046,17.373937275525
"7935","Sudan",2000,30617593,276550235,"Japan",307167828,19.4379030441605,17.2370853363515
"7936","Sudan",2001,34408142,263498439,"Japan",297906581,19.3895580018295,17.3538037803844
"7937","Sudan",2002,49359063,257407855,"Japan",306766918,19.3661723693662,17.7146319543991
"7938","Sudan",2003,61626409,467835053,"Japan",529461462,19.9636263409018,17.9366010541631
"7939","Sudan",2004,123158617,1174147375,"Japan",1297305992,20.8838080828418,18.6289836516623
"7940","Sudan",2005,502029924,1670323758,"Japan",2172353682,21.2362833116512,20.0341702854412
"7941","Sudan",2006,650600157,2752856620,"Japan",3403456777,21.7359049803848,20.2934058133192
"7942","Sudan",2007,669191724,2414033943,"Japan",3083225667,21.6045650204177,20.3215811599951
"7943","Sudan",2008,123050170,3882227974,"Japan",4005278144,22.0796750458834,18.6281027163526
"7944","Sudan",2009,746080278,971016691,"Japan",1717096969,20.6938542156032,20.4303437636384
"7945","Sudan",2010,92453775,1100049249,"Japan",1192503024,20.8186207875667,18.3422193478464
"7946","Sudan",2011,56101140,2264354265,"Japan",2320455405,21.5405554625195,17.8426666911421
"7947","Sudan",2012,49640170,434216356,"Japan",483856526,19.8890534839758,17.7203109429524
"7948","Sudan",2013,47175612,451998882,"Japan",499174494,19.9291902643421,17.6693876221077
"7949","Sudan",2014,49727839,125158528,"Japan",174886367,18.6450917157498,17.7220754750916
"7950","Sudan",2015,59693293,163261212,"Japan",222954505,18.9108620037012,17.904730226993
"7951","Sudan",2016,49524681,25549395,"Japan",75074076,17.056124195273,17.7179817093368
"7952","Sudan",2017,288970400.5,5895859,"Japan",294866259.5,15.589760798047,19.4818348204162
"7953","South Sudan",1962,0,0,"0",0,0,0
"7954","South Sudan",1963,0,0,"0",0,0,0
"7955","South Sudan",1964,0,0,"0",0,0,0
"7956","South Sudan",1965,0,0,"0",0,0,0
"7957","South Sudan",1966,0,0,"0",0,0,0
"7958","South Sudan",1967,0,0,"0",0,0,0
"7959","South Sudan",1968,0,0,"0",0,0,0
"7960","South Sudan",1969,0,0,"0",0,0,0
"7961","South Sudan",1970,0,0,"0",0,0,0
"7962","South Sudan",1971,0,0,"0",0,0,0
"7963","South Sudan",1972,0,0,"0",0,0,0
"7964","South Sudan",1973,0,0,"0",0,0,0
"7965","South Sudan",1974,0,0,"0",0,0,0
"7966","South Sudan",1975,0,0,"0",0,0,0
"7967","South Sudan",1976,0,0,"0",0,0,0
"7968","South Sudan",1977,0,0,"0",0,0,0
"7969","South Sudan",1978,0,0,"0",0,0,0
"7970","South Sudan",1979,0,0,"0",0,0,0
"7971","South Sudan",1980,0,0,"0",0,0,0
"7972","South Sudan",1981,0,0,"0",0,0,0
"7973","South Sudan",1982,0,0,"0",0,0,0
"7974","South Sudan",1983,0,0,"0",0,0,0
"7975","South Sudan",1984,0,0,"0",0,0,0
"7976","South Sudan",1985,0,0,"0",0,0,0
"7977","South Sudan",1986,0,0,"0",0,0,0
"7978","South Sudan",1987,0,0,"0",0,0,0
"7979","South Sudan",1988,0,0,"0",0,0,0
"7980","South Sudan",1989,0,0,"0",0,0,0
"7981","South Sudan",1990,0,0,"0",0,0,0
"7982","South Sudan",1991,0,0,"0",0,0,0
"7983","South Sudan",1992,0,0,"0",0,0,0
"7984","South Sudan",1993,0,0,"0",0,0,0
"7985","South Sudan",1994,0,0,"0",0,0,0
"7986","South Sudan",1995,0,0,"0",0,0,0
"7987","South Sudan",1996,0,0,"0",0,0,0
"7988","South Sudan",1997,0,0,"0",0,0,0
"7989","South Sudan",1998,0,0,"0",0,0,0
"7990","South Sudan",1999,0,0,"0",0,0,0
"7991","South Sudan",2000,0,0,"0",0,0,0
"7992","South Sudan",2001,0,0,"0",0,0,0
"7993","South Sudan",2002,0,0,"0",0,0,0
"7994","South Sudan",2003,0,0,"0",0,0,0
"7995","South Sudan",2004,0,0,"0",0,0,0
"7996","South Sudan",2005,0,0,"0",0,0,0
"7997","South Sudan",2006,0,0,"0",0,0,0
"7998","South Sudan",2007,0,0,"0",0,0,0
"7999","South Sudan",2008,0,0,"0",0,0,0
"8000","South Sudan",2009,0,0,"0",0,0,0
"8001","South Sudan",2010,0,0,"0",0,0,0
"8002","South Sudan",2011,0,0,"0",0,0,0
"8003","South Sudan",2012,11639083,144005654,"Japan",155644737,18.7853631206584,16.2698792170955
"8004","South Sudan",2013,15215133,0,"Japan",15215133,0,16.5378010826486
"8005","South Sudan",2014,11383645,0,"Japan",11383645,0,16.2476882341475
"8006","South Sudan",2015,13680580,0,"Japan",13680580,0,16.4314878669207
"8007","South Sudan",2016,9172979,414603,"Japan",9587582,12.9350767148477,16.0317726551618
"8008","South Sudan",2017,0,0,"0",0,0,0
"8009","Senegal",1962,436000,1629000,"Japan",2065000,14.3034768875842,12.9853975223312
"8010","Senegal",1963,318000,1819000,"Japan",2137000,14.4137974575003,12.6698066617623
"8011","Senegal",1964,312000,3569000,"Japan",3881000,15.0877960024723,12.6507584667916
"8012","Senegal",1965,269000,4240000,"Japan",4509000,15.2600738272081,12.502466658584
"8013","Senegal",1966,688000,4974000,"Japan",5662000,15.4197349033455,13.4415441169155
"8014","Senegal",1967,480000,4518000,"Japan",4998000,15.3235799760101,13.0815413828841
"8015","Senegal",1968,443000,5144000,"Japan",5587000,15.4533415448996,13.0013250490273
"8016","Senegal",1969,773000,4273000,"Japan",5046000,15.2678267146262,13.5580343275696
"8017","Senegal",1970,824000,5029000,"Japan",5853000,15.4307317151541,13.6219258088916
"8018","Senegal",1971,854000,2822000,"Japan",3676000,14.8529564113949,13.6576864727707
"8019","Senegal",1972,1142000,2912000,"Japan",4054000,14.8843506882987,13.9482916691981
"8020","Senegal",1973,2526000,4465000,"Japan",6991000,15.3117797722927,14.7421475818926
"8021","Senegal",1974,3322000,10874000,"Japan",14196000,16.201885176688,15.0160775691554
"8022","Senegal",1975,4514000,10532000,"Japan",15046000,16.1699287995983,15.3226942363596
"8023","Senegal",1976,2230000,12802000,"Japan",15032000,16.3651119666841,14.6175121434363
"8024","Senegal",1977,4468000,12764000,"Japan",17232000,16.3621392663803,15.3124514391712
"8025","Senegal",1978,7978000,12426000,"Japan",20404000,16.3353016096058,15.8921983114475
"8026","Senegal",1979,11927000,10957000,"Japan",22884000,16.2094890793875,16.2943152955608
"8027","Senegal",1980,11795000,15364000,"Japan",27159000,16.5475376684479,16.2831862708239
"8028","Senegal",1981,13662000,14519000,"Japan",28181000,16.4909686944658,16.4301288142739
"8029","Senegal",1982,14569000,14170000,"Japan",28739000,16.4666376116669,16.4944065416361
"8030","Senegal",1983,13616000,12591000,"Japan",26207000,16.3484928309838,16.4267561297953
"8031","Senegal",1984,14003660,8581330,"Japan",22584990,15.9650994711061,16.4548292819845
"8032","Senegal",1985,16732827,19861940,"Japan",36594767,16.8043158955971,16.6328830365719
"8033","Senegal",1986,19189008,24446874,"Japan",43635882,17.0120129129506,16.7698481730573
"8034","Senegal",1987,33003450,12472080,"Japan",45475530,16.3390031040674,17.3121226594208
"8035","Senegal",1988,39270625,16449754,"Japan",55720379,16.6158210806565,17.4859873418846
"8036","Senegal",1989,25003140,21725241,"Japan",46728381,16.8939853222648,17.0345119749455
"8037","Senegal",1990,36945275,12132101,"Japan",49077376,16.3113654728466,17.4249483216743
"8038","Senegal",1991,26418228,11766937,"Japan",38185165,16.2808042074758,17.0895647844079
"8039","Senegal",1992,34532205,9411810,"Japan",43944015,16.0574758416303,17.3574029248426
"8040","Senegal",1993,30937820,10020700,"Japan",40958520,16.1201635114603,17.247489941674
"8041","Senegal",1994,27376088,10595439,"Japan",37971527,16.1759341834651,17.1251804896034
"8042","Senegal",1995,37160014,9642371,"Japan",46802385,16.0816775907018,17.430743848659
"8043","Senegal",1996,28553364,16762908,"Japan",45316272,16.6346791463206,17.1672853154964
"8044","Senegal",1997,27596335,6138125,"Japan",33734460,15.6300298788942,17.133193532015
"8045","Senegal",1998,25936000,6718000,"Japan",32654000,15.7203010491544,17.0711425229576
"8046","Senegal",1999,22026011,7197561,"Japan",29223572,15.7892527765975,16.9077346311167
"8047","Senegal",2000,35563508,5572881,"Japan",41136389,15.533422713372,17.3868306139131
"8048","Senegal",2001,17375170,3016532,"Japan",20391702,14.9196183851276,16.6705527335399
"8049","Senegal",2002,19082702,10114930,"Japan",29197632,16.1295231081448,16.7642928282138
"8050","Senegal",2003,20354023,10648516,"Japan",31002539,16.1809310976876,16.8287891407324
"8051","Senegal",2004,21562005,16569906,"Japan",38131911,16.6230987164838,16.8864432959706
"8052","Senegal",2005,26754397,14196649,"Japan",40951046,16.4685165088069,17.1022093916302
"8053","Senegal",2006,35735572,8362250,"Japan",44097822,15.9392380876055,17.3916571652242
"8054","Senegal",2007,29526621,12449616,"Japan",41976237,16.3372003370258,17.2008028211655
"8055","Senegal",2008,46687658,15663681,"Japan",62351339,16.5668552783765,17.6589904050551
"8056","Senegal",2009,39728541,8906856,"Japan",48635397,16.0023318752237,17.497580404237
"8057","Senegal",2010,55364526,10446057,"Japan",65810583,16.1617351445976,17.8294496217122
"8058","Senegal",2011,58529745,25469586,"Japan",83999331,17.0529955924066,17.8850456445178
"8059","Senegal",2012,47287409,27110348,"Japan",74397757,17.1154260579841,17.6717546235229
"8060","Senegal",2013,52313241,14808931,"Japan",67122172,16.51074100268,17.7727600709882
"8061","Senegal",2014,36376549,16539160,"Japan",52915709,16.6212414602968,17.4094348667417
"8062","Senegal",2015,48403011,11639208,"Japan",60042219,16.2698899567155,17.6950725804957
"8063","Senegal",2016,54724834,7719073,"Japan",62443907,15.8592048370708,17.81782816802
"8064","Senegal",2017,46740862.5,16898245.5,"Japan",63639108,16.6427203579359,17.6601293400498
"8065","Solomon Islands",1962,0,0,"0",0,0,0
"8066","Solomon Islands",1963,0,0,"0",0,0,0
"8067","Solomon Islands",1964,0,0,"0",0,0,0
"8068","Solomon Islands",1965,0,0,"0",0,0,0
"8069","Solomon Islands",1966,0,0,"0",0,0,0
"8070","Solomon Islands",1967,0,0,"0",0,0,0
"8071","Solomon Islands",1968,0,0,"0",0,0,0
"8072","Solomon Islands",1969,0,0,"0",0,0,0
"8073","Solomon Islands",1970,0,0,"0",0,0,0
"8074","Solomon Islands",1971,0,0,"0",0,0,0
"8075","Solomon Islands",1972,0,0,"0",0,0,0
"8076","Solomon Islands",1973,0,0,"0",0,0,0
"8077","Solomon Islands",1974,0,0,"0",0,0,0
"8078","Solomon Islands",1975,0,0,"0",0,0,0
"8079","Solomon Islands",1976,0,0,"0",0,0,0
"8080","Solomon Islands",1977,0,0,"0",0,0,0
"8081","Solomon Islands",1978,0,0,"0",0,0,0
"8082","Solomon Islands",1979,0,0,"0",0,0,0
"8083","Solomon Islands",1980,0,0,"0",0,0,0
"8084","Solomon Islands",1981,0,0,"0",0,0,0
"8085","Solomon Islands",1982,0,0,"0",0,0,0
"8086","Solomon Islands",1983,0,0,"0",0,0,0
"8087","Solomon Islands",1984,15173874,37735534,"Japan",52909408,17.4461127549194,16.5350856911683
"8088","Solomon Islands",1985,16030197,38100420,"Japan",54130617,17.4557358636582,16.5899848139675
"8089","Solomon Islands",1986,19780359,27202884,"Japan",46983243,17.1188335550573,16.8002000336402
"8090","Solomon Islands",1987,18210570,26233451,"Japan",44444021,17.082545910097,16.7175127526966
"8091","Solomon Islands",1988,16993799,28739223,"Japan",45733022,17.1737734027591,16.6483590707718
"8092","Solomon Islands",1989,31264270,34707764,"Japan",65972034,17.3624739662873,17.2579864699184
"8093","Solomon Islands",1990,18572879,37120825,"Japan",55693704,17.4296886908508,16.7372129563149
"8094","Solomon Islands",1991,23009352,36025448,"Japan",59034800,17.399736135581,16.9514112999462
"8095","Solomon Islands",1992,20767800,48185491,"Japan",68953291,17.6905685171087,16.8489142682393
"8096","Solomon Islands",1993,13042540,79516313,"Japan",92558853,18.1914727535435,16.3837268807707
"8097","Solomon Islands",1994,16631095,77633896,"Japan",94264991,18.167514693906,16.6267846938601
"8098","Solomon Islands",1995,14196062,89015324,"Japan",103211386,18.3043190926505,16.4684751601664
"8099","Solomon Islands",1996,15195879,102356587,"Japan",117552466,18.4439732255972,16.5365348306362
"8100","Solomon Islands",1997,8769036,52690339,"Japan",61459375,17.7799426760232,15.9867374381243
"8101","Solomon Islands",1998,0,0,"0",0,0,0
"8102","Solomon Islands",1999,17366995,51187380,"Japan",68554375,17.7510035752525,16.6700821238269
"8103","Solomon Islands",2000,5971716,20372368,"Japan",26344084,16.8296900308329,15.6025448812526
"8104","Solomon Islands",2001,3715162,16621100,"Japan",20336262,16.6261835305203,15.1279328421819
"8105","Solomon Islands",2002,2089862,18449853,"Japan",20539715,16.7305669609394,14.5526085930529
"8106","Solomon Islands",2003,3525916,16126232,"Japan",19652148,16.5959578208283,15.0756508186273
"8107","Solomon Islands",2004,5476392,16333130,"Japan",21809522,16.6087061183497,15.515957047927
"8108","Solomon Islands",2005,7089741,14459827,"Japan",21549568,16.4868848105846,15.7741593675167
"8109","Solomon Islands",2006,18331200,20721958,"Japan",39053158,16.8467044689604,16.7241150841215
"8110","Solomon Islands",2007,14143959,18081739,"Japan",32225698,16.7104130919313,16.4647981650997
"8111","Solomon Islands",2008,10262401,10622991,"Japan",20885392,16.1785311725435,16.1439973859241
"8112","Solomon Islands",2009,8808802,6023647,"Japan",14832449,15.6112034478073,15.9912620068272
"8113","Solomon Islands",2010,11862324,8392928,"Japan",20255252,15.9429000044508,16.2888778851201
"8114","Solomon Islands",2011,14797286,6238304,"Japan",21035590,15.6462189085309,16.5099543435401
"8115","Solomon Islands",2012,20535026,7440415,"Japan",27975441,15.8224371848235,16.837642571503
"8116","Solomon Islands",2013,17807124,5242473,"Japan",23049597,15.4723038915304,16.6951091599129
"8117","Solomon Islands",2014,13766552,9954382,"Japan",23720934,16.1135234141963,16.4377524399306
"8118","Solomon Islands",2015,13606015,8969447,"Japan",22575462,16.0093345821903,16.4260225323413
"8119","Solomon Islands",2016,21080009,5172628,"Japan",26252637,15.4588914345499,16.8638357085823
"8120","Solomon Islands",2017,19030263.5,3963341,"Japan",22993604.5,15.1925979143956,16.7615410857345
"8121","Sierra Leone",1962,6414000,1e+05,"Japan",6514000,11.5129254649702,15.6739936592352
"8122","Sierra Leone",1963,2660000,9000,"Japan",2669000,9.10497985631836,14.7938366807579
"8123","Sierra Leone",1964,10112000,165000,"Japan",10277000,12.0137007528827,16.1292333953688
"8124","Sierra Leone",1965,8806000,122000,"Japan",8928000,11.7117763237154,15.9909438652978
"8125","Sierra Leone",1966,10414000,464000,"Japan",10878000,13.0476398312084,16.158661612705
"8126","Sierra Leone",1967,8940000,388000,"Japan",9328000,12.8687606186054,16.0060461471497
"8127","Sierra Leone",1968,10618000,1245000,"Japan",11863000,14.0346460878809,16.1780612321258
"8128","Sierra Leone",1969,11542000,7955000,"Japan",19497000,15.889311219754,16.261503114253
"8129","Sierra Leone",1970,9150000,9178000,"Japan",18328000,16.0323198739369,16.0292644372517
"8130","Sierra Leone",1971,10342000,11190000,"Japan",21532000,16.2305310802881,16.1517238319383
"8131","Sierra Leone",1972,12003000,12099000,"Japan",24102000,16.3086333625236,16.3006671765075
"8132","Sierra Leone",1973,14800000,10572000,"Japan",25372000,16.1737195547063,16.5101377387343
"8133","Sierra Leone",1974,21437000,12235000,"Japan",33672000,16.3198112548589,16.8806289590033
"8134","Sierra Leone",1975,12874000,14779000,"Japan",27653000,16.5087178121967,16.3707203315947
"8135","Sierra Leone",1976,12173000,111000,"Japan",12284000,11.6172854802945,16.3147309423917
"8136","Sierra Leone",1977,11771000,70000,"Japan",11841000,11.1562505210315,16.2811494373946
"8137","Sierra Leone",1978,22558000,246000,"Japan",22804000,12.4130868149145,16.931600328182
"8138","Sierra Leone",1979,14178000,576000,"Japan",14754000,13.263862939678,16.4672020253971
"8139","Sierra Leone",1980,36461000,977000,"Japan",37438000,13.7922419310249,17.4117537541563
"8140","Sierra Leone",1981,16094000,1919000,"Japan",18013000,14.4673147749898,16.5939570896882
"8141","Sierra Leone",1982,20794000,811000,"Japan",21605000,13.6060233330975,16.8501750415201
"8142","Sierra Leone",1983,6801000,533000,"Japan",7334000,13.186276703148,15.7325802181578
"8143","Sierra Leone",1984,7465916,1838,"Japan",7467754,7.51643330291563,15.8258586873888
"8144","Sierra Leone",1985,8316392,1120771,"Japan",9437163,13.9295273992947,15.9337390648962
"8145","Sierra Leone",1986,8923046,54471,"Japan",8977517,10.9054237289388,16.0041479260859
"8146","Sierra Leone",1987,13679187,21782,"Japan",13700969,9.98883921963563,16.4313860385681
"8147","Sierra Leone",1988,16232363,332640,"Japan",16565003,12.7148161030918,16.6025175234709
"8148","Sierra Leone",1989,13878440,3160838,"Japan",17039278,14.9663477402799,16.4458471147957
"8149","Sierra Leone",1990,14132843,2244488,"Japan",16377331,14.6239879907875,16.464011937536
"8150","Sierra Leone",1991,8064938,1938704,"Japan",10003642,14.4775302665634,15.9030365819731
"8151","Sierra Leone",1992,5835336,2532392,"Japan",8367728,14.7446748685885,15.5794424055925
"8152","Sierra Leone",1993,10812116,1216641,"Japan",12028757,14.0116043407776,16.1961779151408
"8153","Sierra Leone",1994,13725064,2740156,"Japan",16465220,14.8235254110501,16.4347342083727
"8154","Sierra Leone",1995,1990692,2506002,"Japan",4496694,14.7341992125224,14.5039928749471
"8155","Sierra Leone",1996,2901066,2596392,"Japan",5497458,14.7696333469474,14.8805888136203
"8156","Sierra Leone",1997,3392711,867556,"Japan",4260267,13.6734353420338,15.0371398647777
"8157","Sierra Leone",1998,3121000,892000,"Japan",4013000,13.7012214115621,14.9536640212529
"8158","Sierra Leone",1999,2027219,751630,"Japan",2778849,13.5299994605732,14.5221754610386
"8159","Sierra Leone",2000,5731226,463309,"Japan",6194535,13.046149497074,15.56144002741
"8160","Sierra Leone",2001,5479847,2607482,"Japan",8087329,14.7738955626693,15.5165877388264
"8161","Sierra Leone",2002,5300364,750432,"Japan",6050796,13.5284043196882,15.4832860554093
"8162","Sierra Leone",2003,4676332,26828,"Japan",4703160,10.1972013972196,15.3580245999091
"8163","Sierra Leone",2004,3663604,143069,"Japan",3806673,11.8710823103504,15.1139579203326
"8164","Sierra Leone",2005,7248757,228057,"Japan",7476814,12.3373508766918,15.7963405638561
"8165","Sierra Leone",2006,1530232,840889,"Japan",2371121,13.6422149445129,14.2409299158603
"8166","Sierra Leone",2007,2902723,3069746,"Japan",5972469,14.9371053799842,14.8811598199216
"8167","Sierra Leone",2008,8840302,2157980,"Japan",10998282,14.5846831569167,15.9948315969262
"8168","Sierra Leone",2009,23457414,3910133,"Japan",27367547,15.1790819467283,16.9706971649348
"8169","Sierra Leone",2010,9272980,4059740,"Japan",13332720,15.2166294901184,16.0426153529807
"8170","Sierra Leone",2011,9437899,4895965,"Japan",14333864,15.4039219544559,16.0602439497914
"8171","Sierra Leone",2012,21158193,76394753,"Japan",97552946,18.1514245737678,16.8675377643324
"8172","Sierra Leone",2013,10946734,14928228,"Japan",25874962,16.5187644752645,16.2085517048968
"8173","Sierra Leone",2014,12855985,1922292,"Japan",14778277,14.469028782051,16.3693200196284
"8174","Sierra Leone",2015,11015614,946856,"Japan",11962470,13.7609023014719,16.2148242788348
"8175","Sierra Leone",2016,14313046,1792401,"Japan",16105447,14.3990666198052,16.4766819870227
"8176","Sierra Leone",2017,22617660,173891,"Japan",22791551,12.0661839451216,16.9342415750252
"8177","El Salvador",1962,8165000,25391000,"Japan",33556000,17.0499053384901,15.9153672843867
"8178","El Salvador",1963,9800000,38528000,"Japan",48328000,17.4668958076506,16.0978929436408
"8179","El Salvador",1964,12789000,37403000,"Japan",50192000,17.4372614730715,16.3640959844155
"8180","El Salvador",1965,17819000,33838000,"Japan",51657000,17.3370949893009,16.6957758617096
"8181","El Salvador",1966,14411000,22394000,"Japan",36805000,16.9243036238023,16.4835023618205
"8182","El Salvador",1967,16750000,16328000,"Japan",33078000,16.6083919834718,16.6339088162354
"8183","El Salvador",1968,15986000,15950000,"Japan",31936000,16.5849693871951,16.5872238971681
"8184","El Salvador",1969,18100000,19482000,"Japan",37582000,16.785001520313,16.7114224962361
"8185","El Salvador",1970,21930000,28113000,"Japan",50043000,17.1517426607741,16.9033661203941
"8186","El Salvador",1971,28889000,30607000,"Japan",59496000,17.2367392989314,17.17897145779
"8187","El Salvador",1972,30150000,40858000,"Japan",71008000,17.5256131985297,17.2216954811375
"8188","El Salvador",1973,35724000,48421000,"Japan",84145000,17.6954441618838,17.3913332897859
"8189","El Salvador",1974,44451000,45318000,"Japan",89769000,17.6292148625236,17.609898016859
"8190","El Salvador",1975,41238000,63571000,"Japan",104809000,17.9676679494794,17.5348707193318
"8191","El Salvador",1976,69319000,64197000,"Japan",133516000,17.9774670385964,18.0542295968565
"8192","El Salvador",1977,104150000,74215000,"Japan",178365000,18.122476844041,18.4613427256713
"8193","El Salvador",1978,108436000,63889000,"Japan",172325000,17.9726577605543,18.5016706951568
"8194","El Salvador",1979,81964000,78650000,"Japan",160614000,18.1805181874686,18.2217906844389
"8195","El Salvador",1980,42586000,36379000,"Japan",78965000,17.4095022430459,17.5670361187285
"8196","El Salvador",1981,33380000,40490000,"Japan",73870000,17.5165655880083,17.323467476198
"8197","El Salvador",1982,26575000,22743000,"Japan",49318000,16.9397679637066,17.0954814821923
"8198","El Salvador",1983,30835000,37953000,"Japan",68788000,17.4518591100649,17.2441609664077
"8199","El Salvador",1984,40493905,38555848,"Japan",79049753,17.4676183455606,17.5166620269243
"8200","El Salvador",1985,43269707,35333991,"Japan",78603698,17.3803559764426,17.582963340743
"8201","El Salvador",1986,33021122,30525681,"Japan",63546803,17.2340788872945,17.3126579752854
"8202","El Salvador",1987,59270212,26225513,"Japan",85495725,17.0822432735424,17.8976174106093
"8203","El Salvador",1988,53926180,26354932,"Japan",80281112,17.0871659881125,17.8031266322439
"8204","El Salvador",1989,55124640,15637671,"Japan",70762311,16.5651933689493,17.8251073610977
"8205","El Salvador",1990,32718862,6189266,"Japan",38908128,15.6383270592776,17.3034622891429
"8206","El Salvador",1991,55506366,15795707,"Japan",71302073,16.5752487522169,17.8320082748415
"8207","El Salvador",1992,99674057,5101337,"Japan",104775394,15.4450132202002,18.4174159904395
"8208","El Salvador",1993,94630270,8533618,"Japan",103163888,15.9595239796003,18.3654879616981
"8209","El Salvador",1994,130957876,8039474,"Japan",138997350,15.8998742161294,18.6903862722029
"8210","El Salvador",1995,127729538,14619709,"Japan",142349247,16.497881107847,18.6654256020078
"8211","El Salvador",1996,114167908,14420548,"Japan",128588456,16.4841646918729,18.553180799932
"8212","El Salvador",1997,136496560,21406670,"Japan",157903230,16.8792131136723,18.7318099708065
"8213","El Salvador",1998,123691000,23065000,"Japan",146756000,16.9538268749741,18.6332970780465
"8214","El Salvador",1999,116675735,15473004,"Japan",132148739,16.5546073859866,18.5749091493303
"8215","El Salvador",2000,90475201,16533808,"Japan",107009009,16.6209178122924,18.3205863490198
"8216","El Salvador",2001,113646143,10779842,"Japan",124425985,16.1931884665659,18.5486001701594
"8217","El Salvador",2002,123715054,11291068,"Japan",135006122,16.2395225286403,18.6334915276138
"8218","El Salvador",2003,120225791,13038110,"Japan",133263901,16.3833871653079,18.6048821244368
"8219","El Salvador",2004,122167626,12035829,"Japan",134203455,16.3033985092533,18.6209046432523
"8220","El Salvador",2005,116861734,18138568,"Japan",135000302,16.7135510579696,18.5765020332485
"8221","El Salvador",2006,141386948,23306474,"Japan",164693422,16.9642417340189,18.7670110016501
"8222","El Salvador",2007,167097531,18054404,"Japan",185151935,16.7089002019024,18.934088217873
"8223","El Salvador",2008,170585300,18052724,"Japan",188638024,16.7088071454842,18.954746022838
"8224","El Salvador",2009,95937268,24842845,"Japan",120780113,17.0280803414824,18.3792050775018
"8225","El Salvador",2010,137243797,25065271,"Japan",162309068,17.0369938205104,18.7372694424328
"8226","El Salvador",2011,153552447,55657923,"Japan",209210370,17.8347349975196,18.8495527409013
"8227","El Salvador",2012,108044068,43503628,"Japan",151547696,17.58835489488,18.4980497389011
"8228","El Salvador",2013,120065158,40297440,"Japan",160362598,17.511798501326,18.6035451367175
"8229","El Salvador",2014,103022118,19788736,"Japan",122810854,16.8006234448972,18.4504542610051
"8230","El Salvador",2015,98400741,26221857,"Japan",124622598,17.0821038575906,18.4045588924819
"8231","El Salvador",2016,130322951,21622665,"Japan",151945616,16.8892526280737,18.685526166262
"8232","El Salvador",2017,177586364,19236998,"Japan",196823362,16.772345961922,18.9949676062954
"8233","Somaliland",1962,0,0,"0",0,0,0
"8234","Somaliland",1963,0,0,"0",0,0,0
"8235","Somaliland",1964,0,0,"0",0,0,0
"8236","Somaliland",1965,0,0,"0",0,0,0
"8237","Somaliland",1966,0,0,"0",0,0,0
"8238","Somaliland",1967,0,0,"0",0,0,0
"8239","Somaliland",1968,0,0,"0",0,0,0
"8240","Somaliland",1969,0,0,"0",0,0,0
"8241","Somaliland",1970,0,0,"0",0,0,0
"8242","Somaliland",1971,0,0,"0",0,0,0
"8243","Somaliland",1972,0,0,"0",0,0,0
"8244","Somaliland",1973,0,0,"0",0,0,0
"8245","Somaliland",1974,0,0,"0",0,0,0
"8246","Somaliland",1975,0,0,"0",0,0,0
"8247","Somaliland",1976,0,0,"0",0,0,0
"8248","Somaliland",1977,0,0,"0",0,0,0
"8249","Somaliland",1978,0,0,"0",0,0,0
"8250","Somaliland",1979,0,0,"0",0,0,0
"8251","Somaliland",1980,0,0,"0",0,0,0
"8252","Somaliland",1981,0,0,"0",0,0,0
"8253","Somaliland",1982,0,0,"0",0,0,0
"8254","Somaliland",1983,0,0,"0",0,0,0
"8255","Somaliland",1984,0,0,"0",0,0,0
"8256","Somaliland",1985,0,0,"0",0,0,0
"8257","Somaliland",1986,0,0,"0",0,0,0
"8258","Somaliland",1987,0,0,"0",0,0,0
"8259","Somaliland",1988,0,0,"0",0,0,0
"8260","Somaliland",1989,0,0,"0",0,0,0
"8261","Somaliland",1990,0,0,"0",0,0,0
"8262","Somaliland",1991,0,0,"0",0,0,0
"8263","Somaliland",1992,0,0,"0",0,0,0
"8264","Somaliland",1993,0,0,"0",0,0,0
"8265","Somaliland",1994,0,0,"0",0,0,0
"8266","Somaliland",1995,0,0,"0",0,0,0
"8267","Somaliland",1996,0,0,"0",0,0,0
"8268","Somaliland",1997,0,0,"0",0,0,0
"8269","Somaliland",1998,0,0,"0",0,0,0
"8270","Somaliland",1999,0,0,"0",0,0,0
"8271","Somaliland",2000,0,0,"0",0,0,0
"8272","Somaliland",2001,0,0,"0",0,0,0
"8273","Somaliland",2002,0,0,"0",0,0,0
"8274","Somaliland",2003,0,0,"0",0,0,0
"8275","Somaliland",2004,0,0,"0",0,0,0
"8276","Somaliland",2005,0,0,"0",0,0,0
"8277","Somaliland",2006,0,0,"0",0,0,0
"8278","Somaliland",2007,0,0,"0",0,0,0
"8279","Somaliland",2008,0,0,"0",0,0,0
"8280","Somaliland",2009,0,0,"0",0,0,0
"8281","Somaliland",2010,0,0,"0",0,0,0
"8282","Somaliland",2011,0,0,"0",0,0,0
"8283","Somaliland",2012,0,0,"0",0,0,0
"8284","Somaliland",2013,0,0,"0",0,0,0
"8285","Somaliland",2014,0,0,"0",0,0,0
"8286","Somaliland",2015,0,0,"0",0,0,0
"8287","Somaliland",2016,0,0,"0",0,0,0
"8288","Somaliland",2017,0,0,"0",0,0,0
"8289","Somalia",1962,483000,0,"Japan",483000,0,13.0877719326347
"8290","Somalia",1963,708000,1000,"Japan",709000,6.90775527898214,13.4701993726759
"8291","Somalia",1964,1329000,5000,"Japan",1334000,8.51719319141624,14.0999373376954
"8292","Somalia",1965,918000,0,"Japan",918000,0,13.7299526696026
"8293","Somalia",1966,3160000,0,"Japan",3160000,0,14.9660825855631
"8294","Somalia",1967,2104000,0,"Japan",2104000,0,14.5593508528397
"8295","Somalia",1968,2779000,0,"Japan",2779000,0,14.8376017087246
"8296","Somalia",1969,3397000,155000,"Japan",3552000,11.9511803959014,15.0384032471427
"8297","Somalia",1970,3349000,109000,"Japan",3458000,11.5991031612113,15.0241723517763
"8298","Somalia",1971,3283000,133000,"Japan",3416000,11.7981044072039,15.0042681964837
"8299","Somalia",1972,4286000,330000,"Japan",4616000,12.7068479334427,15.2708644550157
"8300","Somalia",1973,3950000,119000,"Japan",4069000,11.6868787720937,15.1892261368773
"8301","Somalia",1974,5145000,1702000,"Japan",6847000,14.3473145881155,15.4535359272503
"8302","Somalia",1975,922000,1694000,"Japan",2616000,14.3426031541941,13.7343005025387
"8303","Somalia",1976,1779000,2189000,"Japan",3968000,14.598955376505,14.391561966648
"8304","Somalia",1977,1938000,6297000,"Japan",8235000,15.6555838874709,14.4771670714328
"8305","Somalia",1978,2162000,2274000,"Japan",4436000,14.6370509532926,14.5865442771813
"8306","Somalia",1979,2109000,895000,"Japan",3004000,13.704578997257,14.5617244594609
"8307","Somalia",1980,5126000,0,"Japan",5126000,0,15.4498361859062
"8308","Somalia",1981,5580000,91000,"Japan",5671000,11.418614785499,15.5346993343575
"8309","Somalia",1982,3173000,0,"Japan",3173000,0,14.9701880705653
"8310","Somalia",1983,11630000,80000,"Japan",11710000,11.289781913656,16.2690985244948
"8311","Somalia",1984,5510721,415422,"Japan",5926143,12.9370501500232,15.5222060255631
"8312","Somalia",1985,10691683,363687,"Japan",11055370,12.8040488865914,16.1849767074662
"8313","Somalia",1986,24756599,24956,"Japan",24781555,10.1248695532307,17.0246026377031
"8314","Somalia",1987,10493733,1229545,"Japan",11723278,14.0221547402126,16.1662887797948
"8315","Somalia",1988,10748549,2196506,"Japan",12945055,14.6023784740127,16.1902813266836
"8316","Somalia",1989,7737827,500816,"Japan",8238643,13.1239940471395,15.8616314567944
"8317","Somalia",1990,7864829,412850,"Japan",8277679,12.9308396098456,15.8779113523437
"8318","Somalia",1991,2274992,33857,"Japan",2308849,10.4299010516438,14.6374870938775
"8319","Somalia",1992,1212333,164768,"Japan",1377101,12.0122937028459,14.0080571603491
"8320","Somalia",1993,4481072,3516,"Japan",4484588,8.16507925880507,15.3153728614812
"8321","Somalia",1994,1486254,0,"Japan",1486254,0,14.2117694183208
"8322","Somalia",1995,780364,0,"Japan",780364,0,13.5675157564774
"8323","Somalia",1996,392000,4907,"Japan",396907,8.4984180360899,12.8790171187726
"8324","Somalia",1997,583033,9624,"Japan",592657,9.17201525765451,13.2759990675043
"8325","Somalia",1998,491000,0,"Japan",491000,0,13.1041994067767
"8326","Somalia",1999,391753,0,"Japan",391753,0,12.8783868181341
"8327","Somalia",2000,499353,233921,"Japan",733274,12.3627387305002,13.1210685394634
"8328","Somalia",2001,199798,158113,"Japan",357911,11.9710652462561,12.2050621351365
"8329","Somalia",2002,328235,73498,"Japan",401733,11.2050134739464,12.7014850942435
"8330","Somalia",2003,124243,439830,"Japan",564073,12.9941435676004,11.7299946043437
"8331","Somalia",2004,176910,1175342,"Japan",1352252,13.9770697270393,12.0833964076627
"8332","Somalia",2005,250093,493261,"Japan",743354,13.1087937247006,12.4295881276695
"8333","Somalia",2006,238739,489043,"Japan",727782,13.1002056991513,12.3831261839831
"8334","Somalia",2007,1214342,283282,"Japan",1497624,12.5541981469134,14.0097129242721
"8335","Somalia",2008,2848374,107566,"Japan",2955940,11.5858598916459,14.862258863117
"8336","Somalia",2009,1461461,72682,"Japan",1534143,11.1938490400181,14.1949471782646
"8337","Somalia",2010,136321,42460,"Japan",178781,10.6563177352572,11.822767677717
"8338","Somalia",2011,895328,56715,"Japan",952043,10.9457940049931,13.7049454105664
"8339","Somalia",2012,152538,43230,"Japan",195768,10.6742899776617,11.9351690243172
"8340","Somalia",2013,957357,61985,"Japan",1019342,11.0346476992722,13.771931641625
"8341","Somalia",2014,3273453,190063,"Japan",3463516,12.1551108751298,15.0013559490391
"8342","Somalia",2015,5396582,1488411,"Japan",6884993,14.2132196659137,15.5012763481659
"8343","Somalia",2016,3650420,8250879,"Japan",11901299,15.9258302980898,15.110352787432
"8344","Somalia",2017,0,0,"0",0,0,0
"8345","Republic of Serbia",1962,0,0,"0",0,0,0
"8346","Republic of Serbia",1963,0,0,"0",0,0,0
"8347","Republic of Serbia",1964,0,0,"0",0,0,0
"8348","Republic of Serbia",1965,0,0,"0",0,0,0
"8349","Republic of Serbia",1966,0,0,"0",0,0,0
"8350","Republic of Serbia",1967,0,0,"0",0,0,0
"8351","Republic of Serbia",1968,0,0,"0",0,0,0
"8352","Republic of Serbia",1969,0,0,"0",0,0,0
"8353","Republic of Serbia",1970,0,0,"0",0,0,0
"8354","Republic of Serbia",1971,0,0,"0",0,0,0
"8355","Republic of Serbia",1972,0,0,"0",0,0,0
"8356","Republic of Serbia",1973,0,0,"0",0,0,0
"8357","Republic of Serbia",1974,0,0,"0",0,0,0
"8358","Republic of Serbia",1975,0,0,"0",0,0,0
"8359","Republic of Serbia",1976,0,0,"0",0,0,0
"8360","Republic of Serbia",1977,0,0,"0",0,0,0
"8361","Republic of Serbia",1978,0,0,"0",0,0,0
"8362","Republic of Serbia",1979,0,0,"0",0,0,0
"8363","Republic of Serbia",1980,0,0,"0",0,0,0
"8364","Republic of Serbia",1981,0,0,"0",0,0,0
"8365","Republic of Serbia",1982,0,0,"0",0,0,0
"8366","Republic of Serbia",1983,0,0,"0",0,0,0
"8367","Republic of Serbia",1984,0,0,"0",0,0,0
"8368","Republic of Serbia",1985,0,0,"0",0,0,0
"8369","Republic of Serbia",1986,0,0,"0",0,0,0
"8370","Republic of Serbia",1987,0,0,"0",0,0,0
"8371","Republic of Serbia",1988,0,0,"0",0,0,0
"8372","Republic of Serbia",1989,0,0,"0",0,0,0
"8373","Republic of Serbia",1990,0,0,"0",0,0,0
"8374","Republic of Serbia",1991,0,0,"0",0,0,0
"8375","Republic of Serbia",1992,0,0,"0",0,0,0
"8376","Republic of Serbia",1993,0,0,"0",0,0,0
"8377","Republic of Serbia",1994,0,0,"0",0,0,0
"8378","Republic of Serbia",1995,0,0,"0",0,0,0
"8379","Republic of Serbia",1996,0,0,"0",0,0,0
"8380","Republic of Serbia",1997,0,0,"0",0,0,0
"8381","Republic of Serbia",1998,0,0,"0",0,0,0
"8382","Republic of Serbia",1999,0,0,"0",0,0,0
"8383","Republic of Serbia",2000,0,0,"0",0,0,0
"8384","Republic of Serbia",2001,0,0,"0",0,0,0
"8385","Republic of Serbia",2002,0,0,"0",0,0,0
"8386","Republic of Serbia",2003,0,0,"0",0,0,0
"8387","Republic of Serbia",2004,0,0,"0",0,0,0
"8388","Republic of Serbia",2005,0,0,"0",0,0,0
"8389","Republic of Serbia",2006,0,0,"0",0,0,0
"8390","Republic of Serbia",2007,0,0,"0",0,0,0
"8391","Republic of Serbia",2008,0,0,"0",0,0,0
"8392","Republic of Serbia",2009,0,0,"0",0,0,0
"8393","Republic of Serbia",2010,0,0,"0",0,0,0
"8394","Republic of Serbia",2011,0,0,"0",0,0,0
"8395","Republic of Serbia",2012,0,0,"0",0,0,0
"8396","Republic of Serbia",2013,0,0,"0",0,0,0
"8397","Republic of Serbia",2014,0,0,"0",0,0,0
"8398","Republic of Serbia",2015,0,0,"0",0,0,0
"8399","Republic of Serbia",2016,0,0,"0",0,0,0
"8400","Republic of Serbia",2017,0,0,"0",0,0,0
"8401","Suriname",1962,2491000,115000,"Japan",2606000,11.6526874073454,14.7281947942443
"8402","Suriname",1963,1932000,320000,"Japan",2252000,12.6760762747759,14.4740662937546
"8403","Suriname",1964,3156000,701000,"Japan",3857000,13.4602631660167,14.9648159609479
"8404","Suriname",1965,4353000,8e+05,"Japan",5153000,13.5923670066501,15.2863758205344
"8405","Suriname",1966,3482000,995000,"Japan",4477000,13.8104980161407,15.0631173993103
"8406","Suriname",1967,5738000,1103000,"Japan",6841000,13.9135442982356,15.5626212755234
"8407","Suriname",1968,5248000,5599000,"Japan",10847000,15.538098568331,15.4733576096061
"8408","Suriname",1969,6946000,3677000,"Japan",10623000,15.1176077602834,15.7536765122862
"8409","Suriname",1970,7390000,1093000,"Japan",8483000,13.9044367671587,15.8156382929244
"8410","Suriname",1971,9165000,5196000,"Japan",14361000,15.4633996567726,16.0309024392559
"8411","Suriname",1972,11351000,4055000,"Japan",15406000,15.2154612455316,16.2448164037375
"8412","Suriname",1973,9993000,3418000,"Japan",13411000,15.0445661426577,16.1173954058439
"8413","Suriname",1974,16302000,4644000,"Japan",20946000,15.3510866217999,16.6067983576365
"8414","Suriname",1975,14050000,5357000,"Japan",19407000,15.4939146748631,16.458132953744
"8415","Suriname",1976,21348000,10922000,"Japan",32270000,16.2062896616942,16.876468616436
"8416","Suriname",1977,25650000,19234000,"Japan",44884000,16.7721901042546,17.0600541295811
"8417","Suriname",1978,27374000,25434000,"Japan",52808000,17.0515974195628,17.1251042157533
"8418","Suriname",1979,21895000,45086000,"Japan",66981000,17.6240823349962,16.9017688582176
"8419","Suriname",1980,23771000,28779000,"Japan",52550000,17.1751565124682,16.9839769082874
"8420","Suriname",1981,34731000,23042000,"Japan",57773000,16.9528291955801,17.363143217856
"8421","Suriname",1982,33032000,19298000,"Japan",52330000,16.7755120215625,17.3129873465481
"8422","Suriname",1983,20466000,16680000,"Japan",37146000,16.6297209548949,16.8342755306288
"8423","Suriname",1984,11474233,12899350,"Japan",24373583,16.3726874804655,16.2556144707183
"8424","Suriname",1985,9725360,8452564,"Japan",18177924,15.9499803852599,16.0902474647785
"8425","Suriname",1986,8367122,25427477,"Japan",33794599,17.051340918949,15.9398205362638
"8426","Suriname",1987,5262912,24715393,"Japan",29978305,17.0229368058713,15.4761950436945
"8427","Suriname",1988,9056098,20139116,"Japan",29195214,16.8181745515406,16.0189489009213
"8428","Suriname",1989,10386429,15901214,"Japan",26287643,16.581906016477,16.156010608137
"8429","Suriname",1990,11046388,16089020,"Japan",27135408,16.5936476097177,16.2176140546638
"8430","Suriname",1991,19438887,17686611,"Japan",37125498,16.6883184706205,16.7827861022711
"8431","Suriname",1992,15560191,19332168,"Japan",34892359,16.7772810021639,16.5602263517034
"8432","Suriname",1993,13926129,17621184,"Japan",31547313,16.6846123725825,16.4492774176903
"8433","Suriname",1994,12911626,22784451,"Japan",35696077,16.9415888875906,16.3736387037688
"8434","Suriname",1995,15512876,25166820,"Japan",40679696,17.0410370182478,16.5571809467186
"8435","Suriname",1996,22702946,35279769,"Japan",57982715,17.3788202414624,16.9380052537667
"8436","Suriname",1997,24613853,19570944,"Japan",44184797,16.7895565753065,17.0188199724856
"8437","Suriname",1998,22937000,21405000,"Japan",44342000,16.8791350975612,16.9482618851764
"8438","Suriname",1999,21683724,20431681,"Japan",42115405,16.8325972443683,16.8920724910024
"8439","Suriname",2000,32106914,19955212,"Japan",52062126,16.8090009203123,17.2845819543154
"8440","Suriname",2001,21611685,16755724,"Japan",38367409,16.6342504892018,16.8887446986039
"8441","Suriname",2002,32203695,16800592,"Japan",49004287,16.6369246818479,17.287591755484
"8442","Suriname",2003,39078076,12098108,"Japan",51176184,16.3085596347045,17.481072151583
"8443","Suriname",2004,44913853,11745602,"Japan",56659455,16.2789894306152,17.6202568351937
"8444","Suriname",2005,42989939,10731885,"Japan",53721824,16.1887297748534,17.5764766695368
"8445","Suriname",2006,44465834,7008742,"Japan",51474576,15.762668784989,17.6102316769652
"8446","Suriname",2007,57844524,7830125,"Japan",65674649,15.8734890320797,17.8732693485237
"8447","Suriname",2008,54721277,3027889,"Japan",57749166,14.9233762350076,17.8177631679946
"8448","Suriname",2009,72764870,5798058,"Japan",78562928,15.5730335918632,18.1027438417548
"8449","Suriname",2010,75561450,6864404,"Japan",82425854,15.7418597762267,18.1404567904611
"8450","Suriname",2011,67542889,5197347,"Japan",72740236,15.4636588610516,18.0282733466589
"8451","Suriname",2012,82072467,5636337,"Japan",87708804,15.5447449443934,18.2231131588592
"8452","Suriname",2013,81715480,5104733,"Japan",86820213,15.4456787065481,18.2187540155666
"8453","Suriname",2014,70169506,5226908,"Japan",75396414,15.4693304566219,18.0664243871581
"8454","Suriname",2015,79010599,5768298,"Japan",84778897,15.5678876209674,18.185092565989
"8455","Suriname",2016,34359785,6417722,"Japan",40777507,15.6745737840391,17.3523973977848
"8456","Suriname",2017,35494730.5,182442,"Japan",35677172.5,12.1141875932738,17.3848948068081
"8457","Slovakia",1962,0,0,"0",0,0,0
"8458","Slovakia",1963,0,0,"0",0,0,0
"8459","Slovakia",1964,0,0,"0",0,0,0
"8460","Slovakia",1965,0,0,"0",0,0,0
"8461","Slovakia",1966,0,0,"0",0,0,0
"8462","Slovakia",1967,0,0,"0",0,0,0
"8463","Slovakia",1968,0,0,"0",0,0,0
"8464","Slovakia",1969,0,0,"0",0,0,0
"8465","Slovakia",1970,0,0,"0",0,0,0
"8466","Slovakia",1971,0,0,"0",0,0,0
"8467","Slovakia",1972,0,0,"0",0,0,0
"8468","Slovakia",1973,0,0,"0",0,0,0
"8469","Slovakia",1974,0,0,"0",0,0,0
"8470","Slovakia",1975,0,0,"0",0,0,0
"8471","Slovakia",1976,0,0,"0",0,0,0
"8472","Slovakia",1977,0,0,"0",0,0,0
"8473","Slovakia",1978,0,0,"0",0,0,0
"8474","Slovakia",1979,0,0,"0",0,0,0
"8475","Slovakia",1980,0,0,"0",0,0,0
"8476","Slovakia",1981,0,0,"0",0,0,0
"8477","Slovakia",1982,0,0,"0",0,0,0
"8478","Slovakia",1983,0,0,"0",0,0,0
"8479","Slovakia",1984,0,0,"0",0,0,0
"8480","Slovakia",1985,0,0,"0",0,0,0
"8481","Slovakia",1986,0,0,"0",0,0,0
"8482","Slovakia",1987,0,0,"0",0,0,0
"8483","Slovakia",1988,0,0,"0",0,0,0
"8484","Slovakia",1989,0,0,"0",0,0,0
"8485","Slovakia",1990,0,0,"0",0,0,0
"8486","Slovakia",1991,0,0,"0",0,0,0
"8487","Slovakia",1992,0,0,"0",0,0,0
"8488","Slovakia",1993,13130618,5306098,"Japan",18436716,15.4843672831663,16.390457312955
"8489","Slovakia",1994,73665403,8960356,"Japan",82625759,16.0083205163047,18.1150438168206
"8490","Slovakia",1995,117158814,27451973,"Japan",144610787,17.1279485994753,18.5790409569637
"8491","Slovakia",1996,141743712,23282067,"Japan",165025779,16.9631939655458,18.7695311397999
"8492","Slovakia",1997,192593622,17734166,"Japan",210327788,16.6910036194286,19.0760929415152
"8493","Slovakia",1998,209752000,17747000,"Japan",227499000,16.6917270455167,19.161436438427
"8494","Slovakia",1999,159382491,19654160,"Japan",179036651,16.7937995787078,18.8868174751253
"8495","Slovakia",2000,193191407,114055999,"Japan",307247406,18.5522001050483,19.0791920015279
"8496","Slovakia",2001,214191284,154139435,"Japan",368330719,18.8533681728085,19.182380024207
"8497","Slovakia",2002,277333437,135880371,"Japan",413213808,18.7272854316032,19.4407310839154
"8498","Slovakia",2003,384326274,69535208,"Japan",453861482,18.0573437721897,19.7670024216602
"8499","Slovakia",2004,524642106,114665741,"Japan",639307847,18.5575318539626,20.0782268852337
"8500","Slovakia",2005,579130121,100815788,"Japan",679945909,18.4288055283209,20.1770377443125
"8501","Slovakia",2006,778877812,152675652,"Japan",931553464,18.8438263075736,20.4733647391576
"8502","Slovakia",2007,752939363,183460128,"Japan",936399491,19.0275079157453,20.4394952552972
"8503","Slovakia",2008,896571161,195642933,"Japan",1092214094,19.0918017853448,20.6140882243233
"8504","Slovakia",2009,631754603,115973792,"Japan",747728395,18.5688747925099,20.264011590316
"8505","Slovakia",2010,1006533010,118533049,"Japan",1125066059,18.5907023741704,20.729777599327
"8506","Slovakia",2011,449591127,195339350,"Japan",644930477,19.0902488604466,19.9238491210287
"8507","Slovakia",2012,447820428,225302388,"Japan",673122816,19.2329540045474,19.9199028796682
"8508","Slovakia",2013,345199656,267840147,"Japan",613039803,19.4059008941004,19.6596335206493
"8509","Slovakia",2014,317852186,228558191,"Japan",546410377,19.2473014010847,19.577097008781
"8510","Slovakia",2015,263325213,144930934,"Japan",408256147,18.7917678696684,19.3889003775729
"8511","Slovakia",2016,252735407,225826530,"Japan",478561937,19.235277696135,19.3478536773039
"8512","Slovakia",2017,416683731.5,179595614,"Japan",596279345.5,19.0062182925988,19.8478380543539
"8513","Slovenia",1962,0,0,"0",0,0,0
"8514","Slovenia",1963,0,0,"0",0,0,0
"8515","Slovenia",1964,0,0,"0",0,0,0
"8516","Slovenia",1965,0,0,"0",0,0,0
"8517","Slovenia",1966,0,0,"0",0,0,0
"8518","Slovenia",1967,0,0,"0",0,0,0
"8519","Slovenia",1968,0,0,"0",0,0,0
"8520","Slovenia",1969,0,0,"0",0,0,0
"8521","Slovenia",1970,0,0,"0",0,0,0
"8522","Slovenia",1971,0,0,"0",0,0,0
"8523","Slovenia",1972,0,0,"0",0,0,0
"8524","Slovenia",1973,0,0,"0",0,0,0
"8525","Slovenia",1974,0,0,"0",0,0,0
"8526","Slovenia",1975,0,0,"0",0,0,0
"8527","Slovenia",1976,0,0,"0",0,0,0
"8528","Slovenia",1977,0,0,"0",0,0,0
"8529","Slovenia",1978,0,0,"0",0,0,0
"8530","Slovenia",1979,0,0,"0",0,0,0
"8531","Slovenia",1980,0,0,"0",0,0,0
"8532","Slovenia",1981,0,0,"0",0,0,0
"8533","Slovenia",1982,0,0,"0",0,0,0
"8534","Slovenia",1983,0,0,"0",0,0,0
"8535","Slovenia",1984,0,0,"0",0,0,0
"8536","Slovenia",1985,0,0,"0",0,0,0
"8537","Slovenia",1986,0,0,"0",0,0,0
"8538","Slovenia",1987,0,0,"0",0,0,0
"8539","Slovenia",1988,0,0,"0",0,0,0
"8540","Slovenia",1989,0,0,"0",0,0,0
"8541","Slovenia",1990,0,0,"0",0,0,0
"8542","Slovenia",1991,0,0,"0",0,0,0
"8543","Slovenia",1992,81906792,10246578,"Japan",92153370,16.1424543541486,18.2210924757877
"8544","Slovenia",1993,113703316,29467945,"Japan",143171261,17.1988136203517,18.5491031227634
"8545","Slovenia",1994,113926515,25971077,"Japan",139897592,17.072494053707,18.5510641932483
"8546","Slovenia",1995,144238062,29348310,"Japan",173586372,17.1947455216606,18.786975700829
"8547","Slovenia",1996,148799819,27443586,"Japan",176243405,17.1276430374146,18.8181124639647
"8548","Slovenia",1997,163698157,20308325,"Japan",184006482,16.8265414584668,18.9135347838785
"8549","Slovenia",1998,170066000,19297000,"Japan",189363000,16.7754602013785,18.9516971549648
"8550","Slovenia",1999,175499067,21408875,"Japan",196907942,16.8793161136458,18.9831442846167
"8551","Slovenia",2000,151416278,20461659,"Japan",171877937,16.8340634002445,18.8355434097007
"8552","Slovenia",2001,131115119,22123545,"Japan",153238664,16.9121529839839,18.6915862662646
"8553","Slovenia",2002,131553892,26012538,"Japan",157566430,17.0740892105191,18.6949271507218
"8554","Slovenia",2003,184275033,29728303,"Japan",214003336,17.207610112955,19.0319399441198
"8555","Slovenia",2004,219638406,36003759,"Japan",255642165,17.399133907636,19.2074931430184
"8556","Slovenia",2005,268456810,46467105,"Japan",314923915,17.6542552008636,19.4082006023636
"8557","Slovenia",2006,233791000,40736274,"Japan",274527274,17.5226295065539,19.2699381118216
"8558","Slovenia",2007,282021187,45773223,"Japan",327794410,17.6392098274546,19.4574927572859
"8559","Slovenia",2008,327484575,53097540,"Japan",380582115,17.7876411574554,19.6069515126937
"8560","Slovenia",2009,214579293,35194063,"Japan",249773356,17.3763879615701,19.184189892359
"8561","Slovenia",2010,209900502,41705792,"Japan",251606294,17.5461505740062,19.1621441764031
"8562","Slovenia",2011,83375458,55484883,"Japan",138860341,17.8316211632366,18.2388645554383
"8563","Slovenia",2012,78836747,58371300,"Japan",137208047,17.8823348886469,18.1828897786162
"8564","Slovenia",2013,92119756,67730321,"Japan",159850077,18.0310445105863,18.3385999841942
"8565","Slovenia",2014,89939333,66349410,"Japan",156288743,18.0104454264648,18.3146459232242
"8566","Slovenia",2015,97781830,64630372,"Japan",162412202,17.9841950130635,18.3982493304234
"8567","Slovenia",2016,119924806,141943996,"Japan",261868802,18.7709431434054,18.6023754876734
"8568","Slovenia",2017,199361535,157928205,"Japan",357289740,18.8776510889867,19.1106304931726
"8569","Sweden",1962,34070000,16897000,"Japan",50967000,16.6426466493428,17.3439277896371
"8570","Sweden",1963,35596000,19915000,"Japan",55511000,16.8069837745979,17.3877438299589
"8571","Sweden",1964,46875000,33224000,"Japan",80099000,17.3187830642927,17.6629950422548
"8572","Sweden",1965,60921000,33932000,"Japan",94853000,17.3398690799098,17.925088500827
"8573","Sweden",1966,58190000,33601000,"Japan",91791000,17.3300663863953,17.8792240766329
"8574","Sweden",1967,67279000,46538000,"Japan",113817000,17.655779741129,18.0243587102605
"8575","Sweden",1968,86831000,51334000,"Japan",138165000,17.7538638586385,18.2794742587274
"8576","Sweden",1969,87300000,59102000,"Japan",146402000,17.8947753227513,18.2848610208098
"8577","Sweden",1970,125991000,88709000,"Japan",214700000,18.300871907747,18.6517210337932
"8578","Sweden",1971,146001000,117171000,"Japan",263172000,18.5791449642158,18.7991240289642
"8579","Sweden",1972,175042000,97339000,"Japan",272381000,18.3937102890479,18.9805365030924
"8580","Sweden",1973,238558000,168477000,"Japan",407035000,18.9423097999236,19.2901230253104
"8581","Sweden",1974,388161000,249687000,"Japan",637848000,19.3357186914197,19.7769307599739
"8582","Sweden",1975,504393000,198918000,"Japan",703311000,19.1084032374671,20.038866284084
"8583","Sweden",1976,615258000,226132000,"Japan",841390000,19.2366294575301,20.2375522499953
"8584","Sweden",1977,784278000,219980000,"Japan",1004258000,19.2090471910932,20.4802741072986
"8585","Sweden",1978,790803000,351688000,"Japan",1142491000,19.6782549768735,20.4885594428802
"8586","Sweden",1979,819187000,412945000,"Japan",1232132000,19.8388249701443,20.523822942983
"8587","Sweden",1980,953319000,462603000,"Japan",1415922000,19.9523797928249,20.675460138032
"8588","Sweden",1981,1050596000,332941000,"Japan",1383537000,19.6234758550698,20.7726234591287
"8589","Sweden",1982,1015847000,351972000,"Japan",1367819000,19.6790621849439,20.7389885842116
"8590","Sweden",1983,996761000,451561000,"Japan",1448322000,19.9282210269003,20.7200215800314
"8591","Sweden",1984,1169906334,429188913,"Japan",1599095247,19.8774077366071,20.8801895261411
"8592","Sweden",1985,1324356074,406899007,"Japan",1731255081,19.8240755725659,21.0041921963703
"8593","Sweden",1986,1680867046,517716366,"Japan",2198583412,20.0649380942757,21.2425755960379
"8594","Sweden",1987,2326636579,618781356,"Japan",2945417935,20.2432625469268,21.5676895333071
"8595","Sweden",1988,2651536079,894394501,"Japan",3545930580,20.6116575120904,21.6984049614638
"8596","Sweden",1989,2696489275,977438189,"Japan",3673927464,20.7004456140649,21.7152164953556
"8597","Sweden",1990,2525658629,1175933507,"Japan",3701592136,20.8853281431576,21.6497677088284
"8598","Sweden",1991,2303360324,1153503372,"Japan",3456863696,20.8660695588508,21.5576349040789
"8599","Sweden",1992,2270602426,1093699298,"Japan",3364301724,20.8128316384473,21.5433110191342
"8600","Sweden",1993,1920373605,1387414567,"Japan",3307788172,21.0507078283558,21.3757855899942
"8601","Sweden",1994,2202003967,1651879890,"Japan",3853883857,21.2251798035909,21.5126336767893
"8602","Sweden",1995,1684272165,2328974720,"Japan",4013246885,21.5686939733457,21.2445993578788
"8603","Sweden",1996,1415526931,2519621885,"Japan",3935148816,21.6473746815768,21.0707676881212
"8604","Sweden",1997,1501369877,1770285419,"Japan",3271655296,21.2944066242045,21.1296437796276
"8605","Sweden",1998,1664830000,1929721000,"Japan",3594551000,21.380641269828,21.2329888530639
"8606","Sweden",1999,1550724142,2163433638,"Japan",3714157780,21.494962443713,21.1619878471661
"8607","Sweden",2000,1940816405,2472260546,"Japan",4413076951,21.6283987698551,21.3863745488183
"8608","Sweden",2001,1284106054,1969097401,"Japan",3253203455,21.4008411026222,20.9733286353765
"8609","Sweden",2002,1341453780,1838877378,"Japan",3180331158,21.3324211017158,21.017019773267
"8610","Sweden",2003,1663441387,1803812993,"Japan",3467254380,21.3131685907967,21.232154418056
"8611","Sweden",2004,1899647689,2059726122,"Japan",3959373811,21.4458388604238,21.364934279083
"8612","Sweden",2005,2091329264,1952949212,"Japan",4044278476,21.3926064833825,21.4610657122368
"8613","Sweden",2006,2215365388,2110358885,"Japan",4325724273,21.4701238576488,21.5186831875613
"8614","Sweden",2007,2340793195,2032959890,"Japan",4373753085,21.4327586419341,21.5737556811001
"8615","Sweden",2008,2335994001,1873782464,"Japan",4209776465,21.3512249329148,21.571703333844
"8616","Sweden",2009,1647010651,1539486118,"Japan",3186496769,21.1547145080748,21.2222277550305
"8617","Sweden",2010,1853100502,1819303398,"Japan",3672403900,21.3217195164166,21.3401260202316
"8618","Sweden",2011,1916190183,2413155158,"Japan",4329345341,21.6042009223924,21.3736047720075
"8619","Sweden",2012,1730094183,2398347115,"Japan",4128441298,21.5980456349528,21.2714416850147
"8620","Sweden",2013,1251446155,2279585019,"Japan",3531031174,21.5472592541365,20.9475656435398
"8621","Sweden",2014,1335948145,2099465785,"Japan",3435413930,21.4649487612184,21.0129070976848
"8622","Sweden",2015,1325720139,1826705415,"Japan",3152425554,21.3257798616045,21.0052216498734
"8623","Sweden",2016,1423498844,2163501332,"Japan",3587000176,21.4949937332981,21.0763836525991
"8624","Sweden",2017,1319601447.5,2619301349,"Japan",3938902796.5,21.6861734584721,21.0005955942414
"8625","Swaziland",1962,0,0,"0",0,0,0
"8626","Swaziland",1963,0,0,"0",0,0,0
"8627","Swaziland",1964,0,0,"0",0,0,0
"8628","Swaziland",1965,0,0,"0",0,0,0
"8629","Swaziland",1966,0,0,"0",0,0,0
"8630","Swaziland",1967,0,0,"0",0,0,0
"8631","Swaziland",1968,0,0,"0",0,0,0
"8632","Swaziland",1969,0,0,"0",0,0,0
"8633","Swaziland",1970,0,0,"0",0,0,0
"8634","Swaziland",1971,0,0,"0",0,0,0
"8635","Swaziland",1972,0,0,"0",0,0,0
"8636","Swaziland",1973,0,0,"0",0,0,0
"8637","Swaziland",1974,0,0,"0",0,0,0
"8638","Swaziland",1975,0,0,"0",0,0,0
"8639","Swaziland",1976,0,0,"0",0,0,0
"8640","Swaziland",1977,0,0,"0",0,0,0
"8641","Swaziland",1978,0,0,"0",0,0,0
"8642","Swaziland",1979,0,0,"0",0,0,0
"8643","Swaziland",1980,0,0,"0",0,0,0
"8644","Swaziland",1981,0,0,"0",0,0,0
"8645","Swaziland",1982,0,0,"0",0,0,0
"8646","Swaziland",1983,0,0,"0",0,0,0
"8647","Swaziland",1984,0,0,"0",0,0,0
"8648","Swaziland",1985,0,0,"0",0,0,0
"8649","Swaziland",1986,0,0,"0",0,0,0
"8650","Swaziland",1987,0,0,"0",0,0,0
"8651","Swaziland",1988,0,0,"0",0,0,0
"8652","Swaziland",1989,0,0,"0",0,0,0
"8653","Swaziland",1990,0,0,"0",0,0,0
"8654","Swaziland",1991,0,0,"0",0,0,0
"8655","Swaziland",1992,0,0,"0",0,0,0
"8656","Swaziland",1993,0,0,"0",0,0,0
"8657","Swaziland",1994,0,0,"0",0,0,0
"8658","Swaziland",1995,0,0,"0",0,0,0
"8659","Swaziland",1996,0,0,"0",0,0,0
"8660","Swaziland",1997,0,0,"0",0,0,0
"8661","Swaziland",1998,0,0,"0",0,0,0
"8662","Swaziland",1999,0,0,"0",0,0,0
"8663","Swaziland",2000,4672980,9937835,"Japan",14610815,16.1118597480684,15.3573075417676
"8664","Swaziland",2001,5498372,6597396,"Japan",12095768,15.7021855836886,15.5199626063861
"8665","Swaziland",2002,3894430,4583010,"Japan",8477440,15.3378665454658,15.1750578851146
"8666","Swaziland",2003,3863004,5763096,"Japan",9626100,15.5669853882707,15.1669556771125
"8667","Swaziland",2004,4770942,5971701,"Japan",10742643,15.6025423694086,15.3780543276438
"8668","Swaziland",2005,5119731,5930933,"Japan",11050664,15.5956920941798,15.448612456573
"8669","Swaziland",2006,5630119,4100825,"Japan",9730944,15.2266987309448,15.5436411366598
"8670","Swaziland",2007,6030492,4638332,"Japan",10668824,15.3498653768144,15.6123391574147
"8671","Swaziland",2008,5520551,5069939,"Japan",10590490,15.4388393439368,15.5239882321123
"8672","Swaziland",2009,5078662,4743083,"Japan",9821745,15.3721979041795,15.4405583990358
"8673","Swaziland",2010,7321448,1933348,"Japan",9254796,14.4747637730267,15.8063186805825
"8674","Swaziland",2011,4462551,1171981,"Japan",5634532,13.9742060373836,15.3112311335762
"8675","Swaziland",2012,5924764,872063,"Japan",6796827,13.6786169479878,15.5946514129686
"8676","Swaziland",2013,5829924,2027034,"Japan",7856958,14.5220841988504,15.5785145222211
"8677","Swaziland",2014,7438980,621941,"Japan",8060921,13.3406005119168,15.8222443006365
"8678","Swaziland",2015,9703694,310133,"Japan",10013827,12.6447565167114,16.0880171957205
"8679","Swaziland",2016,10934578,583442,"Japan",11518020,13.2767003255968,16.2074406196702
"8680","Swaziland",2017,14372563,296048.5,"Japan",14668611.5,12.5982785712354,16.480831599841
"8681","Syria",1962,8640000,8e+05,"Japan",9440000,13.5923670066501,15.9719131407802
"8682","Syria",1963,9947000,964000,"Japan",10911000,13.7788465735927,16.1127815561345
"8683","Syria",1964,8847000,1494000,"Japan",10341000,14.2169676446749,15.9955889764655
"8684","Syria",1965,9981000,1116000,"Japan",11097000,13.9252614219234,16.1161938436687
"8685","Syria",1966,10348000,7764000,"Japan",18112000,15.865008223271,16.1523038222881
"8686","Syria",1967,7010000,5037000,"Japan",12047000,15.4323212247278,15.7628482590108
"8687","Syria",1968,10284000,18537000,"Japan",28821000,16.7352792927112,16.1460998473679
"8688","Syria",1969,17647000,859000,"Japan",18506000,13.6635242009664,16.6860763552254
"8689","Syria",1970,16124000,16739000,"Japan",32863000,16.6332518840848,16.5958194032192
"8690","Syria",1971,20565000,7686000,"Japan",28251000,15.8549110501069,16.8391011596467
"8691","Syria",1972,32069000,6728000,"Japan",38797000,15.7217884806349,17.2834003893933
"8692","Syria",1973,23926000,4177000,"Japan",28103000,15.2451038434793,16.990476291713
"8693","Syria",1974,40687000,1960000,"Japan",42647000,14.4884550312067,17.5214191890711
"8694","Syria",1975,87384000,3371000,"Japan",90755000,15.0307199942162,18.2858227575055
"8695","Syria",1976,157069000,6505000,"Japan",163574000,15.6880816699287,18.8721957572108
"8696","Syria",1977,152525000,6156000,"Japan",158681000,15.6329377739409,18.8428390750022
"8697","Syria",1978,88172000,4294000,"Japan",92466000,15.2727292574209,18.2948000102584
"8698","Syria",1979,100604000,1347000,"Japan",101951000,14.1133904553925,18.4267025762709
"8699","Syria",1980,198387000,2759000,"Japan",201146000,14.8303788531994,19.1057302264747
"8700","Syria",1981,254524000,10746000,"Japan",265270000,16.1900441502709,19.3549056920627
"8701","Syria",1982,167948000,1552000,"Japan",169500000,14.2550549797253,18.9391649656456
"8702","Syria",1983,250276000,1438000,"Japan",251714000,14.1787638172631,19.3380748668667
"8703","Syria",1984,116240892,4436332,"Japan",120677224,15.305338466852,18.5711752509752
"8704","Syria",1985,126917081,2783474,"Japan",129700555,14.839210345804,18.6590445256754
"8705","Syria",1986,91342935,6279737,"Japan",97622672,15.6528386585865,18.3301314978959
"8706","Syria",1987,131271934,3736552,"Japan",135008486,15.1336738190227,18.6927815616641
"8707","Syria",1988,205060410,6083932,"Japan",211144342,15.6211617554415,19.138815176619
"8708","Syria",1989,77088930,3892763,"Japan",80981693,15.1746297462395,18.1604702484585
"8709","Syria",1990,69688248,4172959,"Japan",73861207,15.2441359344595,18.0595422531934
"8710","Syria",1991,117582478,3495857,"Japan",121078335,15.0670891110308,18.5826505857291
"8711","Syria",1992,300169757,7548848,"Japan",307718605,15.8369055268018,19.5198587292506
"8712","Syria",1993,274531821,13807178,"Japan",288338999,16.4406991598265,19.4305777356925
"8713","Syria",1994,461445030,15305730,"Japan",476750760,16.5437378260553,19.9498734932202
"8714","Syria",1995,181205809,7705478,"Japan",188911287,15.85744206245,19.0151440095582
"8715","Syria",1996,267985165,11632925,"Japan",279618090,16.269349997602,19.4064421824654
"8716","Syria",1997,246308712,29183696,"Japan",275492408,17.1891207551353,19.3220962339634
"8717","Syria",1998,242600000,32164000,"Japan",274764000,17.2863583726502,19.3069245544742
"8718","Syria",1999,156659854,20081755,"Japan",176741609,16.815322249367,18.8695874779484
"8719","Syria",2000,118510315,15304361,"Japan",133814676,16.5436483784283,18.5905105611646
"8720","Syria",2001,184137326,14581440,"Japan",198718766,16.4952600450999,19.0311923741589
"8721","Syria",2002,181376774,19812932,"Japan",201189706,16.8018454137805,19.0160870499616
"8722","Syria",2003,184547769,43057366,"Japan",227605135,17.5780438775697,19.0334188985024
"8723","Syria",2004,227846997,15081246,"Japan",242928243,16.5289625431254,19.2441848958638
"8724","Syria",2005,252500534,14880782,"Japan",267381316,16.5155811397518,19.3469239215289
"8725","Syria",2006,341135592,8797498,"Japan",349933090,15.9899779208405,19.6477905867123
"8726","Syria",2007,476887114,20435384,"Japan",497322498,16.8327784660934,19.9827903625637
"8727","Syria",2008,642979080,13193940,"Japan",656173020,16.395268191233,20.2816227466804
"8728","Syria",2009,279650778,32374353,"Japan",312025131,17.2928770932283,19.449052161277
"8729","Syria",2010,208672882,114297871,"Japan",322970753,18.5543185021699,19.1562784258952
"8730","Syria",2011,201823690,19398501,"Japan",221222191,16.780706353007,19.1229050524526
"8731","Syria",2012,113146659,2655739,"Japan",115802398,14.7922335166775,18.5441954024316
"8732","Syria",2013,7464931,1864753,"Japan",9329684,14.4386391626109,15.8257267457781
"8733","Syria",2014,10183867,1322104,"Japan",11505971,14.0947349649834,16.1363153594326
"8734","Syria",2015,9184830,788840,"Japan",9973670,13.578318790924,16.0330637680224
"8735","Syria",2016,22781183,934132,"Japan",23715315,13.7473730348483,16.9414454461538
"8736","Syria",2017,0,0,"0",0,0,0
"8737","Chad",1962,511000,0,"Japan",511000,0,13.1441248691858
"8738","Chad",1963,434000,0,"Japan",434000,0,12.9807998130825
"8739","Chad",1964,635000,0,"Japan",635000,0,13.3613802778748
"8740","Chad",1965,809000,278000,"Japan",1087000,12.5353763926728,13.6035541960406
"8741","Chad",1966,907000,438000,"Japan",1345000,12.9899741893586,13.7178977290973
"8742","Chad",1967,473000,1166000,"Japan",1639000,13.9690896458926,13.0668506674741
"8743","Chad",1968,610000,1678000,"Japan",2288000,14.3331131660093,13.3212142361495
"8744","Chad",1969,630000,735000,"Japan",1365000,13.507625778195,13.3534750983677
"8745","Chad",1970,575000,6138000,"Japan",6713000,15.6300095141618,13.2621253197795
"8746","Chad",1971,828000,2740000,"Japan",3568000,14.8234684783643,13.6267684333674
"8747","Chad",1972,703000,2671000,"Japan",3374000,14.7979634920921,13.4631121707928
"8748","Chad",1973,1900000,4697000,"Japan",6597000,15.3624345650091,14.4573644441367
"8749","Chad",1974,922000,12143000,"Japan",13065000,16.312263430036,13.7343005025387
"8750","Chad",1975,2027000,4301000,"Japan",6328000,15.2743581117659,14.5220674254341
"8751","Chad",1976,2229000,14847000,"Japan",17076000,16.5133083826021,14.617063612368
"8752","Chad",1977,1574000,18278000,"Japan",19852000,16.7212087088143,14.2691307079595
"8753","Chad",1978,1604000,12586000,"Japan",14190000,16.348095643069,14.2880110674086
"8754","Chad",1979,246000,10811000,"Japan",11057000,16.1960746922749,12.4130868149145
"8755","Chad",1980,64000,7494000,"Japan",7558000,15.8296132583358,11.0666383623418
"8756","Chad",1981,60000,9019000,"Japan",9079000,16.0148440211478,11.0020998412042
"8757","Chad",1982,5000,650000,"Japan",655000,13.3847276418718,8.51719319141624
"8758","Chad",1983,91000,2395000,"Japan",2486000,14.6888937888272,11.418614785499
"8759","Chad",1984,197869,3447589,"Japan",3645458,15.0531857041249,12.1953604745505
"8760","Chad",1985,686547,119002,"Japan",805549,11.6868955786751,13.4394299650659
"8761","Chad",1986,814736,1215528,"Japan",2030264,14.0106891082607,13.6106194133672
"8762","Chad",1987,1304342,4803,"Japan",1309145,8.47699600166482,14.0812092570206
"8763","Chad",1988,8276952,3706440,"Japan",11983392,15.1255824051697,15.9289853426481
"8764","Chad",1989,4517089,8667034,"Japan",13184123,15.9750371910348,15.3233783177856
"8765","Chad",1990,5800050,11003256,"Japan",16803306,16.2137017869633,15.5733770961691
"8766","Chad",1991,4558916,9165233,"Japan",13724149,16.0309278617369,15.3325954339326
"8767","Chad",1992,3786904,4191459,"Japan",7978363,15.2485594413111,15.1470593566814
"8768","Chad",1993,4003344,2581663,"Japan",6585007,14.7639443228928,15.2026405698308
"8769","Chad",1994,3958515,1509200,"Japan",5467715,14.2270902670723,15.1913795129006
"8770","Chad",1995,4208842,3213656,"Japan",7422498,14.9829197878151,15.2526981084404
"8771","Chad",1996,1119997,4842898,"Japan",5962895,15.3930238598379,13.9288365646963
"8772","Chad",1997,1145620,2770526,"Japan",3916146,14.8345477518331,13.9514565331367
"8773","Chad",1998,836000,3037000,"Japan",3873000,14.9263807440279,13.6363838920668
"8774","Chad",1999,1617243,2124714,"Japan",3741957,14.5691477630476,14.2962334055617
"8775","Chad",2000,1799992,980411,"Japan",2780403,13.7957271504834,14.4032927784121
"8776","Chad",2001,2015683,760091,"Japan",2775774,13.5411934419367,14.5164686537461
"8777","Chad",2002,765176,70421,"Japan",835597,11.1622467931194,13.5478611517072
"8778","Chad",2003,1440862,21799,"Japan",1462661,9.98961937616541,14.1807521035671
"8779","Chad",2004,501817,119982,"Japan",621799,11.6950970105131,13.1259907903797
"8780","Chad",2005,534560,44762,"Japan",579322,10.7091148441801,13.1891992575906
"8781","Chad",2006,1064516,11249189,"Japan",12313705,16.2358065951273,13.8780307937335
"8782","Chad",2007,4702790,85939680,"Japan",90642470,18.2691562127761,15.3636665075807
"8783","Chad",2008,9898699,179163390,"Japan",189062089,19.0038087407587,16.1079138923278
"8784","Chad",2009,12540876,443395,"Japan",12984271,13.002216299601,16.3445039471885
"8785","Chad",2010,3506670,61566,"Japan",3568236,11.0278650490903,15.0701774271756
"8786","Chad",2011,1505410,140053,"Japan",1645463,11.8497762013799,14.2245758443133
"8787","Chad",2012,2704166,37672534,"Japan",40376700,17.4444418457891,14.8103041047932
"8788","Chad",2013,2659181,186906188,"Japan",189565369,19.0461173804919,14.7935287386117
"8789","Chad",2014,2373762,296510491,"Japan",298884253,19.5075931585754,14.6799865963881
"8790","Chad",2015,8741882,249754344,"Japan",258496226,19.3359883687351,15.9836360562589
"8791","Chad",2016,8325269,69706674,"Japan",78031943,18.0598066243748,15.9348059056211
"8792","Chad",2017,0,0,"0",0,0,0
"8793","Togo",1962,1390000,603000,"Japan",1993000,13.3096724757093,14.1448143051069
"8794","Togo",1963,2591000,1166000,"Japan",3757000,13.9690896458926,14.7675544595442
"8795","Togo",1964,5890000,1910000,"Japan",7800000,14.4626138000228,15.5887665556278
"8796","Togo",1965,6263000,2399000,"Japan",8662000,14.6905625418218,15.6501698615075
"8797","Togo",1966,6490000,2759000,"Japan",9249000,14.8303788531994,15.6857730886803
"8798","Togo",1967,5668000,2575000,"Japan",8243000,14.76136009208,15.5503468797927
"8799","Togo",1968,5330000,3548000,"Japan",8878000,15.0818946224116,15.488861796142
"8800","Togo",1969,4044000,3562000,"Japan",7606000,15.0858327428317,15.2127448591225
"8801","Togo",1970,3841000,3316000,"Japan",7157000,15.0142697952373,15.161243307328
"8802","Togo",1971,3387000,2731000,"Japan",6118000,14.8201784004558,15.0354551317999
"8803","Togo",1972,3674000,1846000,"Japan",5520000,14.4285316940449,15.1167915447572
"8804","Togo",1973,2816000,2270000,"Japan",5086000,14.6352903894576,14.8508279962601
"8805","Togo",1974,3625000,6254000,"Japan",9879000,15.6487318169999,15.1033648462709
"8806","Togo",1975,4980000,4877000,"Japan",9857000,15.4000408346922,15.4209404490008
"8807","Togo",1976,9431000,3794000,"Japan",13225000,15.1489314294771,16.059512693526
"8808","Togo",1977,12347000,1352000,"Japan",13699000,14.117095535585,16.3289236765499
"8809","Togo",1978,12900000,1248000,"Japan",14148000,14.0370528279115,16.3727378693319
"8810","Togo",1979,17497000,2044000,"Japan",19541000,14.5304192303057,16.6775399956268
"8811","Togo",1980,24548000,881000,"Japan",25429000,13.6888129049183,17.0161409424911
"8812","Togo",1981,24327000,2997000,"Japan",27324000,14.9131223462988,17.0070974025948
"8813","Togo",1982,26279000,2476000,"Japan",28755000,14.7221549127866,17.0842806991063
"8814","Togo",1983,17917000,1825000,"Japan",19742000,14.4170905449987,16.701260540782
"8815","Togo",1984,15752831,965658,"Japan",16718489,13.7805650132416,16.5725306531153
"8816","Togo",1985,22988186,561067,"Japan",23549253,13.2375956069637,16.950490989755
"8817","Togo",1986,33816662,4630147,"Japan",38446809,15.3480991750185,17.336464197569
"8818","Togo",1987,27183110,5596365,"Japan",32779475,15.5376278378013,17.1181063825109
"8819","Togo",1988,24661865,1265422,"Japan",25927287,14.0509162213506,17.020768681389
"8820","Togo",1989,21341095,3200931,"Japan",24542026,14.9789522629558,16.8761451146114
"8821","Togo",1990,25916495,520523,"Japan",26437018,13.1625893543414,17.0703901965394
"8822","Togo",1991,30411609,554112,"Japan",30965721,13.2251221113616,17.2303349684808
"8823","Togo",1992,20766942,914762,"Japan",21681704,13.7264192011338,16.8488729534286
"8824","Togo",1993,6554395,428127,"Japan",6982522,12.9671751595206,15.6956463749631
"8825","Togo",1994,8936922,201752,"Japan",9138674,12.214794499342,16.0057017925644
"8826","Togo",1995,14464455,332478,"Japan",14796933,12.7143289714755,16.4872048185308
"8827","Togo",1996,13846387,59123,"Japan",13905510,10.9873752985836,16.4435348901401
"8828","Togo",1997,24131915,53224,"Japan",24185139,10.8822647014217,16.9990457962425
"8829","Togo",1998,22457000,0,"Japan",22457000,0,16.9271129275607
"8830","Togo",1999,21232616,135594,"Japan",21368210,11.8174204057219,16.8710490479441
"8831","Togo",2000,22061816,160256,"Japan",22222072,11.9845278155797,16.9093588893443
"8832","Togo",2001,21649447,115204,"Japan",21764651,11.6544597488633,16.8904904693614
"8833","Togo",2002,19416657,140583,"Japan",19557240,11.8535533406644,16.7816418638878
"8834","Togo",2003,19821052,625913,"Japan",20446965,13.3469666627882,16.8022551631568
"8835","Togo",2004,17149833,345508,"Japan",17495341,12.7527710767698,16.6574989939195
"8836","Togo",2005,13717950,69344,"Japan",13787294,11.1468349043361,16.4342157521886
"8837","Togo",2006,13387140,126397,"Japan",13513537,11.747183026236,16.4098051026203
"8838","Togo",2007,22393604,45485,"Japan",22439089,10.7251378802562,16.9242859403379
"8839","Togo",2008,22033747,61985,"Japan",22095732,11.0346476992722,16.9080857905615
"8840","Togo",2009,17501142,598621,"Japan",18099763,13.302383955643,16.6777766939074
"8841","Togo",2010,24227120,107417,"Japan",24334537,11.5844737353093,17.002983224812
"8842","Togo",2011,38527697,115640,"Japan",38643337,11.6582371961303,17.4668879432094
"8843","Togo",2012,49545035,52581,"Japan",49597616,10.8701101167413,17.7183926119034
"8844","Togo",2013,45164029,97969,"Japan",45261998,11.4924063810803,17.6258115093867
"8845","Togo",2014,32231585,129984,"Japan",32361569,11.7751666449401,17.2884574303671
"8846","Togo",2015,33052307,3403355,"Japan",36455662,15.04027226776,17.3136019251541
"8847","Togo",2016,42192278,3931700,"Japan",46123978,15.1845824602886,17.5577477764803
"8848","Togo",2017,42926991.5,64259,"Japan",42991250.5,11.0706770707685,17.5750113585464
"8849","Thailand",1962,161387000,71679000,"Japan",233066000,18.0877083756408,18.8993157653269
"8850","Thailand",1963,195455000,90721000,"Japan",286176000,18.3232994208107,19.0908407318663
"8851","Thailand",1964,225717000,130612000,"Japan",356329000,18.6877416541997,19.2347925601741
"8852","Thailand",1965,249508000,130785000,"Japan",380293000,18.6890653115122,19.3350015367701
"8853","Thailand",1966,323593000,153236000,"Japan",476829000,18.8474897746108,19.5949971112706
"8854","Thailand",1967,386850000,160045000,"Japan",546895000,18.8909655836547,19.7735475789597
"8855","Thailand",1968,397792000,147030000,"Japan",544822000,18.8061472055538,19.8014398135736
"8856","Thailand",1969,457499000,167431000,"Japan",624930000,18.9360818840602,19.9412852568851
"8857","Thailand",1970,485932000,189614000,"Japan",675546000,19.0605009847216,20.0015792543799
"8858","Thailand",1971,485249000,230088000,"Japan",715337000,19.2539724024071,20.0001727192179
"8859","Thailand",1972,548140000,252061000,"Japan",800201000,19.3451816796751,20.1220412867368
"8860","Thailand",1973,741095000,394160000,"Japan",1135255000,19.7922674762,20.423639380171
"8861","Thailand",1974,990492000,685140000,"Japan",1675632000,20.3451337549059,20.7137123473413
"8862","Thailand",1975,1034589000,723829000,"Japan",1758418000,20.4000657346079,20.7572700833488
"8863","Thailand",1976,1159266000,848043000,"Japan",2007309000,20.5584419000178,20.8710528831678
"8864","Thailand",1977,1493600000,748201000,"Japan",2241801000,20.4331822164185,21.1244551501918
"8865","Thailand",1978,1645669000,842659000,"Japan",2488328000,20.5520729264203,21.2214128254191
"8866","Thailand",1979,1843025000,1169402000,"Japan",3012427000,20.8797583439832,21.334674080382
"8867","Thailand",1980,1952469000,1119489000,"Japan",3071958000,20.8361381681397,21.3923605624714
"8868","Thailand",1981,2412452000,1061094000,"Japan",3473546000,20.7825662883184,21.6039094946064
"8869","Thailand",1982,2000855000,1040697000,"Japan",3041552000,20.7631565179288,21.4168404261543
"8870","Thailand",1983,2813925000,1018659000,"Japan",3832584000,20.7417528933762,21.7578461428314
"8871","Thailand",1984,2633509302,968946990,"Japan",3602456292,20.6917204624763,21.691583129063
"8872","Thailand",1985,2282384138,945309077,"Japan",3227693215,20.6670224975922,21.5484864081373
"8873","Thailand",1986,2238701862,1319155568,"Japan",3557857430,21.0002576476236,21.5291620089305
"8874","Thailand",1987,3071354360,1632973979,"Japan",4704328339,21.2136687163314,21.8453844608723
"8875","Thailand",1988,5329966257,2488442908,"Japan",7818409165,21.634923013665,22.3966107443349
"8876","Thailand",1989,7079779043,3266694456,"Japan",10346473499,21.9070444408574,22.6805085355492
"8877","Thailand",1990,9189649804,3754578459,"Japan",12944228263,22.0462418546091,22.9413436663856
"8878","Thailand",1991,9987023462,4751729566,"Japan",14738753028,22.2817745078756,23.0245524334587
"8879","Thailand",1992,10742689555,5386584513,"Japan",16129274068,22.4071773499554,23.0974913187917
"8880","Thailand",1993,12587816692,5864706873,"Japan",18452523565,22.4922183387747,23.2559952539199
"8881","Thailand",1994,14833662422,7422850353,"Japan",22256512775,22.7278289649702,23.4201649229572
"8882","Thailand",1995,19458897682,9126395215,"Japan",28585292897,22.9344366250009,23.6915702667761
"8883","Thailand",1996,18381804047,9193624631,"Japan",27575428678,22.941776105892,23.6346271017776
"8884","Thailand",1997,9173425631,7347622423,"Japan",16521048054,22.7176426179763,22.9395766228117
"8885","Thailand",1998,10156622000,7824035000,"Japan",17980657000,22.7804662430841,23.041391743498
"8886","Thailand",1999,11006237578,7995203104,"Japan",19001440682,22.8021075867871,23.1217280015767
"8887","Thailand",2000,13739073314,9555471229,"Japan",23294544543,22.9803797309527,23.3435096770702
"8888","Thailand",2001,12390829092,9319858070,"Japan",21710687162,22.9554132369872,23.2402224465714
"8889","Thailand",2002,13392379074,9464571163,"Japan",22856950237,22.9708213129215,23.3179516562965
"8890","Thailand",2003,16408799373,10711390057,"Japan",27120189430,23.0945735035536,23.5210835750208
"8891","Thailand",2004,20147921062,12821399435,"Japan",32969320497,23.2743814427778,23.7263669469147
"8892","Thailand",2005,23390159113,14043585892,"Japan",37433745005,23.3654316083468,23.8755812201273
"8893","Thailand",2006,23208118666,15207915336,"Japan",38416034002,23.4450818750471,23.8677679969031
"8894","Thailand",2007,26390740255,16225283488,"Japan",42616023743,23.5098365716798,23.9962790376556
"8895","Thailand",2008,30158929875,18405583614,"Japan",48564513489,23.6359199128101,24.1297468978585
"8896","Thailand",2009,22767222501,14218634616,"Japan",36985857117,23.377819238146,23.8485877289494
"8897","Thailand",2010,34354625837,18718947265,"Japan",53073573102,23.6528020705705,24.2600025142917
"8898","Thailand",2011,36438164078,23834465362,"Japan",60272629440,23.8943984945566,24.3188825260163
"8899","Thailand",2012,42378797196,22924506520,"Japan",65303303716,23.8554723290121,24.4699140079775
"8900","Thailand",2013,34745072365,21494281201,"Japan",56239353566,23.7910527460471,24.2713035964563
"8901","Thailand",2014,30123198141,21341697802,"Japan",51464895943,23.7839286392617,24.1285614142215
"8902","Thailand",2015,26737604947,19890177382,"Japan",46627782329,23.7134918479223,24.0093368364337
"8903","Thailand",2016,26246197451,19749088916,"Japan",45995286367,23.706373196394,23.9907869564814
"8904","Thailand",2017,0,0,"0",0,0,0
"8905","Tajikistan",1962,0,0,"0",0,0,0
"8906","Tajikistan",1963,0,0,"0",0,0,0
"8907","Tajikistan",1964,0,0,"0",0,0,0
"8908","Tajikistan",1965,0,0,"0",0,0,0
"8909","Tajikistan",1966,0,0,"0",0,0,0
"8910","Tajikistan",1967,0,0,"0",0,0,0
"8911","Tajikistan",1968,0,0,"0",0,0,0
"8912","Tajikistan",1969,0,0,"0",0,0,0
"8913","Tajikistan",1970,0,0,"0",0,0,0
"8914","Tajikistan",1971,0,0,"0",0,0,0
"8915","Tajikistan",1972,0,0,"0",0,0,0
"8916","Tajikistan",1973,0,0,"0",0,0,0
"8917","Tajikistan",1974,0,0,"0",0,0,0
"8918","Tajikistan",1975,0,0,"0",0,0,0
"8919","Tajikistan",1976,0,0,"0",0,0,0
"8920","Tajikistan",1977,0,0,"0",0,0,0
"8921","Tajikistan",1978,0,0,"0",0,0,0
"8922","Tajikistan",1979,0,0,"0",0,0,0
"8923","Tajikistan",1980,0,0,"0",0,0,0
"8924","Tajikistan",1981,0,0,"0",0,0,0
"8925","Tajikistan",1982,0,0,"0",0,0,0
"8926","Tajikistan",1983,0,0,"0",0,0,0
"8927","Tajikistan",1984,0,0,"0",0,0,0
"8928","Tajikistan",1985,0,0,"0",0,0,0
"8929","Tajikistan",1986,0,0,"0",0,0,0
"8930","Tajikistan",1987,0,0,"0",0,0,0
"8931","Tajikistan",1988,0,0,"0",0,0,0
"8932","Tajikistan",1989,0,0,"0",0,0,0
"8933","Tajikistan",1990,0,0,"0",0,0,0
"8934","Tajikistan",1991,0,0,"0",0,0,0
"8935","Tajikistan",1992,751134,9963247,"Japan",10714381,16.1144135804491,13.5293393435914
"8936","Tajikistan",1993,377457,10235092,"Japan",10612549,16.1413327658012,12.8412119338985
"8937","Tajikistan",1994,994580,14869734,"Japan",15864314,16.5148384299105,13.8100758164742
"8938","Tajikistan",1995,384018,18071158,"Japan",18455176,16.7098277446324,12.8584447054713
"8939","Tajikistan",1996,1343729,2479596,"Japan",3823325,14.7236062016452,14.110959142829
"8940","Tajikistan",1997,5306749,54379,"Japan",5361128,10.9037333289037,15.4844899646674
"8941","Tajikistan",1998,5041000,0,"Japan",5041000,0,15.4331150330648
"8942","Tajikistan",1999,3089161,162647,"Japan",3251808,11.9993374872186,14.9434100909698
"8943","Tajikistan",2000,1418170,490545,"Japan",1908715,13.1032722968987,14.1648778660533
"8944","Tajikistan",2001,476706,115424,"Japan",592130,11.6563675837033,13.0746552276461
"8945","Tajikistan",2002,1038404,1642479,"Japan",2680883,14.311717243871,13.8531954770047
"8946","Tajikistan",2003,438906,6426829,"Japan",6865735,15.6759918174957,12.9920405461229
"8947","Tajikistan",2004,447720,7718684,"Japan",8166404,15.8591544411487,13.0119233160032
"8948","Tajikistan",2005,1661699,3729786,"Japan",5391485,15.13186141732,14.3233511308958
"8949","Tajikistan",2006,547359,1267288,"Japan",1814647,14.0523897420756,13.2128601732586
"8950","Tajikistan",2007,3201819,252824,"Japan",3454643,12.4404488734575,14.9792296437706
"8951","Tajikistan",2008,1746827,5306,"Japan",1752133,8.57659353469768,14.3733115573094
"8952","Tajikistan",2009,8786000,3419,"Japan",8789419,8.1371033896393,15.9886701035179
"8953","Tajikistan",2010,1370789,23858647,"Japan",25229436,16.9876572672425,14.1308970444392
"8954","Tajikistan",2011,846915,13051465,"Japan",13898380,16.3844109459686,13.6493556144071
"8955","Tajikistan",2012,7447154,10871241,"Japan",18318395,16.2016314200141,15.8233425039472
"8956","Tajikistan",2013,1339798,1114023,"Japan",2453821,13.9234883455758,14.1080294142951
"8957","Tajikistan",2014,14160345,1337911,"Japan",15498256,14.1066200002681,16.4659560103398
"8958","Tajikistan",2015,5286892,2230141,"Japan",7517033,14.617575370137,15.4807411075454
"8959","Tajikistan",2016,3574868,1161945,"Japan",4736813,13.9656058830879,15.0894388103516
"8960","Tajikistan",2017,0,0,"0",0,0,0
"8961","Turkmenistan",1962,0,0,"0",0,0,0
"8962","Turkmenistan",1963,0,0,"0",0,0,0
"8963","Turkmenistan",1964,0,0,"0",0,0,0
"8964","Turkmenistan",1965,0,0,"0",0,0,0
"8965","Turkmenistan",1966,0,0,"0",0,0,0
"8966","Turkmenistan",1967,0,0,"0",0,0,0
"8967","Turkmenistan",1968,0,0,"0",0,0,0
"8968","Turkmenistan",1969,0,0,"0",0,0,0
"8969","Turkmenistan",1970,0,0,"0",0,0,0
"8970","Turkmenistan",1971,0,0,"0",0,0,0
"8971","Turkmenistan",1972,0,0,"0",0,0,0
"8972","Turkmenistan",1973,0,0,"0",0,0,0
"8973","Turkmenistan",1974,0,0,"0",0,0,0
"8974","Turkmenistan",1975,0,0,"0",0,0,0
"8975","Turkmenistan",1976,0,0,"0",0,0,0
"8976","Turkmenistan",1977,0,0,"0",0,0,0
"8977","Turkmenistan",1978,0,0,"0",0,0,0
"8978","Turkmenistan",1979,0,0,"0",0,0,0
"8979","Turkmenistan",1980,0,0,"0",0,0,0
"8980","Turkmenistan",1981,0,0,"0",0,0,0
"8981","Turkmenistan",1982,0,0,"0",0,0,0
"8982","Turkmenistan",1983,0,0,"0",0,0,0
"8983","Turkmenistan",1984,0,0,"0",0,0,0
"8984","Turkmenistan",1985,0,0,"0",0,0,0
"8985","Turkmenistan",1986,0,0,"0",0,0,0
"8986","Turkmenistan",1987,0,0,"0",0,0,0
"8987","Turkmenistan",1988,0,0,"0",0,0,0
"8988","Turkmenistan",1989,0,0,"0",0,0,0
"8989","Turkmenistan",1990,0,0,"0",0,0,0
"8990","Turkmenistan",1991,0,0,"0",0,0,0
"8991","Turkmenistan",1992,6394240,2253953,"Japan",8648193,14.6281961215455,15.6709081430867
"8992","Turkmenistan",1993,8330821,4620538,"Japan",12951359,15.3460217064946,15.9354725687101
"8993","Turkmenistan",1994,5789898,4334535,"Japan",10124433,15.2821248960073,15.5716252328137
"8994","Turkmenistan",1995,8207337,6281828,"Japan",14489165,15.6531715788906,15.9205390682764
"8995","Turkmenistan",1996,7614105,3298793,"Japan",10912898,15.0090672019553,15.8455130062156
"8996","Turkmenistan",1997,7870499,40811,"Japan",7911310,10.6167069318977,15.8786320237203
"8997","Turkmenistan",1998,7126000,0,"Japan",7126000,0,15.7792606251479
"8998","Turkmenistan",1999,14080999,275878,"Japan",14356877,12.5277140179902,16.4603368578818
"8999","Turkmenistan",2000,55817944,645119,"Japan",56463063,13.3771900748846,17.8376059527176
"9000","Turkmenistan",2001,32435281,375680,"Japan",32810961,12.8364929961818,17.2947573080726
"9001","Turkmenistan",2002,5318294,796199,"Japan",6114493,13.5876044335817,15.4866631331983
"9002","Turkmenistan",2003,26118500,2230353,"Japan",28348853,14.6176704268729,17.0781544334647
"9003","Turkmenistan",2004,51516489,178494,"Japan",51694983,12.0923102661915,17.7574124891462
"9004","Turkmenistan",2005,15102833,6340,"Japan",15109173,8.75463404743127,16.5303929000815
"9005","Turkmenistan",2006,52206153,93386,"Japan",52299539,11.4444967200482,17.7707109194695
"9006","Turkmenistan",2007,91744702,66612,"Japan",91811314,11.1066400204782,18.3345202993625
"9007","Turkmenistan",2008,74308824,1872592,"Japan",76181416,14.4428341253428,18.1237402644129
"9008","Turkmenistan",2009,25633682,121405,"Japan",25755087,11.7068873429209,17.0594177477959
"9009","Turkmenistan",2010,23080685,177016,"Japan",23257701,12.0839954029508,16.9545066785398
"9010","Turkmenistan",2011,271373656,685523,"Japan",272059179,13.4379373295734,19.419007233594
"9011","Turkmenistan",2012,119931294,16470,"Japan",119947764,9.70929582317169,18.602429586777
"9012","Turkmenistan",2013,53787194,37123,"Japan",53824317,10.5219920026,17.8005459670587
"9013","Turkmenistan",2014,59616710,59143,"Japan",59675853,10.9877135192082,17.903446461867
"9014","Turkmenistan",2015,26683379,86680,"Japan",26770059,11.3699784556503,17.0995514201678
"9015","Turkmenistan",2016,397205304,108543,"Japan",397313847,11.5949016868153,19.7999638435205
"9016","Turkmenistan",2017,0,0,"0",0,0,0
"9017","East Timor",1962,0,0,"0",0,0,0
"9018","East Timor",1963,0,0,"0",0,0,0
"9019","East Timor",1964,0,0,"0",0,0,0
"9020","East Timor",1965,0,0,"0",0,0,0
"9021","East Timor",1966,0,0,"0",0,0,0
"9022","East Timor",1967,0,0,"0",0,0,0
"9023","East Timor",1968,0,0,"0",0,0,0
"9024","East Timor",1969,0,0,"0",0,0,0
"9025","East Timor",1970,0,0,"0",0,0,0
"9026","East Timor",1971,0,0,"0",0,0,0
"9027","East Timor",1972,0,0,"0",0,0,0
"9028","East Timor",1973,0,0,"0",0,0,0
"9029","East Timor",1974,0,0,"0",0,0,0
"9030","East Timor",1975,0,0,"0",0,0,0
"9031","East Timor",1976,0,0,"0",0,0,0
"9032","East Timor",1977,0,0,"0",0,0,0
"9033","East Timor",1978,0,0,"0",0,0,0
"9034","East Timor",1979,0,0,"0",0,0,0
"9035","East Timor",1980,0,0,"0",0,0,0
"9036","East Timor",1981,0,0,"0",0,0,0
"9037","East Timor",1982,0,0,"0",0,0,0
"9038","East Timor",1983,0,0,"0",0,0,0
"9039","East Timor",1984,0,0,"0",0,0,0
"9040","East Timor",1985,0,0,"0",0,0,0
"9041","East Timor",1986,0,0,"0",0,0,0
"9042","East Timor",1987,0,0,"0",0,0,0
"9043","East Timor",1988,0,0,"0",0,0,0
"9044","East Timor",1989,0,0,"0",0,0,0
"9045","East Timor",1990,0,0,"0",0,0,0
"9046","East Timor",1991,0,0,"0",0,0,0
"9047","East Timor",1992,0,0,"0",0,0,0
"9048","East Timor",1993,0,0,"0",0,0,0
"9049","East Timor",1994,0,0,"0",0,0,0
"9050","East Timor",1995,0,0,"0",0,0,0
"9051","East Timor",1996,0,0,"0",0,0,0
"9052","East Timor",1997,0,0,"0",0,0,0
"9053","East Timor",1998,0,0,"0",0,0,0
"9054","East Timor",1999,0,0,"0",0,0,0
"9055","East Timor",2000,0,0,"0",0,0,0
"9056","East Timor",2001,0,0,"0",0,0,0
"9057","East Timor",2002,0,0,"0",0,0,0
"9058","East Timor",2003,0,0,"0",0,0,0
"9059","East Timor",2004,0,0,"0",0,0,0
"9060","East Timor",2005,0,0,"0",0,0,0
"9061","East Timor",2006,0,0,"0",0,0,0
"9062","East Timor",2007,0,0,"0",0,0,0
"9063","East Timor",2008,0,0,"0",0,0,0
"9064","East Timor",2009,0,0,"0",0,0,0
"9065","East Timor",2010,0,0,"0",0,0,0
"9066","East Timor",2011,0,0,"0",0,0,0
"9067","East Timor",2012,0,0,"0",0,0,0
"9068","East Timor",2013,0,0,"0",0,0,0
"9069","East Timor",2014,0,0,"0",0,0,0
"9070","East Timor",2015,0,0,"0",0,0,0
"9071","East Timor",2016,0,0,"0",0,0,0
"9072","East Timor",2017,0,0,"0",0,0,0
"9073","Trinidad and Tobago",1962,4412000,536000,"Japan",4948000,13.1918894400529,15.2998386593555
"9074","Trinidad and Tobago",1963,3454000,87000,"Japan",3541000,11.3736633976367,15.0550435376888
"9075","Trinidad and Tobago",1964,4504000,406000,"Japan",4910000,12.9141084385839,15.3204764488017
"9076","Trinidad and Tobago",1965,5149000,481000,"Japan",5630000,13.0836225490879,15.4543130790283
"9077","Trinidad and Tobago",1966,6316000,843000,"Japan",7159000,13.644722236984,15.6585966543577
"9078","Trinidad and Tobago",1967,6777000,1752000,"Japan",8529000,14.3762685504785,15.7290450841182
"9079","Trinidad and Tobago",1968,6085000,2135000,"Japan",8220000,14.5739772046449,15.6213372844038
"9080","Trinidad and Tobago",1969,10007000,1504000,"Japan",11511000,14.2236387834919,16.1187954060726
"9081","Trinidad and Tobago",1970,13454000,2050000,"Japan",15504000,14.5333503511146,16.4147870175677
"9082","Trinidad and Tobago",1971,22039000,2342000,"Japan",24381000,14.6665158231398,16.9083241691688
"9083","Trinidad and Tobago",1972,25664000,2136000,"Japan",27800000,14.5744454790622,17.0605997896484
"9084","Trinidad and Tobago",1973,23562000,2804000,"Japan",26366000,14.8465575271366,16.9751458027882
"9085","Trinidad and Tobago",1974,30897000,7354000,"Japan",38251000,15.8107549408434,17.246169649776
"9086","Trinidad and Tobago",1975,51503000,687000,"Japan",52190000,13.4400895712045,17.7571506163645
"9087","Trinidad and Tobago",1976,55344000,4259000,"Japan",59603000,15.2645449489053,17.8290788101591
"9088","Trinidad and Tobago",1977,82221000,4334000,"Japan",86555000,15.2820014610784,18.2249213018509
"9089","Trinidad and Tobago",1978,108549000,2170000,"Japan",110719000,14.5902377255166,18.5027122419016
"9090","Trinidad and Tobago",1979,202428000,11561000,"Japan",213989000,16.2631479226575,19.1258948257304
"9091","Trinidad and Tobago",1980,211780000,17221000,"Japan",229001000,16.661640127287,19.1710585579666
"9092","Trinidad and Tobago",1981,200269000,7130000,"Japan",207399000,15.7798217923905,19.11517202081
"9093","Trinidad and Tobago",1982,265541000,9437000,"Japan",274978000,16.0601486910035,19.3972798123359
"9094","Trinidad and Tobago",1983,241085000,6791000,"Japan",247876000,15.7311087640959,19.3006601263674
"9095","Trinidad and Tobago",1984,168738050,5115372,"Japan",173853422,15.4477606819961,18.9438580703946
"9096","Trinidad and Tobago",1985,115130490,3935520,"Japan",119066010,15.1855535784981,18.5615767386992
"9097","Trinidad and Tobago",1986,99616670,15613085,"Japan",115229755,16.56361990269,18.416840078028
"9098","Trinidad and Tobago",1987,59229333,30518688,"Japan",89748021,17.2338497752521,17.8969274670045
"9099","Trinidad and Tobago",1988,32897268,20363383,"Japan",53260651,16.8292488949793,17.308900172774
"9100","Trinidad and Tobago",1989,25540520,10198580,"Japan",35739100,16.1377590528768,17.0557767685807
"9101","Trinidad and Tobago",1990,36470331,10774446,"Japan",47244777,16.192687777319,17.4120096386965
"9102","Trinidad and Tobago",1991,82037970,31874895,"Japan",113912865,17.2773292673198,18.222692746835
"9103","Trinidad and Tobago",1992,81741971,26789060,"Japan",108531031,17.1035041531859,18.219078148851
"9104","Trinidad and Tobago",1993,50028506,39786513,"Japan",89815019,17.4990385434787,17.7281035209358
"9105","Trinidad and Tobago",1994,37690331,9423297,"Japan",47113628,16.0586955853168,17.4449141473751
"9106","Trinidad and Tobago",1995,48760819,18148842,"Japan",66909661,16.7141173149868,17.7024376589908
"9107","Trinidad and Tobago",1996,71941265,13785722,"Japan",85726987,16.4391439768392,18.091360580175
"9108","Trinidad and Tobago",1997,131891701,4124771,"Japan",136016472,15.2325210610584,18.6974916968301
"9109","Trinidad and Tobago",1998,105611000,4441000,"Japan",110052000,15.3063901342742,18.4752730904781
"9110","Trinidad and Tobago",1999,126989536,7038482,"Japan",134028018,15.7669030798838,18.6596152473275
"9111","Trinidad and Tobago",2000,85622652,2338456,"Japan",87961108,14.6650014404911,18.2654604322729
"9112","Trinidad and Tobago",2001,105224873,7641081,"Japan",112865954,15.8490496432802,18.4716102656827
"9113","Trinidad and Tobago",2002,107913971,2147783,"Japan",110061754,14.579946705299,18.4968449028474
"9114","Trinidad and Tobago",2003,144273756,12725043,"Japan",156998799,16.35908249957,18.7872231361017
"9115","Trinidad and Tobago",2004,173857187,15658007,"Japan",189515194,16.5664929735057,18.9737447557995
"9116","Trinidad and Tobago",2005,203527840,3252758,"Japan",206780598,14.9950138098201,19.1313133593867
"9117","Trinidad and Tobago",2006,202799461,178451795,"Japan",381251256,18.9998290666899,19.1277281718868
"9118","Trinidad and Tobago",2007,224586965,212738762,"Japan",437325727,19.1755755014609,19.2297735620751
"9119","Trinidad and Tobago",2008,323202791,387004457,"Japan",710207248,19.7739467677236,19.5937905200937
"9120","Trinidad and Tobago",2009,112684639,48728234,"Japan",161412873,17.7017691736541,18.5401036698091
"9121","Trinidad and Tobago",2010,163735932,56661093,"Japan",220397025,17.8525983426854,18.9137655173387
"9122","Trinidad and Tobago",2011,178660596,192109166,"Japan",370769762,19.0735743413324,19.0009984521778
"9123","Trinidad and Tobago",2012,190709584,187772961,"Japan",378482545,19.0507441367369,19.0662623262559
"9124","Trinidad and Tobago",2013,227545322,234829001,"Japan",462374323,19.2743681519197,19.2428599940965
"9125","Trinidad and Tobago",2014,206057558,106672612,"Japan",312730170,18.4852750010367,19.1436660954938
"9126","Trinidad and Tobago",2015,225882383,55595283,"Japan",281477666,17.8336089174924,19.2355249925627
"9127","Trinidad and Tobago",2016,156370320,76193146,"Japan",232563466,18.1487820691048,18.8677375982459
"9128","Trinidad and Tobago",2017,0,0,"0",0,0,0
"9129","Tunisia",1962,1143000,723000,"Japan",1866000,13.4911645011409,13.9491669427769
"9130","Tunisia",1963,1020000,1350000,"Japan",2370000,14.1156151504146,13.8353131852605
"9131","Tunisia",1964,410000,671000,"Japan",1081000,13.4165244159538,12.9239124386805
"9132","Tunisia",1965,986000,758000,"Japan",1744000,13.5384386646245,13.8014116335848
"9133","Tunisia",1966,286000,1128000,"Japan",1414000,13.9359567110401,12.563747089802
"9134","Tunisia",1967,217000,591000,"Japan",808000,13.2895712963882,12.2876526325226
"9135","Tunisia",1968,286000,485000,"Japan",771000,13.0919041699196,12.563747089802
"9136","Tunisia",1969,428000,195000,"Japan",623000,12.1807548375459,12.9668784745639
"9137","Tunisia",1970,825000,50000,"Japan",875000,10.8197782844103,13.6231386653168
"9138","Tunisia",1971,1096000,86000,"Japan",1182000,11.3621025752356,13.9071777464901
"9139","Tunisia",1972,3742000,102000,"Japan",3844000,11.5327280922664,15.1351307858162
"9140","Tunisia",1973,6196000,94000,"Japan",6290000,11.4510500612521,15.6394144805189
"9141","Tunisia",1974,5949000,533000,"Japan",6482000,13.186276703148,15.59873369617
"9142","Tunisia",1975,11444000,402000,"Japan",11846000,12.9042073676012,16.2529761331521
"9143","Tunisia",1976,22217000,1931000,"Japan",24148000,14.4735485614107,16.9163683195593
"9144","Tunisia",1977,21626000,759000,"Japan",22385000,13.5397570563778,16.8894068524876
"9145","Tunisia",1978,15779000,1057000,"Japan",16836000,13.8709452648524,16.5741905000178
"9146","Tunisia",1979,19434000,534000,"Japan",19968000,13.1881511179423,16.7825346673815
"9147","Tunisia",1980,41121000,997000,"Japan",42118000,13.812506048944,17.5320294978816
"9148","Tunisia",1981,114539000,884000,"Japan",115423000,13.6922123416198,18.5564259343174
"9149","Tunisia",1982,66597000,951000,"Japan",67548000,13.7652693415275,18.014170089451
"9150","Tunisia",1983,54947000,2689000,"Japan",57636000,14.804679935251,17.8218796422371
"9151","Tunisia",1984,157513918,1671670,"Japan",159185588,14.329333684726,18.8750243805797
"9152","Tunisia",1985,48026870,3484173,"Japan",51511043,15.06374127129,17.6872712039139
"9153","Tunisia",1986,42347227,2124186,"Japan",44471413,14.5688992281314,17.5614134987603
"9154","Tunisia",1987,25264101,9671035,"Japan",34935136,16.0846458937599,17.044895013253
"9155","Tunisia",1988,45144703,16800396,"Japan",61945099,16.6369130155243,17.6253835109004
"9156","Tunisia",1989,56174276,49766455,"Japan",105940731,17.7228517206508,17.8439694876571
"9157","Tunisia",1990,90569445,17435273,"Japan",108004718,16.6740058961282,18.3216274624755
"9158","Tunisia",1991,110029533,26342450,"Japan",136371983,17.0866922643806,18.5162593695401
"9159","Tunisia",1992,134056469,13010947,"Japan",147067416,16.381301638001,18.7137716795945
"9160","Tunisia",1993,132347045,11910710,"Japan",144257755,16.2929485533246,18.7009381592253
"9161","Tunisia",1994,136941161,17303702,"Japan",154244863,16.6664310250151,18.7350619097869
"9162","Tunisia",1995,127334506,17583485,"Japan",144917991,16.6824706672076,18.6623280872844
"9163","Tunisia",1996,148084989,21659607,"Japan",169744596,16.8909596553282,18.81329691691
"9164","Tunisia",1997,157696739,16586642,"Japan",174283381,16.6241082305877,18.876184373216
"9165","Tunisia",1998,170053000,17787000,"Japan",187840000,16.6939784113576,18.9516207111319
"9166","Tunisia",1999,188896636,18415360,"Japan",207311996,16.7286956569507,19.056710523949
"9167","Tunisia",2000,156918689,20388399,"Japan",177307088,16.8304766205861,18.8712383246951
"9168","Tunisia",2001,153788186,21190840,"Japan",174979026,16.869079570799,18.8510867980413
"9169","Tunisia",2002,143299728,20337830,"Japan",163637558,16.8279932565609,18.7804489946808
"9170","Tunisia",2003,178750948,32109900,"Japan",210860848,17.2846749517662,19.0015040430208
"9171","Tunisia",2004,234516646,55163795,"Japan",289680441,17.8258174083777,19.2730371284059
"9172","Tunisia",2005,197112601,57381362,"Japan",254493963,17.8652301047293,19.0992857020936
"9173","Tunisia",2006,226822664,68046500,"Japan",294869164,18.035701852969,19.2396790542785
"9174","Tunisia",2007,260071984,94809233,"Japan",354881217,18.3673773569975,19.3764690121992
"9175","Tunisia",2008,284752675,152467983,"Japan",437220658,18.8424651844287,19.4671315544529
"9176","Tunisia",2009,203263323,130144259,"Japan",333407582,18.6841540777904,19.1300128540594
"9177","Tunisia",2010,271870077,105272666,"Japan",377142743,18.4720643612607,19.4208348520571
"9178","Tunisia",2011,100819370,156592303,"Japan",257411673,18.8691561896106,18.4288410578391
"9179","Tunisia",2012,110983390,135602190,"Japan",246585580,18.7252360837826,18.5248911084398
"9180","Tunisia",2013,87360073,123302317,"Japan",210662390,18.6301497595233,18.2855489055832
"9181","Tunisia",2014,91832903,124178287,"Japan",216011190,18.637228889314,18.3354812118527
"9182","Tunisia",2015,80736780,97022782,"Japan",177759562,18.3904563748703,18.206704791494
"9183","Tunisia",2016,86478990,92366779,"Japan",178845769,18.3412779373318,18.2754120522261
"9184","Tunisia",2017,136765443,55941411.5,"Japan",192706854.5,17.8398154778116,18.7337779215924
"9185","Turkey",1962,16729000,2527000,"Japan",19256000,14.7425433863703,16.6326542983134
"9186","Turkey",1963,16029000,3571000,"Japan",19600000,15.0883562265766,16.589910139608
"9187","Turkey",1964,6853000,3868000,"Japan",10721000,15.1682481355553,15.740197070568
"9188","Turkey",1965,9372000,3719000,"Japan",13091000,15.1289653729072,16.0532370786098
"9189","Turkey",1966,15694000,8868000,"Japan",24562000,15.9979598497183,16.5687890316696
"9190","Turkey",1967,16925000,26614000,"Japan",43539000,17.0969479510858,16.6443023767626
"9191","Turkey",1968,11746000,27708000,"Japan",39454000,17.1372317381246,16.2790233150646
"9192","Turkey",1969,8757000,17840000,"Japan",26597000,16.6969536851161,15.9853639385044
"9193","Turkey",1970,25420000,28351000,"Japan",53771000,17.1601728608846,17.0510468237256
"9194","Turkey",1971,25105000,22518000,"Japan",47623000,16.9298255473452,17.0385775874509
"9195","Turkey",1972,32459000,20546000,"Japan",53005000,16.8381768327583,17.2954883124289
"9196","Turkey",1973,58920000,28401000,"Japan",87321000,17.1619349137791,17.8916911495587
"9197","Turkey",1974,198887000,33464000,"Japan",232351000,17.3259807921042,19.1082473822111
"9198","Turkey",1975,210887000,42328000,"Japan",253215000,17.5609593635661,19.1668330029612
"9199","Turkey",1976,227004000,55929000,"Japan",282933000,17.8395935871457,19.2404781964358
"9200","Turkey",1977,310727000,43113000,"Japan",353840000,17.5793351337245,19.5544252711348
"9201","Turkey",1978,113390000,48081000,"Japan",161471000,17.6883976466438,18.546343761948
"9202","Turkey",1979,221662000,40250000,"Japan",261912000,17.5106205618288,19.2166642570988
"9203","Turkey",1980,109844000,39426000,"Japan",149270000,17.4899360551081,18.5145717353669
"9204","Turkey",1981,204229000,45747000,"Japan",249976000,17.6386367737653,19.1347524712411
"9205","Turkey",1982,355372000,40359000,"Japan",395731000,17.5133249761358,19.688675686113
"9206","Turkey",1983,483204000,53660000,"Japan",536864000,17.7981784029618,19.9959494826963
"9207","Turkey",1984,306774741,44316166,"Japan",351090907,17.6068600894411,19.5416242935596
"9208","Turkey",1985,433609807,53898457,"Japan",487508264,17.8026124083823,19.8876556254539
"9209","Turkey",1986,663238381,93998557,"Japan",757236938,18.3587899890526,20.3126450325475
"9210","Turkey",1987,569791618,183911222,"Japan",753702840,19.0299637100075,20.1607812694952
"9211","Turkey",1988,557757047,297074285,"Japan",854831332,19.5094927833378,20.1394340258901
"9212","Turkey",1989,479038654,214454206,"Japan",693492860,19.1836067816982,19.9872918494054
"9213","Turkey",1990,1018587375,240850176,"Japan",1259437551,19.2996856217855,20.741682577875
"9214","Turkey",1991,989176374,282645737,"Japan",1271822111,19.4597048587146,20.7123832093797
"9215","Turkey",1992,1009058444,183969931,"Japan",1193028375,19.0302828837407,20.7322834993362
"9216","Turkey",1993,1471927656,159823176,"Japan",1631750832,18.8895786120695,21.1098387093062
"9217","Turkey",1994,883878103,198676899,"Japan",1082555002,19.1071904400687,20.5998297185599
"9218","Turkey",1995,1271489265,214729307,"Japan",1486218572,19.1848887556294,20.9634547000067
"9219","Turkey",1996,1279206656,218445505,"Japan",1497652161,19.202047136359,20.9695059227225
"9220","Turkey",1997,1847960089,131262805,"Japan",1979222894,18.6927120165819,21.3373482130712
"9221","Turkey",1998,2040967000,133370000,"Japan",2174337000,18.7086377785986,21.4366895520986
"9222","Turkey",1999,1261453243,150593686,"Japan",1412046929,18.8300959468204,20.9555302607528
"9223","Turkey",2000,1443642366,156414009,"Japan",1600056375,18.8680169536754,21.090435177767
"9224","Turkey",2001,1186374518,141623193,"Japan",1327997711,18.7686805181843,20.8941678701352
"9225","Turkey",2002,1314144915,151686350,"Japan",1465831265,18.8373254600462,20.996452036316
"9226","Turkey",2003,1739172651,191554259,"Japan",1930726910,19.0706816632673,21.2766753491616
"9227","Turkey",2004,2432937608,251075122,"Japan",2684012730,19.3412627431541,21.6123652563582
"9228","Turkey",2005,2840502870,255998758,"Japan",3096501628,19.3606831508696,21.7672469403464
"9229","Turkey",2006,2886666820,324278387,"Japan",3210945207,19.597112923975,21.7833683239704
"9230","Turkey",2007,3229237533,385998581,"Japan",3615236114,19.7713442512565,21.8955118884202
"9231","Turkey",2008,3504494885,378230104,"Japan",3882724989,19.7510133091171,21.9773122343516
"9232","Turkey",2009,2411504665,361716918,"Japan",2773221583,19.7063724693977,21.603516731952
"9233","Turkey",2010,2819997726,363949212,"Japan",3183946938,19.7125248883936,21.7600019155131
"9234","Turkey",2011,2896059236,516348420,"Japan",3412407656,20.062292328137,21.7866167656806
"9235","Turkey",2012,2170360073,574402491,"Japan",2744762564,20.168840912388,21.4981589229916
"9236","Turkey",2013,2286805748,582238434,"Japan",2869044182,20.182390602212,21.550421810907
"9237","Turkey",2014,2062292891,663290871,"Japan",2725583762,20.3127241713979,21.4470842546462
"9238","Turkey",2015,2052635111,626145859,"Japan",2678780970,20.2550939035212,21.4423902246517
"9239","Turkey",2016,2790999102,563279651,"Japan",3354278753,20.1492867785897,21.7496654697521
"9240","Turkey",2017,3777325708,565000656.5,"Japan",4342326364.5,20.1523374510569,22.0522821115364
"9241","Taiwan",1962,95944000,67383000,"Japan",163327000,18.025903318549,18.3792752458937
"9242","Taiwan",1963,99171000,130831000,"Japan",230002000,18.6894169719647,18.4123561908061
"9243","Taiwan",1964,133419000,150083000,"Japan",283502000,18.8266990323614,18.7090051100894
"9244","Taiwan",1965,193079000,158376000,"Japan",351455000,18.8804825107135,19.0786099895428
"9245","Taiwan",1966,238881000,148196000,"Japan",387077000,18.8140462799087,19.2914760779487
"9246","Taiwan",1967,326865000,137098000,"Japan",463963000,18.7362065565341,19.6050577995813
"9247","Taiwan",1968,362710000,151098000,"Japan",513808000,18.833439190888,19.7091141748684
"9248","Taiwan",1969,537366000,180562000,"Japan",717928000,19.0115847670626,20.1021899845595
"9249","Taiwan",1970,654294000,250789000,"Japan",905083000,19.3401225061121,20.2990673496925
"9250","Taiwan",1971,829061000,286883000,"Japan",1115944000,19.4745850251005,20.5358042930222
"9251","Taiwan",1972,1090699000,421864000,"Japan",1512563000,19.8601935451771,20.8100846120562
"9252","Taiwan",1973,1642159000,887797000,"Japan",2529956000,20.6042536712191,21.219277676419
"9253","Taiwan",1974,2000606000,952862000,"Japan",2953468000,20.6749806452569,21.4167159716111
"9254","Taiwan",1975,1823997000,812107000,"Japan",2636104000,20.5151426628436,21.3242960838604
"9255","Taiwan",1976,2278834000,1189834000,"Japan",3468668000,20.8970796385411,21.5469297455926
"9256","Taiwan",1977,2551776000,1288670000,"Japan",3840446000,20.976876515714,21.6600554242819
"9257","Taiwan",1978,3583542000,1750156000,"Japan",5333698000,21.282970763766,21.9996175337147
"9258","Taiwan",1979,4365480000,2475630000,"Japan",6841110000,21.6297607460304,22.1969939858279
"9259","Taiwan",1980,5142272000,2293366000,"Japan",7435638000,21.5532864443082,22.3607608420962
"9260","Taiwan",1981,5400401000,2522497000,"Japan",7922898000,21.648515120895,22.4097390470188
"9261","Taiwan",1982,4252266000,2443115000,"Japan",6695381000,21.6165397013847,22.1707178542653
"9262","Taiwan",1983,5080610000,2622320000,"Japan",7702930000,21.6873252590822,22.3486971700681
"9263","Taiwan",1984,0,0,"0",0,0,0
"9264","Taiwan",1985,0,0,"0",0,0,0
"9265","Taiwan",1986,0,0,"0",0,0,0
"9266","Taiwan",1987,0,0,"0",0,0,0
"9267","Taiwan",1988,0,0,"0",0,0,0
"9268","Taiwan",1989,0,0,"0",0,0,0
"9269","Taiwan",1990,0,0,"0",0,0,0
"9270","Taiwan",1991,0,0,"0",0,0,0
"9271","Taiwan",1992,0,0,"0",0,0,0
"9272","Taiwan",1993,0,0,"0",0,0,0
"9273","Taiwan",1994,0,0,"0",0,0,0
"9274","Taiwan",1995,0,0,"0",0,0,0
"9275","Taiwan",1996,0,0,"0",0,0,0
"9276","Taiwan",1997,0,0,"0",0,0,0
"9277","Taiwan",1998,27508500000,9766051000,"Japan",37274551000,23.0021780247717,24.0377608847693
"9278","Taiwan",1999,0,0,"0",0,0,0
"9279","Taiwan",2000,0,0,"0",0,0,0
"9280","Taiwan",2001,0,0,"0",0,0,0
"9281","Taiwan",2002,0,0,"0",0,0,0
"9282","Taiwan",2003,0,0,"0",0,0,0
"9283","Taiwan",2004,0,0,"0",0,0,0
"9284","Taiwan",2005,0,0,"0",0,0,0
"9285","Taiwan",2006,0,0,"0",0,0,0
"9286","Taiwan",2007,0,0,"0",0,0,0
"9287","Taiwan",2008,0,0,"0",0,0,0
"9288","Taiwan",2009,0,0,"0",0,0,0
"9289","Taiwan",2010,0,0,"0",0,0,0
"9290","Taiwan",2011,0,0,"0",0,0,0
"9291","Taiwan",2012,0,0,"0",0,0,0
"9292","Taiwan",2013,0,0,"0",0,0,0
"9293","Taiwan",2014,0,0,"0",0,0,0
"9294","Taiwan",2015,0,0,"0",0,0,0
"9295","Taiwan",2016,0,0,"0",0,0,0
"9296","Taiwan",2017,0,0,"0",0,0,0
"9297","United Republic of Tanzania",1962,0,0,"0",0,0,0
"9298","United Republic of Tanzania",1963,0,0,"0",0,0,0
"9299","United Republic of Tanzania",1964,0,0,"0",0,0,0
"9300","United Republic of Tanzania",1965,0,0,"0",0,0,0
"9301","United Republic of Tanzania",1966,0,0,"0",0,0,0
"9302","United Republic of Tanzania",1967,0,0,"0",0,0,0
"9303","United Republic of Tanzania",1968,0,0,"0",0,0,0
"9304","United Republic of Tanzania",1969,0,0,"0",0,0,0
"9305","United Republic of Tanzania",1970,0,0,"0",0,0,0
"9306","United Republic of Tanzania",1971,0,0,"0",0,0,0
"9307","United Republic of Tanzania",1972,0,0,"0",0,0,0
"9308","United Republic of Tanzania",1973,0,0,"0",0,0,0
"9309","United Republic of Tanzania",1974,0,0,"0",0,0,0
"9310","United Republic of Tanzania",1975,0,0,"0",0,0,0
"9311","United Republic of Tanzania",1976,0,0,"0",0,0,0
"9312","United Republic of Tanzania",1977,0,0,"0",0,0,0
"9313","United Republic of Tanzania",1978,0,0,"0",0,0,0
"9314","United Republic of Tanzania",1979,0,0,"0",0,0,0
"9315","United Republic of Tanzania",1980,0,0,"0",0,0,0
"9316","United Republic of Tanzania",1981,0,0,"0",0,0,0
"9317","United Republic of Tanzania",1982,0,0,"0",0,0,0
"9318","United Republic of Tanzania",1983,0,0,"0",0,0,0
"9319","United Republic of Tanzania",1984,0,0,"0",0,0,0
"9320","United Republic of Tanzania",1985,0,0,"0",0,0,0
"9321","United Republic of Tanzania",1986,0,0,"0",0,0,0
"9322","United Republic of Tanzania",1987,0,0,"0",0,0,0
"9323","United Republic of Tanzania",1988,0,0,"0",0,0,0
"9324","United Republic of Tanzania",1989,0,0,"0",0,0,0
"9325","United Republic of Tanzania",1990,0,0,"0",0,0,0
"9326","United Republic of Tanzania",1991,0,0,"0",0,0,0
"9327","United Republic of Tanzania",1992,0,0,"0",0,0,0
"9328","United Republic of Tanzania",1993,0,0,"0",0,0,0
"9329","United Republic of Tanzania",1994,0,0,"0",0,0,0
"9330","United Republic of Tanzania",1995,0,0,"0",0,0,0
"9331","United Republic of Tanzania",1996,0,0,"0",0,0,0
"9332","United Republic of Tanzania",1997,0,0,"0",0,0,0
"9333","United Republic of Tanzania",1998,0,0,"0",0,0,0
"9334","United Republic of Tanzania",1999,0,0,"0",0,0,0
"9335","United Republic of Tanzania",2000,0,0,"0",0,0,0
"9336","United Republic of Tanzania",2001,0,0,"0",0,0,0
"9337","United Republic of Tanzania",2002,0,0,"0",0,0,0
"9338","United Republic of Tanzania",2003,0,0,"0",0,0,0
"9339","United Republic of Tanzania",2004,0,0,"0",0,0,0
"9340","United Republic of Tanzania",2005,0,0,"0",0,0,0
"9341","United Republic of Tanzania",2006,0,0,"0",0,0,0
"9342","United Republic of Tanzania",2007,0,0,"0",0,0,0
"9343","United Republic of Tanzania",2008,0,0,"0",0,0,0
"9344","United Republic of Tanzania",2009,0,0,"0",0,0,0
"9345","United Republic of Tanzania",2010,0,0,"0",0,0,0
"9346","United Republic of Tanzania",2011,0,0,"0",0,0,0
"9347","United Republic of Tanzania",2012,0,0,"0",0,0,0
"9348","United Republic of Tanzania",2013,0,0,"0",0,0,0
"9349","United Republic of Tanzania",2014,0,0,"0",0,0,0
"9350","United Republic of Tanzania",2015,0,0,"0",0,0,0
"9351","United Republic of Tanzania",2016,0,0,"0",0,0,0
"9352","United Republic of Tanzania",2017,0,0,"0",0,0,0
"9353","Uganda",1962,5231000,1569000,"Japan",6800000,14.2659490317152,15.4701130223527
"9354","Uganda",1963,7387000,4171000,"Japan",11558000,15.2436663731791,15.8152322565109
"9355","Uganda",1964,6900000,3822000,"Japan",10722000,15.1562844037824,15.7470319695675
"9356","Uganda",1965,6245000,5461000,"Japan",11706000,15.5131424811343,15.6472917015418
"9357","Uganda",1966,6385000,7819000,"Japan",14204000,15.8720672271067,15.6694620474488
"9358","Uganda",1967,5838000,14967000,"Japan",20805000,16.5213583355113,15.5798988303962
"9359","Uganda",1968,12019000,25268000,"Japan",37287000,17.0450493310007,16.3019992889349
"9360","Uganda",1969,13353000,26896000,"Japan",40249000,17.1074881346305,16.4072516366661
"9361","Uganda",1970,13959000,33251000,"Japan",47210000,17.3195953998019,16.4516350194949
"9362","Uganda",1971,25717000,22973000,"Japan",48690000,16.9498301712743,17.0626628097841
"9363","Uganda",1972,11566000,25926000,"Japan",37492000,17.0707568841421,16.2635803177003
"9364","Uganda",1973,8892000,26605000,"Japan",35497000,17.0966097260126,16.0006625540662
"9365","Uganda",1974,12006000,27400000,"Japan",39406000,17.1260535713583,16.3009170827939
"9366","Uganda",1975,14921000,27635000,"Japan",42556000,17.1345936432495,16.5182801746226
"9367","Uganda",1976,6152000,24312000,"Japan",30464000,17.0064806135788,15.6322877901676
"9368","Uganda",1977,21493000,36620000,"Japan",58113000,17.4161050972106,16.8832378586894
"9369","Uganda",1978,14985000,35003000,"Japan",49988000,17.3709443300661,16.5225602587329
"9370","Uganda",1979,7725000,52144000,"Japan",59869000,17.7695196800595,15.8599723807481
"9371","Uganda",1980,17056000,36633000,"Japan",53689000,17.4164600314833,16.6520126059477
"9372","Uganda",1981,5218000,15364000,"Japan",20582000,16.5475376684479,15.4676247446788
"9373","Uganda",1982,7683000,24415000,"Japan",32098000,17.0107082554779,15.8545206538498
"9374","Uganda",1983,14676000,17962000,"Japan",32638000,16.703768973213,16.5017240644573
"9375","Uganda",1984,17203275,26759251,"Japan",43962526,17.102390803296,16.6606103306353
"9376","Uganda",1985,19516321,10004670,"Japan",29520991,16.1185625419478,16.7867616478252
"9377","Uganda",1986,15464060,16707953,"Japan",32172013,16.6313953915715,16.5540291798421
"9378","Uganda",1987,32417920,15843238,"Japan",48261158,16.5782533426517,17.2942219142864
"9379","Uganda",1988,25532414,8988625,"Japan",34521039,16.0114704470304,17.0554593401726
"9380","Uganda",1989,28150119,9548719,"Japan",37698838,16.0719175673342,17.1530621398945
"9381","Uganda",1990,24280270,6272907,"Japan",30553177,15.6517504415266,17.0051746443573
"9382","Uganda",1991,39122660,2494233,"Japan",41616893,14.7294918250765,17.4822123967293
"9383","Uganda",1992,30498570,3470184,"Japan",33968754,15.0597181764538,17.2331903552326
"9384","Uganda",1993,28907729,2658475,"Japan",31566204,14.7932632080832,17.1796195567735
"9385","Uganda",1994,45551150,3714240,"Japan",49265390,15.1276846391624,17.6343464283329
"9386","Uganda",1995,51000749,9394925,"Japan",60395674,16.0556802078282,17.7473508768553
"9387","Uganda",1996,39603271,9563559,"Japan",49166830,16.0734704960832,17.4944222738235
"9388","Uganda",1997,36887929,6638555,"Japan",43526484,15.7084048772879,17.4233949281217
"9389","Uganda",1998,34917000,7235000,"Japan",42152000,15.7944409180477,17.3684843745922
"9390","Uganda",1999,39969952,9895764,"Japan",49865716,16.1076173447507,17.5036385297861
"9391","Uganda",2000,27854177,11089653,"Japan",38943830,16.2215230693871,17.1424934951381
"9392","Uganda",2001,67355221,8507898,"Japan",75863119,15.9565054665139,18.0254909782318
"9393","Uganda",2002,78004201,13135536,"Japan",91139737,16.3908317872734,18.1722732421779
"9394","Uganda",2003,81229765,9129047,"Japan",90358812,16.0269718659621,18.2127923020031
"9395","Uganda",2004,109235165,8601263,"Japan",117836428,15.9674196109059,18.5090135932461
"9396","Uganda",2005,132579006,6725631,"Japan",139304637,15.7214363080468,18.7026892973893
"9397","Uganda",2006,81872763,5924872,"Japan",87797635,15.5946696413766,18.220676929409
"9398","Uganda",2007,124540400,9638672,"Japan",134179072,16.0812938977609,18.6401407192229
"9399","Uganda",2008,240474707,16017291,"Japan",256491998,16.5891793841817,19.2981254735803
"9400","Uganda",2009,240632684,5269211,"Japan",245901895,15.4773911939391,19.298782196003
"9401","Uganda",2010,274892236,4506438,"Japan",279398674,15.3210175989787,19.4318897097392
"9402","Uganda",2011,170890803,4575107,"Japan",175465910,15.3361406443964,18.9565353315412
"9403","Uganda",2012,155017307,7708634,"Japan",162725941,15.8578515573394,18.8590473267147
"9404","Uganda",2013,165385145,7630281,"Japan",173015426,15.8476352308918,18.9237875239449
"9405","Uganda",2014,186784272,4792620,"Japan",191576892,15.3825877927121,19.0454648832121
"9406","Uganda",2015,163387183,12935003,"Japan",176322186,16.3754476055311,18.9116332979012
"9407","Uganda",2016,162284874,9505155,"Japan",171790029,16.0673448409784,18.9048638303598
"9408","Uganda",2017,322030638.5,17179896,"Japan",339210534.5,16.6592504209514,19.5901572496033
"9409","Ukraine",1962,0,0,"0",0,0,0
"9410","Ukraine",1963,0,0,"0",0,0,0
"9411","Ukraine",1964,0,0,"0",0,0,0
"9412","Ukraine",1965,0,0,"0",0,0,0
"9413","Ukraine",1966,0,0,"0",0,0,0
"9414","Ukraine",1967,0,0,"0",0,0,0
"9415","Ukraine",1968,0,0,"0",0,0,0
"9416","Ukraine",1969,0,0,"0",0,0,0
"9417","Ukraine",1970,0,0,"0",0,0,0
"9418","Ukraine",1971,0,0,"0",0,0,0
"9419","Ukraine",1972,0,0,"0",0,0,0
"9420","Ukraine",1973,0,0,"0",0,0,0
"9421","Ukraine",1974,0,0,"0",0,0,0
"9422","Ukraine",1975,0,0,"0",0,0,0
"9423","Ukraine",1976,0,0,"0",0,0,0
"9424","Ukraine",1977,0,0,"0",0,0,0
"9425","Ukraine",1978,0,0,"0",0,0,0
"9426","Ukraine",1979,0,0,"0",0,0,0
"9427","Ukraine",1980,0,0,"0",0,0,0
"9428","Ukraine",1981,0,0,"0",0,0,0
"9429","Ukraine",1982,0,0,"0",0,0,0
"9430","Ukraine",1983,0,0,"0",0,0,0
"9431","Ukraine",1984,0,0,"0",0,0,0
"9432","Ukraine",1985,0,0,"0",0,0,0
"9433","Ukraine",1986,0,0,"0",0,0,0
"9434","Ukraine",1987,0,0,"0",0,0,0
"9435","Ukraine",1988,0,0,"0",0,0,0
"9436","Ukraine",1989,0,0,"0",0,0,0
"9437","Ukraine",1990,0,0,"0",0,0,0
"9438","Ukraine",1991,0,0,"0",0,0,0
"9439","Ukraine",1992,41596036,54734514,"Japan",96330550,17.8180050373364,17.5435154322297
"9440","Ukraine",1993,62115171,95165388,"Japan",157280559,18.3711268622249,17.9445008165843
"9441","Ukraine",1994,50697466,83871381,"Japan",134568847,18.2447950047843,17.7413864870362
"9442","Ukraine",1995,37981756,109424735,"Japan",147406491,18.5107475192882,17.4526164971401
"9443","Ukraine",1996,112172305,128746602,"Japan",240918907,18.6733567049268,18.5355466845767
"9444","Ukraine",1997,102605157,65206146,"Japan",167811303,17.993064286258,18.4463987525957
"9445","Ukraine",1998,71077000,71040000,"Japan",142117000,18.0787536566482,18.0792743543949
"9446","Ukraine",1999,91596466,111448451,"Japan",203044917,18.5290727190903,18.3329032481141
"9447","Ukraine",2000,91341912,139188359,"Japan",230530271,18.751338674494,18.3301202982807
"9448","Ukraine",2001,148910307,126896488,"Japan",275806795,18.6588822569667,18.8188547162122
"9449","Ukraine",2002,167603386,133279779,"Japan",300883165,18.7079610782182,18.9371109486721
"9450","Ukraine",2003,340849392,147212576,"Japan",488061968,18.8073881953923,19.6469512719956
"9451","Ukraine",2004,380829056,135835583,"Japan",516664639,18.7269557638031,19.7578611604916
"9452","Ukraine",2005,493411124,129773851,"Japan",623184975,18.681303885853,20.0168533074073
"9453","Ukraine",2006,765778099,158401235,"Japan",924179334,18.8806418340314,20.4564029977476
"9454","Ukraine",2007,1270262458,142966492,"Japan",1413228950,18.7781208390882,20.9624893759082
"9455","Ukraine",2008,2639628775,196267541,"Japan",2835896316,19.0949892915243,21.693904128687
"9456","Ukraine",2009,505891266,190921051,"Japan",696812317,19.0673705550103,20.0418323148317
"9457","Ukraine",2010,722530957,185639750,"Japan",908170707,19.0393185256438,20.3982708240918
"9458","Ukraine",2011,663373207,170878678,"Japan",834251885,18.956464377283,20.3128482962634
"9459","Ukraine",2012,569536994,485688737,"Japan",1055225731,20.0010785178357,20.1603342974775
"9460","Ukraine",2013,570637428,463504702,"Japan",1034142130,19.954327087471,20.1622645887039
"9461","Ukraine",2014,337409011,469013387,"Japan",806422398,19.9661418697132,19.636806434892
"9462","Ukraine",2015,205451707,605559531,"Japan",811011238,20.2216634332179,19.1407215618501
"9463","Ukraine",2016,310642731,575194345,"Japan",885837076,20.1702185329598,19.5541540348762
"9464","Ukraine",2017,549104010.5,431334586,"Japan",980438596.5,19.8823946485259,20.1237984359922
"9465","Uruguay",1962,7481000,1012000,"Japan",8493000,13.8274391288295,15.8278770308545
"9466","Uruguay",1963,3971000,5268000,"Japan",9239000,15.4771613418453,15.1945285101134
"9467","Uruguay",1964,2949000,1083000,"Japan",4032000,13.8952455259831,14.8969766877974
"9468","Uruguay",1965,966000,801000,"Japan",1767000,13.5936162260505,13.7809191131947
"9469","Uruguay",1966,597000,3977000,"Japan",4574000,15.1960383241898,13.2996723923747
"9470","Uruguay",1967,741000,2577000,"Japan",3318000,14.7621364896345,13.5157559042782
"9471","Uruguay",1968,1143000,1595000,"Japan",2738000,14.2823842942011,13.9491669427769
"9472","Uruguay",1969,2380000,2255000,"Japan",4635000,14.6286605309189,14.6826110456477
"9473","Uruguay",1970,4630000,1731000,"Japan",6361000,14.3642098341583,15.3480674260624
"9474","Uruguay",1971,4334000,1849000,"Japan",6183000,14.4301555103693,15.2820014610784
"9475","Uruguay",1972,3857000,3800000,"Japan",7657000,15.1505116246966,15.1654002371904
"9476","Uruguay",1973,3979000,13480000,"Japan",17459000,16.4167176634484,15.1965410894091
"9477","Uruguay",1974,8273000,7687000,"Japan",15960000,15.8550411483313,15.9285077581723
"9478","Uruguay",1975,12231000,6856000,"Japan",19087000,15.7406347392598,16.3194842704695
"9479","Uruguay",1976,10751000,11353000,"Japan",22104000,16.2449925841467,16.1905093314674
"9480","Uruguay",1977,17175000,9145000,"Japan",26320000,16.0287178398071,16.6589653960727
"9481","Uruguay",1978,42399000,14376000,"Japan",56775000,16.4810707074455,17.5626353350184
"9482","Uruguay",1979,30269000,10262000,"Japan",40531000,16.143958310484,17.225634644443
"9483","Uruguay",1980,67922000,10617000,"Japan",78539000,16.1779670479957,18.0338705459414
"9484","Uruguay",1981,79728000,13701000,"Japan",93429000,16.4329793808352,18.1941313995033
"9485","Uruguay",1982,21735000,21059000,"Japan",42794000,16.8628385801619,16.894434422405
"9486","Uruguay",1983,17201000,25362000,"Japan",42563000,17.048762548777,16.6604780796285
"9487","Uruguay",1984,10937154,25685491,"Japan",36622645,17.0614368379165,16.2076761748619
"9488","Uruguay",1985,17876329,23087184,"Japan",40963513,16.9547882163359,16.6989879934309
"9489","Uruguay",1986,32869047,16991439,"Japan",49860486,16.6482201869421,17.3080419522174
"9490","Uruguay",1987,38287135,19572289,"Japan",57859424,16.7896252972744,17.4606244969403
"9491","Uruguay",1988,42700225,23160590,"Japan",65860815,16.9579626853014,17.5697147475058
"9492","Uruguay",1989,39541687,22489940,"Japan",62031627,16.9285786560796,17.4928660404516
"9493","Uruguay",1990,53730494,26443526,"Japan",80174020,17.090521922604,17.7994912567815
"9494","Uruguay",1991,71605691,22872398,"Japan",94478089,16.9454414140221,18.0866851120125
"9495","Uruguay",1992,93716673,26859487,"Japan",120576160,17.106129649845,18.355786671614
"9496","Uruguay",1993,115918499,19246163,"Japan",135164662,16.7728222741549,18.5683979073076
"9497","Uruguay",1994,74503749,22974262,"Japan",97478011,16.9498851038185,18.1263600042313
"9498","Uruguay",1995,71180761,22127410,"Japan",93308171,16.9123276694799,18.0807331291946
"9499","Uruguay",1996,72542680,28713169,"Japan",101255849,17.1728664256645,18.0996856362703
"9500","Uruguay",1997,91147946,28068994,"Japan",119216940,17.1501761087218,18.3279945245509
"9501","Uruguay",1998,107293000,30526000,"Japan",137819000,17.2340893374572,18.4910739678214
"9502","Uruguay",1999,65967220,29267687,"Japan",95234907,17.1919946326553,18.0046685099443
"9503","Uruguay",2000,55490533,51033656,"Japan",106524189,17.7479958946047,17.8317229875902
"9504","Uruguay",2001,49496441,40667545,"Japan",90163986,17.5209409121568,17.7174113259642
"9505","Uruguay",2002,26392857,46842312,"Japan",73235169,17.6622974549974,17.0886039633246
"9506","Uruguay",2003,28946835,52912277,"Japan",81859112,17.7841459492974,17.1809714295818
"9507","Uruguay",2004,42068847,56967496,"Japan",99036343,17.8579914175329,17.554818048488
"9508","Uruguay",2005,44171071,72273152,"Japan",116444223,18.0959632765325,17.6035806305054
"9509","Uruguay",2006,51181189,97311909,"Japan",148493098,18.3934319343223,17.7508826201572
"9510","Uruguay",2007,58788161,84221542,"Japan",143009703,18.2489612897207,17.8894510490591
"9511","Uruguay",2008,81165102,118515829,"Japan",199680931,18.5905570876778,18.2119959344256
"9512","Uruguay",2009,65232975,66173614,"Japan",131406589,18.0077923613927,17.9934756505814
"9513","Uruguay",2010,93474968,74864681,"Japan",168339649,18.1311927885417,18.3532042364899
"9514","Uruguay",2011,93305689,98532095,"Japan",191837784,18.4058928906322,18.351391639307
"9515","Uruguay",2012,90582054,98417723,"Japan",188999777,18.4047314575929,18.3217666719227
"9516","Uruguay",2013,110366105,77269005,"Japan",187635110,18.1628034629018,18.5193136247395
"9517","Uruguay",2014,78361970,71200446,"Japan",149562416,18.0810096404075,18.1768492911023
"9518","Uruguay",2015,73289060,60402112,"Japan",133691172,17.9165346291811,18.1099219060591
"9519","Uruguay",2016,52637959,58156064,"Japan",110794023,17.8786407135212,17.7789480714333
"9520","Uruguay",2017,62587696,44966490,"Japan",107554186,17.621428103666,17.9520792672312
"9521","United States of America",1962,1362259000,1809398000,"Japan",3171657000,21.3162600302165,21.0324101881225
"9522","United States of America",1963,1502879000,2077619000,"Japan",3580498000,21.4544883634385,21.1306484388211
"9523","United States of America",1964,1769888000,2336802000,"Japan",4106690000,21.5720491649087,21.2941821046939
"9524","United States of America",1965,2423059000,2366369000,"Japan",4789428000,21.5846225497674,21.6082966284637
"9525","United States of America",1966,2972453000,2658079000,"Japan",5630532000,21.700869518391,21.8126533747978
"9526","United States of America",1967,3005674000,3212750000,"Japan",6218424000,21.8903931051515,21.823767672629
"9527","United States of America",1968,4062112000,3528621000,"Japan",7590733000,21.9841729800093,22.1249688723488
"9528","United States of America",1969,4897330000,4094098000,"Japan",8991428000,22.1328122613685,22.311955995593
"9529","United States of America",1970,5900385000,5564721000,"Japan",11465106000,22.4397126856462,22.4982834399664
"9530","United States of America",1971,7294299000,4991932000,"Japan",12286231000,22.3310888461259,22.7103589210894
"9531","United States of America",1972,8983286000,5856605000,"Japan",14839891000,22.4908359211105,22.9186315766027
"9532","United States of America",1973,9566072000,9279805000,"Japan",18845877000,22.9511063705927,22.9814885088331
"9533","United States of America",1974,13390500000,12698131000,"Japan",26088631000,23.2647206542267,23.3178113372518
"9534","United States of America",1975,12275914000,11610847000,"Japan",23886761000,23.1752055843449,23.2309049681401
"9535","United States of America",1976,16799952000,11848728000,"Japan",28648680000,23.1954863569939,23.5446418662087
"9536","United States of America",1977,20126378000,12421670000,"Japan",32548048000,23.2427083649602,23.7252971299566
"9537","United States of America",1978,26336375000,14805024000,"Japan",41141399000,23.4182324195726,23.9942169004041
"9538","United States of America",1979,28102183000,20474206000,"Japan",48576389000,23.7424316869348,24.0591130971014
"9539","United States of America",1980,32787520000,24447548000,"Japan",57235068000,23.9197957615397,24.2133137921278
"9540","United States of America",1981,39713144000,25347462000,"Japan",65060606000,23.9559444436282,24.4049480529671
"9541","United States of America",1982,39586998000,24271027000,"Japan",63858025000,23.9125491714056,24.4017665679603
"9542","United States of America",1983,43256206000,24741890000,"Japan",67998096000,23.9317635954957,24.4904065513599
"9543","United States of America",1984,57501556278,24706533797,"Japan",82208090075,23.9303335717938,24.7750778500878
"9544","United States of America",1985,68303327544,23494990333,"Japan",91798317877,23.8800530580519,24.9472243218679
"9545","United States of America",1986,81409657800,27115117619,"Japan",108524775419,24.0233572550135,25.1227597491086
"9546","United States of America",1987,84738011676,29389527549,"Japan",114127539225,24.1039042420184,25.1628301180508
"9547","United States of America",1988,89491582646,38204863399,"Japan",127696446045,24.3662286585651,25.2174104091563
"9548","United States of America",1989,88236429727,43967816564,"Japan",132204246291,24.5067237615034,25.203285750137
"9549","United States of America",1990,85498041080,47968413120,"Japan",133466454200,24.5938085712378,25.1717593012816
"9550","United States of America",1991,86711509411,48657327510,"Japan",135368836921,24.6080682510919,25.185852461761
"9551","United States of America",1992,90718443295,47593722642,"Japan",138312165937,24.5859667122183,25.231026517332
"9552","United States of America",1993,99480198927,50127325770,"Japan",149607524697,24.6378321208982,25.3232244555479
"9553","United States of America",1994,110452824708,57089944457,"Japan",167542769165,24.7678938340197,25.427854341026
"9554","United States of America",1995,114342784388,68054241782,"Japan",182397026170,24.943570897415,25.4624666543136
"9555","United States of America",1996,105879285462,71408360741,"Japan",177287646203,24.9916807966495,25.3855654657181
"9556","United States of America",1997,112256676253,60359920818,"Japan",172616597071,24.8235911590162,25.4440538384415
"9557","United States of America",1998,125049900000,66072351000,"Japan",191122251000,24.9140162058272,25.5519786945896
"9558","United States of America",1999,121130338748,60565831502,"Japan",181696170250,24.8269967344054,25.5201329825369
"9559","United States of America",2000,135043134663,64648039848,"Japan",199691174511,24.8922236222615,25.6288600803727
"9560","United States of America",2001,116270180915,57093383142,"Japan",173363564057,24.7679540649671,25.4791824656161
"9561","United States of America",2002,111555215888,52752328873,"Japan",164307544761,24.6888737575792,25.4377855150285
"9562","United States of America",2003,108707013907,53843108258,"Japan",162550122165,24.7093402520058,25.4119221543553
"9563","United States of America",2004,119401656755,57300825661,"Japan",176702482416,24.7715808700048,25.5057589134787
"9564","United States of America",2005,126923292942,58679420073,"Japan",185602713015,24.7953549072991,25.5668487483453
"9565","United States of America",2006,136437128947,62309634980,"Japan",198746763927,24.8553819053567,25.6391297516706
"9566","United States of America",2007,127886520805,64113462500,"Japan",191999983305,24.8839202022221,25.5744091514317
"9567","United States of America",2008,122102214381,69849297168,"Japan",191951511549,24.9696058605801,25.5281243536971
"9568","United States of America",2009,83208643850,53648072069,"Japan",136856715919,24.7057113700373,25.144617071805
"9569","United States of America",2010,105875932099,61287761117,"Japan",167163693216,24.8388460044409,25.3855337936485
"9570","United States of America",2011,122384647395,74912554267,"Japan",197297201662,25.0395873271356,25.5304347693783
"9571","United States of America",2012,137212299322,76401737207,"Japan",213614036529,25.0592712711719,25.6447951934244
"9572","United States of America",2013,130024699966,69880191909,"Japan",199904891875,24.9700480684735,25.5909902690928
"9573","United States of America",2014,126684430613,71545182320,"Japan",198229612933,24.9935950076281,25.5649650328474
"9574","United States of America",2015,122381875390,67179100945,"Japan",189560976335,24.9306280382634,25.5304121191811
"9575","United States of America",2016,127044728012,68293274912,"Japan",195338002924,24.9470771347221,25.5678050504719
"9576","United States of America",2017,138946140312,70633998095,"Japan",209580138407,24.9807774249523,25.6573522152176
"9577","Uzbekistan",1962,0,0,"0",0,0,0
"9578","Uzbekistan",1963,0,0,"0",0,0,0
"9579","Uzbekistan",1964,0,0,"0",0,0,0
"9580","Uzbekistan",1965,0,0,"0",0,0,0
"9581","Uzbekistan",1966,0,0,"0",0,0,0
"9582","Uzbekistan",1967,0,0,"0",0,0,0
"9583","Uzbekistan",1968,0,0,"0",0,0,0
"9584","Uzbekistan",1969,0,0,"0",0,0,0
"9585","Uzbekistan",1970,0,0,"0",0,0,0
"9586","Uzbekistan",1971,0,0,"0",0,0,0
"9587","Uzbekistan",1972,0,0,"0",0,0,0
"9588","Uzbekistan",1973,0,0,"0",0,0,0
"9589","Uzbekistan",1974,0,0,"0",0,0,0
"9590","Uzbekistan",1975,0,0,"0",0,0,0
"9591","Uzbekistan",1976,0,0,"0",0,0,0
"9592","Uzbekistan",1977,0,0,"0",0,0,0
"9593","Uzbekistan",1978,0,0,"0",0,0,0
"9594","Uzbekistan",1979,0,0,"0",0,0,0
"9595","Uzbekistan",1980,0,0,"0",0,0,0
"9596","Uzbekistan",1981,0,0,"0",0,0,0
"9597","Uzbekistan",1982,0,0,"0",0,0,0
"9598","Uzbekistan",1983,0,0,"0",0,0,0
"9599","Uzbekistan",1984,0,0,"0",0,0,0
"9600","Uzbekistan",1985,0,0,"0",0,0,0
"9601","Uzbekistan",1986,0,0,"0",0,0,0
"9602","Uzbekistan",1987,0,0,"0",0,0,0
"9603","Uzbekistan",1988,0,0,"0",0,0,0
"9604","Uzbekistan",1989,0,0,"0",0,0,0
"9605","Uzbekistan",1990,0,0,"0",0,0,0
"9606","Uzbekistan",1991,0,0,"0",0,0,0
"9607","Uzbekistan",1992,12936541,7965676,"Japan",20902217,15.8906523690369,16.3755665006386
"9608","Uzbekistan",1993,19929073,32323908,"Japan",52252981,17.291317700149,16.8076901783124
"9609","Uzbekistan",1994,41422147,23732969,"Japan",65155116,16.9823757364727,17.5393262474507
"9610","Uzbekistan",1995,81087398,91747348,"Japan",172834746,18.3345491398491,18.2110381186022
"9611","Uzbekistan",1996,81537616,55631216,"Japan",137168832,17.8342550405219,18.2165750177438
"9612","Uzbekistan",1997,67191071,37003590,"Japan",104194661,17.4265254929287,18.0230509246413
"9613","Uzbekistan",1998,65163000,12321000,"Japan",77484000,16.3268156816068,17.9924023811539
"9614","Uzbekistan",1999,85835426,30777327,"Japan",116612753,17.2422888404988,18.2679423696853
"9615","Uzbekistan",2000,24620277,70902264,"Japan",95522541,18.0768129232915,17.0190809296727
"9616","Uzbekistan",2001,17824915,49048788,"Japan",66873703,17.7083260341902,16.6961077556698
"9617","Uzbekistan",2002,17055143,67683246,"Japan",84738389,18.0303492331051,16.6519623584377
"9618","Uzbekistan",2003,43518134,85165551,"Japan",128683685,18.2601075790498,17.5886882827545
"9619","Uzbekistan",2004,52174670,79692848,"Japan",131867518,18.193690403222,17.7701076860393
"9620","Uzbekistan",2005,35859709,113860921,"Japan",149720630,18.5504882703356,17.3951249112171
"9621","Uzbekistan",2006,16431201,164224308,"Japan",180655509,18.9167437830028,16.6146925853334
"9622","Uzbekistan",2007,59837317,148296897,"Japan",208134214,18.8147268830862,17.9071400543954
"9623","Uzbekistan",2008,76068184,288170068,"Japan",364238252,19.4790613777044,18.1471406539397
"9624","Uzbekistan",2009,84093422,97481255,"Japan",181574677,18.3951706610742,18.2474389054751
"9625","Uzbekistan",2010,76951129,161245974,"Japan",238197103,18.8984415458866,18.1586810900064
"9626","Uzbekistan",2011,237315370,48373980,"Japan",285689350,17.6944726238206,19.2849004896414
"9627","Uzbekistan",2012,97468979,107374783,"Japan",204843762,18.4918359173121,18.3950447212406
"9628","Uzbekistan",2013,122508627,102144474,"Japan",224653101,18.4418987808483,18.6236920099592
"9629","Uzbekistan",2014,167871374,27552559,"Japan",195423933,17.131605974912,18.9387086131701
"9630","Uzbekistan",2015,251116854,2725904,"Japan",253842758,14.8183106741842,19.3414289425444
"9631","Uzbekistan",2016,159845427,2592864,"Japan",162438291,14.7682736142444,18.8897178249908
"9632","Uzbekistan",2017,0,0,"0",0,0,0
"9633","Venezuela",1962,42009000,17899000,"Japan",59908000,16.7002554033286,17.553394439006
"9634","Venezuela",1963,37148000,22918000,"Japan",60066000,16.9474331859685,17.430420491878
"9635","Venezuela",1964,72029000,27870000,"Japan",99899000,17.1430613994581,18.0925793736649
"9636","Venezuela",1965,87181000,29655000,"Japan",116836000,17.205141303255,18.2834969752295
"9637","Venezuela",1966,69842000,24965000,"Japan",94807000,17.0329854019168,18.0617461059699
"9638","Venezuela",1967,88064000,29234000,"Japan",117298000,17.1908429734314,18.2935743808351
"9639","Venezuela",1968,86542000,26855000,"Japan",113397000,17.1059625813217,18.2761404031942
"9640","Venezuela",1969,107146000,21697000,"Japan",128843000,16.8926845601055,18.4897029483424
"9641","Venezuela",1970,131269000,22766000,"Japan",154035000,16.9407787528673,18.6927592108638
"9642","Venezuela",1971,164436000,16675000,"Japan",181111000,16.629421149766,18.9180319947163
"9643","Venezuela",1972,193747000,29747000,"Japan",223494000,17.208238844535,19.0820637422069
"9644","Venezuela",1973,205128000,28326000,"Japan",233454000,17.1592906687565,19.1391447324961
"9645","Venezuela",1974,356044000,46544000,"Japan",402588000,17.6559086597171,19.6905648766846
"9646","Venezuela",1975,469490000,33964000,"Japan",503454000,17.3408116981014,19.9671575571312
"9647","Venezuela",1976,522192000,33493000,"Japan",555685000,17.3268470197372,20.0735458943111
"9648","Venezuela",1977,916691000,48547000,"Japan",965238000,17.6980429588254,20.636281005059
"9649","Venezuela",1978,771405000,49541000,"Japan",820946000,17.7183111675303,20.4637240854389
"9650","Venezuela",1979,791602000,141925000,"Japan",933527000,18.7708093070211,20.489569298218
"9651","Venezuela",1980,851157000,691033000,"Japan",1542190000,20.3536981374657,20.5621071583583
"9652","Venezuela",1981,960593000,912422000,"Japan",1873015000,20.6316131603153,20.6830613600562
"9653","Venezuela",1982,1178502000,723346000,"Japan",1901848000,20.3993982271981,20.8875099774116
"9654","Venezuela",1983,348475000,569970000,"Japan",918445000,20.1610942858288,19.6690770495802
"9655","Venezuela",1984,325100699,420526160,"Japan",745626859,19.857017247095,19.5996455353795
"9656","Venezuela",1985,395065943,333524664,"Japan",728590607,19.6252273756079,19.7945632532355
"9657","Venezuela",1986,485251405,303965464,"Japan",789216869,19.5324246476538,20.0001776754239
"9658","Venezuela",1987,479804627,322136649,"Japan",801941276,19.5904863892631,19.9888895519249
"9659","Venezuela",1988,553494479,420926797,"Japan",974421276,19.8579694976681,20.1317623353568
"9660","Venezuela",1989,254560637,484977040,"Japan",739537677,19.999612107575,19.3550496249076
"9661","Venezuela",1990,241075822,576088486,"Japan",817164308,20.1717718283894,19.3006220560822
"9662","Venezuela",1991,505052763,424485125,"Japan",929537888,19.8663875218767,20.04017346297
"9663","Venezuela",1992,856935147,404792874,"Japan",1261728021,19.8188860720276,20.5688727992529
"9664","Venezuela",1993,793611374,355148766,"Japan",1148760140,19.6880473188139,20.4921044459895
"9665","Venezuela",1994,407629007,336779808,"Japan",744408815,19.6349398860412,19.8258680221389
"9666","Venezuela",1995,430236746,419606383,"Japan",849843129,19.8548276464775,19.8798461872357
"9667","Venezuela",1996,273984721,256797306,"Japan",530782027,19.3637976390708,19.4285829000238
"9668","Venezuela",1997,598074156,243795876,"Japan",841870032,19.3118418593639,20.2092253109157
"9669","Venezuela",1998,655750000,269533000,"Japan",925283000,19.4122013897967,20.3012901767113
"9670","Venezuela",1999,417468514,311703300,"Japan",729171814,19.5575623317845,19.8497196838424
"9671","Venezuela",2000,451045943,251144911,"Japan",702190854,19.3415406651639,19.9270797614582
"9672","Venezuela",2001,678334635,219277265,"Japan",897611900,19.2058475372433,20.3351512860899
"9673","Venezuela",2002,392075175,140821724,"Japan",532896899,18.7630052795595,19.7869641523278
"9674","Venezuela",2003,176797843,173201601,"Japan",349999444,18.9699667976988,18.9905175078671
"9675","Venezuela",2004,482805383,218311757,"Japan",701117140,19.2014346771473,19.9951241966698
"9676","Venezuela",2005,643421799,291715402,"Japan",935137201,19.4912892342668,20.2823110531402
"9677","Venezuela",2006,776477144,289797683,"Japan",1066274827,19.4846935926498,20.4702777654772
"9678","Venezuela",2007,799221323,440435287,"Japan",1239656610,19.9032740844894,20.4991484653731
"9679","Venezuela",2008,698211119,155899689,"Japan",854110808,18.8647233391575,20.3640320777447
"9680","Venezuela",2009,576716682,41733994,"Japan",618450676,17.5468265585078,20.1728616848189
"9681","Venezuela",2010,538809268,95036971,"Japan",633846239,18.3697765422795,20.1048722035404
"9682","Venezuela",2011,856812388,39825474,"Japan",896637862,17.5000173157611,20.5687295354433
"9683","Venezuela",2012,864417665,269322011,"Japan",1133739676,19.4114182885673,20.5775666185289
"9684","Venezuela",2013,673149111,504511808,"Japan",1177660919,20.0391018028359,20.327477424732
"9685","Venezuela",2014,324433178,302762423,"Japan",627195601,19.5284589734119,19.597590149945
"9686","Venezuela",2015,212434047,114909707,"Japan",327343754,18.559657221409,19.1741421310961
"9687","Venezuela",2016,103412754,77959198,"Japan",181371952,18.1716961452239,18.4542388586603
"9688","Venezuela",2017,0,0,"0",0,0,0
"9689","Vietnam",1962,63420000,16883000,"Japan",80303000,16.6418177564593,17.9652898270745
"9690","Vietnam",1963,27560000,16288000,"Japan",43848000,16.6059391983324,17.1318760041097
"9691","Vietnam",1964,32071000,16587000,"Japan",48658000,16.6241298139882,17.283462752973
"9692","Vietnam",1965,32053000,18001000,"Japan",50054000,16.7059378698728,17.2829013406945
"9693","Vietnam",1966,70363000,15042000,"Japan",85405000,16.5263568463685,18.0691781147871
"9694","Vietnam",1967,148686000,11263000,"Japan",159949000,16.2370335750298,18.8173472577042
"9695","Vietnam",1968,139785000,8826000,"Japan",148611000,15.9932124688116,18.75561608587
"9696","Vietnam",1969,168507000,9319000,"Japan",177826000,16.0475658847678,18.9424878499205
"9697","Vietnam",1970,52027000,10869000,"Japan",62896000,16.2014252585453,17.7672733725613
"9698","Vietnam",1971,45424000,15792000,"Japan",61216000,16.5750140406554,17.6315511576949
"9699","Vietnam",1972,137974000,16374000,"Japan",154348000,16.6112052689185,18.7425758195738
"9700","Vietnam",1973,77053000,36703000,"Japan",113756000,17.4183690535532,18.1600040547284
"9701","Vietnam",1974,125985000,60857000,"Japan",186842000,17.9240374077577,18.65167341021
"9702","Vietnam",1975,81843000,41108000,"Japan",122951000,17.5317133077271,18.2203133358273
"9703","Vietnam",1976,167239000,48874000,"Japan",216113000,17.7047561157024,18.934934485004
"9704","Vietnam",1977,174669000,71835000,"Japan",246504000,18.089882380427,18.9784033123066
"9705","Vietnam",1978,216821000,50847000,"Japan",267668000,17.7443316816683,19.1945826863074
"9706","Vietnam",1979,117721000,48227000,"Japan",165948000,17.6914295881615,18.5838279760267
"9707","Vietnam",1980,113084000,48628000,"Japan",161712000,17.6997100546578,18.5436414633512
"9708","Vietnam",1981,109452000,37344000,"Japan",146796000,17.4356828140684,18.5109966549503
"9709","Vietnam",1982,92331000,36018000,"Japan",128349000,17.399529371462,18.3408905044061
"9710","Vietnam",1983,119155000,37652000,"Japan",156807000,17.4438966316492,18.5959357245396
"9711","Vietnam",1984,119017517,46352993,"Japan",165370510,17.6517964217856,18.5947812419234
"9712","Vietnam",1985,148840959,58427246,"Japan",207268205,17.8832928800979,18.8183889045824
"9713","Vietnam",1986,189186331,74862998,"Japan",264049329,18.1311703077284,19.058242965672
"9714","Vietnam",1987,178764127,130584117,"Japan",309348244,18.6875281517906,19.0015777685833
"9715","Vietnam",1988,193419774,175505311,"Japan",368925085,18.9831798625206,19.0803733798107
"9716","Vietnam",1989,170267180,318115221,"Japan",488382401,19.5779242053074,18.9528794083286
"9717","Vietnam",1990,215608685,538690085,"Japan",754298770,20.1046509820609,19.1889756791191
"9718","Vietnam",1991,216673114,600408018,"Japan",817081132,20.2131200120648,19.1939003886662
"9719","Vietnam",1992,450179853,790215214,"Japan",1240395067,20.4878158891098,19.9251577342139
"9720","Vietnam",1993,634430434,967409694,"Japan",1601840128,20.6901326389769,20.268238200022
"9721","Vietnam",1994,643672270,1218292574,"Japan",1861964844,20.9207161859273,20.2827002570208
"9722","Vietnam",1995,921896115,1549442405,"Japan",2471338520,21.1611609644464,20.6419431016369
"9723","Vietnam",1996,1138863209,1817764527,"Japan",2956627736,21.3208733012105,20.8532964167453
"9724","Vietnam",1997,1331993123,1576037372,"Japan",2908030495,21.1781795412989,21.0099422461384
"9725","Vietnam",1998,1327399000,1742960000,"Japan",3070359000,21.2788506542824,21.0064872253234
"9726","Vietnam",1999,1625617689,1767563853,"Japan",3393181542,21.2928680812494,21.2091536968099
"9727","Vietnam",2000,2142067361,2380905369,"Japan",4522972730,21.5907466594362,21.4850372561899
"9728","Vietnam",2001,1972411811,2370627776,"Japan",4343039587,21.586420641406,21.4025229004326
"9729","Vietnam",2002,2259374202,2307456523,"Japan",4566830725,21.5594116825603,21.5383537101163
"9730","Vietnam",2003,2690051997,2822392978,"Japan",5512444975,21.7608509358201,21.7128263601131
"9731","Vietnam",2004,3202327871,3500026896,"Japan",6702354767,21.9760364899837,21.887143841969
"9732","Vietnam",2005,3664873836,4117683944,"Japan",7782557780,22.138556692728,22.0220597476816
"9733","Vietnam",2006,4230007515,4802860478,"Japan",9032867993,22.2924775102794,22.1654696065988
"9734","Vietnam",2007,5573709376,5539546383,"Japan",11113255759,22.4351784540283,22.4413266254291
"9735","Vietnam",2008,7084376577,8206259415,"Japan",15290635992,22.828163043311,22.6811577142627
"9736","Vietnam",2009,6436349517,6163503454,"Japan",12599852971,22.5419111953516,22.5852273711589
"9737","Vietnam",2010,7771925250,7331130817,"Japan",15103056067,22.7153956133882,22.7737837505564
"9738","Vietnam",2011,9033945447,11434802394,"Japan",20468747841,23.1599273834673,22.9242550355288
"9739","Vietnam",2012,10220887160,14949355751,"Japan",25170242911,23.427934042276,23.0476992242168
"9740","Vietnam",2013,9932130275,14104047408,"Japan",24036177683,23.3697276433523,23.0190408211998
"9741","Vietnam",2014,11213653533,15261749397,"Japan",26475402930,23.4486154956161,23.1403979382369
"9742","Vietnam",2015,12110290346,14971322402,"Japan",27081612748,23.4294023682834,23.2173213699465
"9743","Vietnam",2016,12498422310,16063695584,"Japan",28562117894,23.499827630077,23.2488682580889
"9744","Vietnam",2017,0,0,"0",0,0,0
"9745","Vanuatu",1962,0,0,"0",0,0,0
"9746","Vanuatu",1963,0,0,"0",0,0,0
"9747","Vanuatu",1964,0,0,"0",0,0,0
"9748","Vanuatu",1965,0,0,"0",0,0,0
"9749","Vanuatu",1966,0,0,"0",0,0,0
"9750","Vanuatu",1967,0,0,"0",0,0,0
"9751","Vanuatu",1968,0,0,"0",0,0,0
"9752","Vanuatu",1969,0,0,"0",0,0,0
"9753","Vanuatu",1970,0,0,"0",0,0,0
"9754","Vanuatu",1971,0,0,"0",0,0,0
"9755","Vanuatu",1972,0,0,"0",0,0,0
"9756","Vanuatu",1973,0,0,"0",0,0,0
"9757","Vanuatu",1974,0,0,"0",0,0,0
"9758","Vanuatu",1975,0,0,"0",0,0,0
"9759","Vanuatu",1976,0,0,"0",0,0,0
"9760","Vanuatu",1977,0,0,"0",0,0,0
"9761","Vanuatu",1978,0,0,"0",0,0,0
"9762","Vanuatu",1979,0,0,"0",0,0,0
"9763","Vanuatu",1980,0,0,"0",0,0,0
"9764","Vanuatu",1981,0,0,"0",0,0,0
"9765","Vanuatu",1982,0,0,"0",0,0,0
"9766","Vanuatu",1983,0,0,"0",0,0,0
"9767","Vanuatu",1984,6656245,3559253,"Japan",10215498,15.0850612493498,15.7110660697
"9768","Vanuatu",1985,6924639,3757695,"Japan",10682334,15.1393162954703,15.750596478715
"9769","Vanuatu",1986,13638676,1391335,"Japan",15030011,14.1457742758422,16.4284201382196
"9770","Vanuatu",1987,10581055,3213619,"Japan",13794674,14.9829082743821,16.1745756958692
"9771","Vanuatu",1988,34511973,2436922,"Japan",36948895,14.7062463255297,17.3568168652742
"9772","Vanuatu",1989,135512164,2716846,"Japan",138229010,14.8149822066402,18.7245719654725
"9773","Vanuatu",1990,164244923,5092801,"Japan",169337724,15.4433385318656,18.9168693046534
"9774","Vanuatu",1991,26178729,4722250,"Japan",30900979,15.3677959388941,17.0804577687572
"9775","Vanuatu",1992,14794764,3912776,"Japan",18707540,15.1797576544735,16.5097838923543
"9776","Vanuatu",1993,60867639,5697079,"Japan",66564718,15.5554641453139,17.9242122121378
"9777","Vanuatu",1994,57478625,6098427,"Japan",63577052,15.6235414270372,17.866923697525
"9778","Vanuatu",1995,57635159,7224167,"Japan",64859326,15.7929424911982,17.8696433387538
"9779","Vanuatu",1996,68852589,8070450,"Japan",76923039,15.9037198007733,18.0474783859178
"9780","Vanuatu",1997,13110620,21819223,"Japan",34929843,16.8983019282026,16.388933146765
"9781","Vanuatu",1998,0,0,"0",0,0,0
"9782","Vanuatu",1999,84269906,9241189,"Japan",93511095,16.039181114993,18.2495353722857
"9783","Vanuatu",2000,21556246,16245782,"Japan",37802028,16.6033438638153,16.8861761701062
"9784","Vanuatu",2001,40392193,6362033,"Japan",46754226,15.6658585383259,17.5141470816834
"9785","Vanuatu",2002,22950046,3899368,"Japan",26849414,15.1763250466861,16.9488304988261
"9786","Vanuatu",2003,21465270,7264746,"Japan",28730016,15.798543892228,16.881946838178
"9787","Vanuatu",2004,23713851,14960267,"Japan",38674118,16.5209083779449,16.9815698657722
"9788","Vanuatu",2005,40208954,14211136,"Japan",54420090,16.4695364405796,17.5096002651056
"9789","Vanuatu",2006,47604435,26069804,"Japan",73674239,17.0762882676612,17.6784364871303
"9790","Vanuatu",2007,5532607,30046882,"Japan",35579489,17.2182694531627,15.5261696909824
"9791","Vanuatu",2008,47294747,29250999,"Japan",76545746,17.1914242849051,17.6719097902124
"9792","Vanuatu",2009,72175530,23014907,"Japan",95190437,16.9516526943824,18.0946116267492
"9793","Vanuatu",2010,44423333,51573521,"Japan",95996854,17.758518939826,17.6092754073842
"9794","Vanuatu",2011,26219634,54706324,"Japan",80925958,17.8174898731411,17.0820190773923
"9795","Vanuatu",2012,75575657,57869990,"Japan",133445647,17.8737095007489,18.140644791943
"9796","Vanuatu",2013,145914785,43243052,"Japan",189157837,17.5823471310381,18.7985333448907
"9797","Vanuatu",2014,38508108,47369976,"Japan",85878084,17.67349916825,17.4663793744881
"9798","Vanuatu",2015,59445463,59968610,"Japan",119414073,17.9093318166203,17.9005698619567
"9799","Vanuatu",2016,34550560,71555563,"Japan",106106123,18.0859848107697,17.3579343164402
"9800","Vanuatu",2017,0,0,"0",0,0,0
"9801","West Bank",1962,0,0,"0",0,0,0
"9802","West Bank",1963,0,0,"0",0,0,0
"9803","West Bank",1964,0,0,"0",0,0,0
"9804","West Bank",1965,0,0,"0",0,0,0
"9805","West Bank",1966,0,0,"0",0,0,0
"9806","West Bank",1967,0,0,"0",0,0,0
"9807","West Bank",1968,0,0,"0",0,0,0
"9808","West Bank",1969,0,0,"0",0,0,0
"9809","West Bank",1970,0,0,"0",0,0,0
"9810","West Bank",1971,0,0,"0",0,0,0
"9811","West Bank",1972,0,0,"0",0,0,0
"9812","West Bank",1973,0,0,"0",0,0,0
"9813","West Bank",1974,0,0,"0",0,0,0
"9814","West Bank",1975,0,0,"0",0,0,0
"9815","West Bank",1976,0,0,"0",0,0,0
"9816","West Bank",1977,0,0,"0",0,0,0
"9817","West Bank",1978,0,0,"0",0,0,0
"9818","West Bank",1979,0,0,"0",0,0,0
"9819","West Bank",1980,0,0,"0",0,0,0
"9820","West Bank",1981,0,0,"0",0,0,0
"9821","West Bank",1982,0,0,"0",0,0,0
"9822","West Bank",1983,0,0,"0",0,0,0
"9823","West Bank",1984,0,0,"0",0,0,0
"9824","West Bank",1985,0,0,"0",0,0,0
"9825","West Bank",1986,0,0,"0",0,0,0
"9826","West Bank",1987,0,0,"0",0,0,0
"9827","West Bank",1988,0,0,"0",0,0,0
"9828","West Bank",1989,0,0,"0",0,0,0
"9829","West Bank",1990,0,0,"0",0,0,0
"9830","West Bank",1991,0,0,"0",0,0,0
"9831","West Bank",1992,0,0,"0",0,0,0
"9832","West Bank",1993,0,0,"0",0,0,0
"9833","West Bank",1994,0,0,"0",0,0,0
"9834","West Bank",1995,0,0,"0",0,0,0
"9835","West Bank",1996,0,0,"0",0,0,0
"9836","West Bank",1997,0,0,"0",0,0,0
"9837","West Bank",1998,0,0,"0",0,0,0
"9838","West Bank",1999,0,0,"0",0,0,0
"9839","West Bank",2000,0,0,"0",0,0,0
"9840","West Bank",2001,0,0,"0",0,0,0
"9841","West Bank",2002,0,0,"0",0,0,0
"9842","West Bank",2003,0,0,"0",0,0,0
"9843","West Bank",2004,0,0,"0",0,0,0
"9844","West Bank",2005,0,0,"0",0,0,0
"9845","West Bank",2006,0,0,"0",0,0,0
"9846","West Bank",2007,0,0,"0",0,0,0
"9847","West Bank",2008,0,0,"0",0,0,0
"9848","West Bank",2009,0,0,"0",0,0,0
"9849","West Bank",2010,0,0,"0",0,0,0
"9850","West Bank",2011,0,0,"0",0,0,0
"9851","West Bank",2012,0,0,"0",0,0,0
"9852","West Bank",2013,0,0,"0",0,0,0
"9853","West Bank",2014,0,0,"0",0,0,0
"9854","West Bank",2015,0,0,"0",0,0,0
"9855","West Bank",2016,0,0,"0",0,0,0
"9856","West Bank",2017,0,0,"0",0,0,0
"9857","Yemen",1962,0,0,"0",0,0,0
"9858","Yemen",1963,0,0,"0",0,0,0
"9859","Yemen",1964,0,0,"0",0,0,0
"9860","Yemen",1965,0,0,"0",0,0,0
"9861","Yemen",1966,0,0,"0",0,0,0
"9862","Yemen",1967,0,0,"0",0,0,0
"9863","Yemen",1968,0,0,"0",0,0,0
"9864","Yemen",1969,0,0,"0",0,0,0
"9865","Yemen",1970,0,0,"0",0,0,0
"9866","Yemen",1971,0,0,"0",0,0,0
"9867","Yemen",1972,0,0,"0",0,0,0
"9868","Yemen",1973,0,0,"0",0,0,0
"9869","Yemen",1974,0,0,"0",0,0,0
"9870","Yemen",1975,0,0,"0",0,0,0
"9871","Yemen",1976,0,0,"0",0,0,0
"9872","Yemen",1977,0,0,"0",0,0,0
"9873","Yemen",1978,0,0,"0",0,0,0
"9874","Yemen",1979,0,0,"0",0,0,0
"9875","Yemen",1980,0,0,"0",0,0,0
"9876","Yemen",1981,0,0,"0",0,0,0
"9877","Yemen",1982,0,0,"0",0,0,0
"9878","Yemen",1983,0,0,"0",0,0,0
"9879","Yemen",1984,179154869,704307,"Japan",179859176,13.4649696196306,19.0037611796881
"9880","Yemen",1985,125460472,12925412,"Japan",138385884,16.3747058540596,18.6475013027811
"9881","Yemen",1986,123366104,1075548,"Japan",124441652,13.8883408570985,18.6306669477484
"9882","Yemen",1987,60932360,2077299,"Japan",63009659,14.5465790501285,17.9252749544468
"9883","Yemen",1988,72426793,87973733,"Japan",160400526,18.2925488392495,18.0980868579581
"9884","Yemen",1989,61878891,94771340,"Japan",156650231,18.366977600842,17.9406896617244
"9885","Yemen",1990,81490733,67829706,"Japan",149320439,18.0325107985475,18.2159998662247
"9886","Yemen",1991,142965928,147096197,"Japan",290062125,18.8065973320764,18.7781168941001
"9887","Yemen",1992,131319367,148671898,"Japan",279991265,18.8172524090379,18.6931428302997
"9888","Yemen",1993,112943982,208017252,"Japan",320961234,19.1531315765338,18.5424025192464
"9889","Yemen",1994,78639366,168133640,"Japan",246773006,18.9402696973345,18.1803829717158
"9890","Yemen",1995,65149806,299746499,"Japan",364896305,19.5184476720706,17.992199883787
"9891","Yemen",1996,66502833,381416457,"Japan",447919290,19.7594023991247,18.0127551062224
"9892","Yemen",1997,77492823,102943623,"Japan",180436446,18.4496920468289,18.1656958835837
"9893","Yemen",1998,73311000,114679000,"Japan",187990000,18.5576474790251,18.1102212238106
"9894","Yemen",1999,79645162,51470984,"Japan",131116146,17.756528789379,18.1930918517348
"9895","Yemen",2000,83707606,46843060,"Japan",130550666,17.6623134233388,18.2428404034936
"9896","Yemen",2001,67784245,52021535,"Japan",119805780,17.767168325431,18.0318403512762
"9897","Yemen",2002,73300789,67734084,"Japan",141034873,18.0311000676162,18.1100819307826
"9898","Yemen",2003,115170243,108106030,"Japan",223276273,18.4986230627373,18.5619219655673
"9899","Yemen",2004,141524797,64117178,"Japan",205641975,17.9762228735082,18.7679855035104
"9900","Yemen",2005,154884182,371937488,"Japan",526821670,19.7342363551059,18.8581881826776
"9901","Yemen",2006,203172324,239468412,"Japan",442640736,19.2939320746763,19.129565063605
"9902","Yemen",2007,209933362,488729727,"Japan",698663089,20.0073201891197,19.1623007145144
"9903","Yemen",2008,330962686,489820578,"Japan",820783264,20.0095497146664,19.6175161958689
"9904","Yemen",2009,176341071,291900882,"Japan",468241953,19.4919248574025,18.9879305810991
"9905","Yemen",2010,300300963,384906087,"Japan",685207050,19.7685099326262,19.5202957397416
"9906","Yemen",2011,129950724,410883949,"Japan",540834673,19.8338213700583,18.6826658904099
"9907","Yemen",2012,298036226,346233382,"Japan",644269608,19.6626236200902,19.5127256008398
"9908","Yemen",2013,363901229,527570400,"Japan",891471629,20.0837928741252,19.7123930398781
"9909","Yemen",2014,405796311,817777551,"Japan",1223573862,20.5221009150412,19.8213618946296
"9910","Yemen",2015,113091995,107760420,"Japan",220852415,18.4954209876089,18.543712160509
"9911","Yemen",2016,115152057,4148526,"Japan",119300583,15.2382636483924,18.5617640477275
"9912","Yemen",2017,0,0,"0",0,0,0
"9913","South Africa",1962,60158000,118816000,"Japan",178974000,18.5930866359589,17.9124849923724
"9914","South Africa",1963,79765000,130624000,"Japan",210389000,18.6878335251517,18.1945953697172
"9915","South Africa",1964,116380000,156305000,"Japan",272685000,18.8673197846433,18.5723712571928
"9916","South Africa",1965,137884000,133685000,"Japan",271569000,18.7109968443048,18.7419233099261
"9917","South Africa",1966,127458000,157603000,"Japan",285061000,18.8755897707399,18.6632974565301
"9918","South Africa",1967,157120000,304591000,"Japan",461711000,19.534480451042,18.8725204025704
"9919","South Africa",1968,170598000,381042000,"Japan",551640000,19.7584201632359,18.9548204696237
"9920","South Africa",1969,277966000,327345000,"Japan",605311000,19.6065252185633,19.4430093620171
"9921","South Africa",1970,329590000,372364000,"Japan",701954000,19.7353824284473,19.6133600157335
"9922","South Africa",1971,414383000,366296000,"Japan",780679000,19.7189523076785,19.8423012249021
"9923","South Africa",1972,364683000,438754000,"Japan",803437000,19.8994494495119,19.7145390410374
"9924","South Africa",1973,596091000,565148000,"Japan",1161239000,20.1525982017113,20.2059038979383
"9925","South Africa",1974,965339000,814934000,"Japan",1780273000,20.5186176863309,20.6879898929503
"9926","South Africa",1975,874862000,917894000,"Japan",1792756000,20.6375924735082,20.589576717598
"9927","South Africa",1976,713138000,800509000,"Japan",1513647000,20.500758333311,20.3851855080376
"9928","South Africa",1977,761602000,934793000,"Japan",1696395000,20.6558356723682,20.4509346674884
"9929","South Africa",1978,985373000,1078908000,"Japan",2064281000,20.7992152554538,20.7085308076582
"9930","South Africa",1979,1002626000,1358306000,"Japan",2360932000,21.0295041720693,20.7258883950327
"9931","South Africa",1980,1808502000,1812965000,"Japan",3621467000,21.3182294635135,21.3157647152447
"9932","South Africa",1981,2232582000,1727523000,"Japan",3960105000,21.2699544275551,21.5264246001636
"9933","South Africa",1982,1663641000,1823211000,"Japan",3486852000,21.3238650692255,21.2322744108768
"9934","South Africa",1983,1745473000,1600278000,"Japan",3345751000,21.1934432010994,21.2802914160426
"9935","South Africa",1984,1817771552,1482733145,"Japan",3300504697,21.1171529412268,21.3208771658401
"9936","South Africa",1985,965417118,1668165933,"Japan",2633583051,21.234990616151,20.6880708125437
"9937","South Africa",1986,1359796776,2029068573,"Japan",3388865349,21.4308426936705,21.0306010961169
"9938","South Africa",1987,1870831982,2069645582,"Japan",3940477564,21.4506432131394,21.3496490790302
"9939","South Africa",1988,2083466435,1758125558,"Japan",3841591993,21.2875140545919,21.4572988987858
"9940","South Africa",1989,1777598546,1862254767,"Japan",3639853313,21.3450538308241,21.2985291588925
"9941","South Africa",1990,1521091758,1688680994,"Japan",3209772752,21.2472135842276,21.1426941758201
"9942","South Africa",1991,1671736930,1657112518,"Japan",3328849448,21.2283424777324,21.2371290007132
"9943","South Africa",1992,1755058020,1883913749,"Japan",3638971769,21.356617231267,21.2857677531468
"9944","South Africa",1993,2056232455,1880421043,"Japan",3936653498,21.3547615477557,21.4441412399188
"9945","South Africa",1994,2012950627,2092748974,"Japan",4105699601,21.4617443372403,21.4228674562293
"9946","South Africa",1995,2442601764,2469248578,"Japan",4911850342,21.627179721869,21.6163296048823
"9947","South Africa",1996,1869372307,2731207429,"Japan",4600579736,21.7280096300505,21.348868546759
"9948","South Africa",1997,1050549128,2162130733,"Japan",3212679861,21.4943600228829,20.7725788434576
"9949","South Africa",1998,1370058000,2316342000,"Japan",3686400000,21.563255054149,21.0381189116567
"9950","South Africa",1999,1679915547,2178210166,"Japan",3858125713,21.5017693517513,21.2420093594552
"9951","South Africa",2000,1908521206,2801498425,"Japan",4710019631,21.7534202627706,21.3695945414318
"9952","South Africa",2001,1540061380,2628582198,"Japan",4168643578,21.6897104495629,21.1550881097205
"9953","South Africa",2002,1626331428,2718828659,"Japan",4345160087,21.7234669844287,21.2095926575598
"9954","South Africa",2003,2184665928,3367300392,"Japan",5551966320,21.937377189659,21.5047287604407
"9955","South Africa",2004,2929236496,4281676028,"Japan",7210912524,22.1776103652138,21.7980076444481
"9956","South Africa",2005,3310005636,5017919104,"Japan",8327924740,22.3362811635969,21.920215729053
"9957","South Africa",2006,4003015018,6225201567,"Japan",10228216585,22.5518716590139,22.110313668636
"9958","South Africa",2007,4504026628,7446470586,"Japan",11950497214,22.7310060102388,22.2282376398445
"9959","South Africa",2008,4149539396,8652903288,"Japan",12802442684,22.8811607418068,22.1462631761136
"9960","South Africa",2009,2595662388,4912250540,"Japan",7507912928,22.3149980321908,21.6771075764835
"9961","South Africa",2010,3641212916,7221781117,"Japan",10862994033,22.7003674515329,22.0155826817714
"9962","South Africa",2011,4198157761,8471889958,"Japan",12670047719,22.8600194562565,22.1579116376769
"9963","South Africa",2012,4020720932,6417241854,"Japan",10437962786,22.5822542445791,22.1147270598169
"9964","South Africa",2013,3428343343,6750565351,"Japan",10178908694,22.6328920940272,21.9553429910678
"9965","South Africa",2014,3215276580,5709205310,"Japan",8924481890,22.4653456757972,21.8911792189296
"9966","South Africa",2015,2670918336,4944341232,"Japan",7615259568,22.3215095741375,21.7056881962901
"9967","South Africa",2016,2215824555,4211789129,"Japan",6427613684,22.1611533656249,21.5188904307658
"9968","South Africa",2017,2671005985,5279787813.5,"Japan",7950793798.5,22.3871517470199,21.7057210118055
"9969","Zambia",1962,7694000,20928000,"Japan",28622000,16.8565985332391,15.8559513622944
"9970","Zambia",1963,12062000,31303000,"Japan",43365000,17.2592244975628,16.3055705729931
"9971","Zambia",1964,16883000,75226000,"Japan",92109000,18.136007473845,16.6418177564593
"9972","Zambia",1965,8172000,60889000,"Japan",69061000,17.9245630923919,15.9162242349196
"9973","Zambia",1966,12382000,83839000,"Japan",96221000,18.244408850985,16.3317543630613
"9974","Zambia",1967,26028000,138149000,"Japan",164177000,18.7438433707986,17.074683439597
"9975","Zambia",1968,29378000,168431000,"Japan",197809000,18.9420367283415,17.1957566528735
"9976","Zambia",1969,22385000,288705000,"Japan",311090000,19.4809159634995,16.9239016496572
"9977","Zambia",1970,30527000,294683000,"Japan",325210000,19.5014107602619,17.2341220958802
"9978","Zambia",1971,37570000,149245000,"Japan",186815000,18.8210998088383,17.4417164175502
"9979","Zambia",1972,54383000,165425000,"Japan",219808000,18.9240284778624,17.8115621629879
"9980","Zambia",1973,47855000,292138000,"Japan",339993000,19.4927368513308,17.6836861636121
"9981","Zambia",1974,75481000,320543000,"Japan",396024000,19.5855269906922,18.1393915269195
"9982","Zambia",1975,83272000,141259000,"Japan",224531000,18.7661056427752,18.2376229161774
"9983","Zambia",1976,19764000,168803000,"Japan",188567000,18.94424291248,16.7993726589478
"9984","Zambia",1977,36452000,186576000,"Japan",223028000,19.0443492207423,17.4115068845982
"9985","Zambia",1978,25706000,167899000,"Japan",193605000,18.9388731661039,17.0622349856522
"9986","Zambia",1979,40529000,294147000,"Japan",334676000,19.4995902003446,17.5175283252184
"9987","Zambia",1980,54729000,297158000,"Japan",351887000,19.5097745418443,17.8179042914385
"9988","Zambia",1981,51702000,273095000,"Japan",324797000,19.4253302779644,17.76100702345
"9989","Zambia",1982,51411000,227157000,"Japan",278568000,19.2411519663358,17.7553627153111
"9990","Zambia",1983,27599000,166887000,"Japan",194486000,18.9328274946457,17.1332900981469
"9991","Zambia",1984,34615560,185172524,"Japan",219788084,19.0367985106388,17.3598138499209
"9992","Zambia",1985,60133598,202694244,"Japan",262827842,19.1272092143737,17.9120792782454
"9993","Zambia",1986,39116829,184007538,"Japan",223124367,19.0304872821254,17.4820633415633
"9994","Zambia",1987,39636084,258965643,"Japan",298601727,19.372205958355,17.4952504734442
"9995","Zambia",1988,68251988,356247355,"Japan",424499343,19.6911358649582,18.0387171198103
"9996","Zambia",1989,90253443,401206072,"Japan",491459515,19.8099857485337,18.3181323040341
"9997","Zambia",1990,82382031,402355034,"Japan",484737065,19.8128454259731,18.2268779007105
"9998","Zambia",1991,69667180,304091908,"Japan",373759088,19.5328405426257,18.0592398896549
"9999","Zambia",1992,56906219,226286358,"Japan",283192577,19.2373118259763,17.8569151901364
"10000","Zambia",1993,53521494,191662750,"Japan",245184244,19.0712478751021,17.7955938881928
"10001","Zambia",1994,37881675,156752762,"Japan",194634437,18.8701803577367,17.4499780438895
"10002","Zambia",1995,60754607,196874221,"Japan",257628828,19.0980756107109,17.9223534727005
"10003","Zambia",1996,19135807,173191856,"Japan",192327663,18.9699105322019,16.7670718499793
"10004","Zambia",1997,32729916,105530632,"Japan",138260548,18.4745118194477,17.3038000800213
"10005","Zambia",1998,31149000,116011000,"Japan",147160000,18.569195572161,17.2542926999537
"10006","Zambia",1999,17865547,85171516,"Japan",103037063,18.2601776166536,16.6983846674988
"10007","Zambia",2000,22568249,84666544,"Japan",107234793,18.2542310874948,16.9320545649246
"10008","Zambia",2001,28728497,54572832,"Japan",83301329,17.8150467344623,17.1734001149333
"10009","Zambia",2002,28799801,60067843,"Japan",88867644,17.9109851980744,17.1758790353601
"10010","Zambia",2003,21355728,62177755,"Japan",83533483,17.9455078570862,16.8768305520536
"10011","Zambia",2004,26501817,89485853,"Japan",115987670,18.3095911037121,17.0927238546436
"10012","Zambia",2005,38057678,53256925,"Japan",91314603,17.7906384010468,17.4546134090379
"10013","Zambia",2006,43711511,45053024,"Japan",88764535,17.623350665182,17.5931220349906
"10014","Zambia",2007,46816794,114628742,"Japan",161445536,18.5572091335915,17.6617525426718
"10015","Zambia",2008,46886995,82934836,"Japan",129821831,18.2335657489681,17.6632509028531
"10016","Zambia",2009,40129451,21302364,"Japan",61431815,16.8743286104367,17.5076210616113
"10017","Zambia",2010,76756707,48633165,"Japan",125389872,17.6998162635441,18.1561513282357
"10018","Zambia",2011,101136708,59087048,"Japan",160223756,17.8945223043823,18.4319837041443
"10019","Zambia",2012,146097305,49963646,"Japan",196060951,17.7268062189416,18.7997834302811
"10020","Zambia",2013,128357714,51073671,"Japan",179431385,17.7487796777714,18.670331564761
"10021","Zambia",2014,108638344,39607477,"Japan",148245821,17.4945284715331,18.5035349786541
"10022","Zambia",2015,68195888,46140193,"Japan",114336081,17.6471949936227,18.0378948277408
"10023","Zambia",2016,47961191,24640665,"Japan",72601856,17.0199086849018,17.6859027210096
"10024","Zambia",2017,88754957.5,89481601.5,"Japan",178236559,18.3095435922803,18.3013898439147
"10025","Zimbabwe",1962,0,0,"0",0,0,0
"10026","Zimbabwe",1963,0,0,"0",0,0,0
"10027","Zimbabwe",1964,0,0,"0",0,0,0
"10028","Zimbabwe",1965,16682000,26494000,"Japan",43176000,17.0924288502263,16.6298408517837
"10029","Zimbabwe",1966,11112000,13781000,"Japan",24893000,16.4388013898573,16.2235361634163
"10030","Zimbabwe",1967,13590000,1266000,"Japan",14856000,14.0513728816863,16.4248447861273
"10031","Zimbabwe",1968,4521000,821000,"Japan",5342000,13.6182783884346,15.3242437662767
"10032","Zimbabwe",1969,3000,0,"Japan",3000,0,8.00636756765025
"10033","Zimbabwe",1970,3000,0,"Japan",3000,0,8.00636756765025
"10034","Zimbabwe",1971,5000,20000,"Japan",25000,9.90348755253613,8.51719319141624
"10035","Zimbabwe",1972,21000,0,"Japan",21000,0,9.95227771670556
"10036","Zimbabwe",1973,36000,0,"Japan",36000,0,10.4912742174382
"10037","Zimbabwe",1974,83000,0,"Japan",83000,0,11.3265958867787
"10038","Zimbabwe",1975,158000,0,"Japan",158000,0,11.9703503120091
"10039","Zimbabwe",1976,68000,0,"Japan",68000,0,11.1272629841582
"10040","Zimbabwe",1977,145000,0,"Japan",145000,0,11.8844890214027
"10041","Zimbabwe",1978,89000,0,"Japan",89000,0,11.3963916487143
"10042","Zimbabwe",1979,57000,0,"Japan",57000,0,10.9508065468167
"10043","Zimbabwe",1980,28629000,30904000,"Japan",59533000,17.2463961833283,17.1699307480675
"10044","Zimbabwe",1981,70379000,48556000,"Japan",118935000,17.6982283289998,18.0694054811748
"10045","Zimbabwe",1982,54514000,45141000,"Japan",99655000,17.6253014824091,17.8139681073792
"10046","Zimbabwe",1983,43052000,81849000,"Japan",124901000,18.2203866442358,17.5779192453663
"10047","Zimbabwe",1984,35521364,64327678,"Japan",99849042,17.9795005476013,17.3856448762518
"10048","Zimbabwe",1985,24676077,50265112,"Japan",74941189,17.7328217960098,17.0213447897477
"10049","Zimbabwe",1986,39863847,55598018,"Japan",95461865,17.8336581111034,17.5009803808866
"10050","Zimbabwe",1987,24226739,78203067,"Japan",102429806,18.1748194246953,17.0029674985104
"10051","Zimbabwe",1988,35784763,140722670,"Japan",176507433,18.7623016320624,17.3930327462462
"10052","Zimbabwe",1989,46852827,167052345,"Japan",213905172,18.9338177643818,17.6625219063437
"10053","Zimbabwe",1990,68868873,133060256,"Japan",201929129,18.7063126362203,18.0477148632226
"10054","Zimbabwe",1991,109921944,149396925,"Japan",259318869,18.8221172481219,18.5152810718714
"10055","Zimbabwe",1992,84663017,108737727,"Japan",193400744,18.504449366392,18.2541894290864
"10056","Zimbabwe",1993,113600920,107212325,"Japan",220813245,18.4903217720071,18.5482021628101
"10057","Zimbabwe",1994,129962325,136312442,"Japan",266274767,18.7304601764331,18.6827551587252
"10058","Zimbabwe",1995,176780922,161239812,"Japan",338020734,18.8984033302488,18.9904217951056
"10059","Zimbabwe",1996,130704673,146528915,"Japan",277233588,18.8027333389598,18.6884509315896
"10060","Zimbabwe",1997,92282684,135928172,"Japan",228210856,18.7276371571227,18.3403670762391
"10061","Zimbabwe",1998,89285000,149469000,"Japan",238754000,18.8225995714339,18.3073440586134
"10062","Zimbabwe",1999,81745175,161042446,"Japan",242787621,18.8971785279534,18.2191173445931
"10063","Zimbabwe",2000,36538918,160046951,"Japan",196585869,18.8909777739019,17.4138884970909
"10064","Zimbabwe",2001,28926484,117756417,"Japan",146682901,18.5841287861912,17.1802681348273
"10065","Zimbabwe",2002,66040813,112858004,"Japan",178898817,18.5416409847207,18.0057834876612
"10066","Zimbabwe",2003,17447748,128084564,"Japan",145532312,18.6682012599966,16.6747211438432
"10067","Zimbabwe",2004,22755027,112485773,"Japan",135240800,18.5383373093895,16.9402966459846
"10068","Zimbabwe",2005,27524099,120904503,"Japan",148428602,18.610511560549,17.130572506159
"10069","Zimbabwe",2006,19187608,118889581,"Japan",138077189,18.5937057295624,16.7697752119603
"10070","Zimbabwe",2007,29116979,207152481,"Japan",236269460,19.1489657032443,17.1868320327792
"10071","Zimbabwe",2008,19315366,106661450,"Japan",125976816,18.485170357644,16.7764115029064
"10072","Zimbabwe",2009,18883924,40787410,"Japan",59671334,17.5238840133229,16.7538215360692
"10073","Zimbabwe",2010,47721941,48295896,"Japan",96017837,17.6928571460686,17.6809018291363
"10074","Zimbabwe",2011,30449214,57670249,"Japan",88119463,17.8702519832518,17.2315707389791
"10075","Zimbabwe",2012,28325555,31212439,"Japan",59537994,17.256327259223,17.1592749586846
"10076","Zimbabwe",2013,41999950,16776997,"Japan",58776947,16.6355192799363,17.5531789857707
"10077","Zimbabwe",2014,37726705,16592063,"Japan",54318768,16.6244350064548,17.4458787570906
"10078","Zimbabwe",2015,28030017,16941004,"Japan",44971021,16.6452475134366,17.1487865296338
"10079","Zimbabwe",2016,16494403,13584125,"Japan",30078528,16.4244123894933,16.6185316692042
"10080","Zimbabwe",2017,0,0,"0",0,0,0
